к	*к	до	142
до	*до	до	95
здесь	*здесь	тут	60
три	*три	три	49
ни	*ни	ні	31
файоло	*файоло	файоло	24
какой	*какой	який	24
рад	*рад	радий	21
пожалуйста	*пожалуйста	будь	21
жирка	*жирка	жирку	21
теннис	*теннис	теніс	20
мэри	*мэри	мері	20
наш	*наш	наш	19
взять	*взять	взяти	19
рик	*рик	ріку	19
наши	*наши	наші	18
мадам	*мадам	мадам	18
домой	*домой	додому	18
пить	*пить	пити	16
изучать	*изучать	вивчати	16
некоторые	*некоторые	деякі	15
токио	*токио	токіо	15
пешком	*пешком	пішки	15
поехал	*поехал	поїхав	15
ласло	*ласло	лазло	15
меленянах	*меленянах	меленянах	15
рано	*рано	рано	15
жирка	*жирка	жирко	15
устал	*устал	втомився	14
лекарство	*лекарство	ліки	14
сэм	*сэм	семе	14
дверь	*дверь	двері	14
боюсь	*боюсь	боюся	14
тони	*тони	тоні	14
ко	*ко	до	13
вернулся	*вернулся	повернувся	13
женился	*женился	одружився	13
мистер	*мистер	містер	13
дезмонд	*дезмонд	десмонд	13
вернусь	*вернусь	повернуся	12
плавать	*плавать	плавати	12
яани	*яани	яані	12
робинзон	*робинзон	робінзон	12
курить	*курить	палити	12
бэтти	*бэтти	бетті	12
возьми	*возьми	візьми	11
петр	*петр	петре	11
ваши	*ваши	ваші	11
нашем	*нашем	нашому	11
какой	*какой	яке	11
ваших	*ваших	ваших	11
разве	*разве	хіба	11
читать	*читать	читати	11
сэр	*сэр	сер	11
последний	*последний	останній	11
поехать	*поехать	поїхати	11
поговорить	*поговорить	поговорити	11
арти	*арти	арті	11
киото	*киото	кіото	11
эсперанто	*эсперанто	есперанто	11
хоккайдо	*хоккайдо	хоккайдо	10
попробуй	*попробуй	спробуй	10
выглядишь	*выглядишь	виглядаєш	10
подумать	*подумать	подумати	10
комары	*комары	комарі	10
ошибок	*грамматических	помилок	10
нашей	*нашей	нашої	10
америке	*америке	америці	10
другие	*другие	інші	10
,	*ширина	,	10
ни	*ни	жодного	9
диалект	*диалект	діалект	9
касабланке	*касабланке	касабланці	9
ребят	*ребят	хлопці	9
вино	*вино	вино	9
какая	*какая	яка	9
интернете	*интернете	інтернеті	9
последние	*последние	останні	9
жарко	*жарко	спекотно	9
париж	*париж	париж	9
зонтик	*зонтик	парасолю	9
понятием	*абстрактным	поняттям	9
какие	*какие	які	9
ребята	*ребята	хлопці	9
скучаю	*скучаю	сумую	9
геттер	*геттер	геттер	9
наша	*наша	наша	9
пикник	*пикник	пікнік	8
придурок	*придурок	придурок	8
ненавижу	*ненавижу	ненавиджу	8
и	*стеснительные	і	8
доволен	*доволен	задоволений	8
родителей	*родителей	батьків	8
свитер	*свитер	светр	8
будто	*будто	немов	8
меленяны	*меленяны	меленяни	8
при	*общаться	за	8
мистер	*мистер	містере	8
коротка	*коротка	коротке	8
париже	*париже	парижі	8
.	*дилма	.	8
мадмуазель	*мадмуазель	мадемуазель	8
блажеи	*блажеи	блажеї	8
поймал	*поймал	спіймав	8
бездарь	*бездарь	нездара	8
бетти	*бетти	бетті	8
я	*наливаю	я	8
изучить	*изучить	вивчити	8
?	*получилось	?	8
японцев	*японцев	японців	8
шкафу	*шкафу	шафі	8
.	*рано	.	8
лыжах	*лыжах	лижах	8
мухи	*мухи	мухи	8
другой	*другой	іншого	8
каким	*каким	яким	8
выпал	*выпал	випав	7
лучший	*лучший	найкращий	7
и	*нору	й	7
троих	*троих	трьох	7
выбор	*единственный	вибір	7
пожалуйста	*пожалуйста	ласка	7
бездянке	*бездянке	бездянці	7
книги	*любые	книги	7
боится	*боится	боїться	7
-	*окаменелость	-	7
взял	*взял	взяв	7
ваше	*ваше	ваше	7
рождеством	*рождеством	новим	7
понадобился	*пете	потребував	7
и	*пусто	і	7
америки	*америки	америки	7
.	*блестит	.	7
нору	*вырыть	нору	7
нью-йорке	*нью-*йорке	нью-йорку	7
эй	*эй	ей	7
кататься	*кататься	кататися	7
шейфер	*шейфер	шефер	7
ваш	*ваш	ваша	7
бывал	*бывал	бував	7
лежит	*лежит	лежить	7
.	*нераздельны	.	7
приемник	*приемник	приймач	7
клади	*клади	клади	7
апельсины	*апельсины	апельсини	7
важное	*какое	важливу	7
рено	*рено	рено	7
какова	*какова	яка	7
к	*к	на	7
карл	*карл	карле	7
ни	*ни	не	7
бы	*понадобился	би	7
многоразового	*проездного	багаторазового	7
бездянка	*бездянка	бездянка	7
ваш	*ваш	ваш	7
плакала	*плакала	плакала	7
ударила	*ударила	вдарила	7
опаздывает	*опаздывает	спізнюється	7
чурбан	*чурбан	добешку	7
касабланки	*касабланки	касабланки	7
прокомпостируйте	*многоразового	прокомпостуйте	7
целый	*целый	цілий	7
мюриэл	*мюриэл	мюріел	7
завтрашнего	*завтрашнего	завтрашнього	7
нашей	*нашей	нашій	7
незнакомец	*незнакомец	незнайомець	7
нэнси	*нэнси	ненсі	7
выражаются	*выражаются	за	7
потерял	*потерял	загубив	7
понтон	*понтон	понтон	7
танцевала	*танцевала	танцювала	7
деревне	*деревне	селі	7
вашего	*вашего	вашого	6
мужчина	*мужчина	чоловік	6
мия	*мия	мія	6
клыки	*клыки	ікла	6
.	*домой	.	6
анджей	*анджей	анджей	6
»	*грушевка	»	6
красивой	*красивой	вродливою	6
вернётся	*вернётся	повернеться	6
бабочку	*бабочку	метелика	6
успел	*успел	встиг	6
задать	*задать	поставити	6
украли	*украли	вкрали	6
кен	*кен	кен	6
первобытный	*первобытный	первісна	6
думают	*вебмастеры	думають	6
предшествует	*предшествует	передує	6
и	*людских	та	6
кейт	*кейт	кейт	6
голубые	*голубые	очі	6
кимоно	*кимоно	кімоно	6
услышать	*услышать	почути	6
сленг	*сленг	сленг	6
блажей	*блажей	блажей	6
мягким	*мягким	м	6
казани	*казани	казані	6
франков	*франков	франків	6
префекта	*префекта	префекта	6
пожелать	*пожелать	приємного	6
.	*сердит	.	6
рождества	*рождества	різдва	6
предатель	*предатель	зрадник	6
бедки	*бедки	клопіт	6
были	*беженцев	були	6
наш	*наш	наша	6
,	*меленянах	,	6
яйца	*жарить	яйця	6
яблочный	*яблочный	яблучний	6
нидерланды	*нидерланды	нідерланди	6
бывает	*бывает	буває	6
-	*лайм	-	6
.	*пальто	.	6
свободное	*свободное	вільний	6
виноват	*виноват	винен	6
петя	*петя	пєтя	6
необходимо	*необходимо	необхідно	6
коул	*коул	коул	6
замужем	*замужем	одружена	6
нашим	*нашим	нашим	6
спросил	*ни	спитав	6
для	*шкаф	для	6
деном	*деном	деном	6
мило	*мило	міло	6
феррари	*феррари	феррарі	6
впадала	*впадала	впадала	6
валентино	*валентино	валентино	6
бабочки	*бабочки	метелики	6
мокрое	*мокрое	мокрого	6
пианино	*пианино	піаніно	6
предъявила	*предъявила	надала	6
лучшая	*лучшая	найкраща	6
гордон	*гордон	гордон	6
окунуть	*окунуть	скупати	6
гусеница	*гусеница	гусениця	6
жрёт	*жрёт	жере	6
мост	*мост	міст	6
поэтому	*поэтому	тому	6
лиллиэн	*лиллиэн	лілліен	6
зуза	*зуза	зуза	6
бейсбол	*бейсбол	бейсбол	6
классной	*классной	класній	6
обязанность	*обязанность	обов	6
джим	*джим	джим	6
чтобы	*грею	щоб	6
изучает	*изучает	вивчає	6
беларуси	*беларуси	білорусі	6
единственная	*единственная	єдина	6
поздравил	*поздравил	привітав	6
,	*подумал	,	6
майк	*майк	майк	6
спросил	*спросил	-	6
штатов	*штатов	штатів	6
укрыта	*укрыта	накрита	6
»	*михалово	»	6
против	*плыть	проти	5
метёт	*метёт	заміта	5
неудивительно	*неудивительно	дивно	5
метла	*метла	мітла	5
джуди	*джуди	джуді	5
уходит	*уходит	виходить	5
уныла	*уныла	нудна	5
,	*боязливые	,	5
.	*бабье	.	5
взял	*взял	втратив	5
франция	*франция	франція	5
дворовый	*дворовый	дворовий	5
свободными	*свободными	вільними	5
сфотографировать	*сфотографировать	сфотографувати	5
бред	*бред	маячіння	5
изобилие	*изобилие	багато	5
,	*спросил	,	5
красивые	*красивые	гарні	5
это	*теленок	це	5
вставать	*вставать	рано	5
слепая	*слепая	сліпа	5
мужественный	*мужественный	чоловіка	5
обеда	*до	обіду	5
закладок	*социальных	закладок	5
блейн	*блейн	блейне	5
изучи	*изучи	вивчи	5
здесь	*здесь	не	5
жутко	*жутко	люто	5
сыграй	*сыграй	зіграй	5
.	*благоденствовать	.	5
выпорхнет	*выпорхнет	випорхне	5
направляются	*направляются	у	5
уйти	*уйти	піти	5
пальто	*пальто	пальто	5
становились	*становились	таборах	5
грозовыми	*грозовыми	горобині	5
выглядит	*выглядит	виглядає	5
красивый	*красивый	гарний	5
свыкнись	*свыкнись	звикнути	5
уйти	*уйти	на	5
туда	*забиться	туди	5
ванной	*ванной	ванній	5
прохладно	*прохладно	прохолодно	5
ричард	*ричард	річарде	5
одноклассников	*одноклассников	однокласників	5
подумай	*подумай	подумай	5
возьмем	*возьмем	візьмемо	5
домовладелец	*домовладелец	домовласник	5
проложил	*проложил	проклала	5
переправлял	*переправлял	постачав	5
буй	*буй	буй	5
мокрая	*мокрая	мокрий	5
столько	*столько	стільки	5
кенгуру	*кенгуру	кенгуру	5
переносили	*переносили	переносили	5
приложиться	*приложиться	прикластися	5
взял	*взял	й	5
магнитофон	*магнитофон	магнітофон	5
вашему	*вашему	вашому	5
файтак	*файтак	файтак	5
давай	*другим	іншим	5
бабочка	*бабочка	метелик	5
транзитные	*транзитные	листи	5
саша	*саша	сашко	5
орала	*орала	орала	5
утки	*утки	качки	5
смокинг	*смокинг	смокінг	5
направляются	*сообщники	прямують	5
шестидесятилетний	*шестидесятилетний	шестидесятирічний	5
очередь	*последнюю	чергу	5
плитках	*плитках	плиткам	5
.	*прыгни	.	5
горит	*горит	горить	5
спросила	*спросила	спитала	5
липла	*липла	липув	5
уснуть	*уснуть	заснути	5
юми	*юми	юмі	5
брать	*брать	брати	5
,	*настойчива	,	5
ланд	*ланд	лунд	5
похожи	*похожи	схожі	5
заводишься	*заводишься	заводишся	5
антоним	*антоним	антонім	5
эй	*эй	гей	5
любом	*любом	будь-якому	5
девятичасовой	*девятичасовой	десятигодинний	5
юбки	*юбки	спіднички	5
силурийского	*силурийского	силурійського	5
,	*ехал	,	5
пребывания	*пребывания	у	5
некоторые	*некоторые	з	5
допотопными	*допотопными	тваринами	5
помни	*помни	пам	5
понравится	*понравится	сподобається	5
возраст	*возраст	вік	5
молния	*молния	блискавка	5
босс	*босс	босе	5
пропустить	*пропустить	пропустити	5
вкусные	*вкусные	страви	5
период	*ледниковый	період	5
будто	*будто	наче	5
одноразового	*прокомпостируйте	одноразового	5
спорить	*спорить	сперечатись	5
практичность	*практичность	практичність	5
повезло	*повезло	пощастило	5
,	*закладок	,	5
иван	*иван	іван	5
колумб	*колумб	колумб	5
шнайдером	*шнайдером	шнайдером	5
.	*скучаю	.	5
цыпленок	*цыпленок	курчатко	5
непрактичности	*непрактичности	непрактичності	5
опиум	*опиум	опіум	5
замечательный	*замечательный	чудового	5
пью	*пью	п'ю	5
джека	*джека	джека	5
обязательно	*обязательно	обов'язково	5
,	*полюбил	,	5
лиза	*лиза	ліза	5
проснулся	*проснулся	прокинувся	5
успеть	*успеть	встигнути	5
?	*сражается	?	5
жирке	*жирке	жирку	5
.	*племена	.	5
вашу	*вашу	вашу	5
одиноко	*одиноко	самотньо	5
ножницы	*ножницы	ножиці	5
курю	*курю	палю	5
грабитель	*грабитель	грабіжник	5
фрукты	*кислые	фрукти	5
какого	*какого	якого	5
всюду	*всюду	всюди	5
трубку	*трубку	слухавку	5
наполеона	*наполеона	наполеона	5
белиной	*белиной	белиної	5
для	*необходимы	для	5
—	*патрик	—	5
сценаристов	*гильдию	сценаристів	5
прекратится	*прекратится	до	5
встаю	*встаю	встаю	5
бабье	*москву	бабине	5
блузка	*блузка	блуза	5
пуста	*пуста	порожньо	5
мыть	*мыть	мити	5
курсовая	*курсовая	робота	5
вышла	*вышла	вийшла	5
ледников	*ледников	льодовиків	5
вышел	*вышел	вийшов	5
грязные	*грязные	брудне	4
некоторых	*некоторых	деяких	4
львы	*львы	леви	4
отрубил	*отрубил	відрубав	4
любовники	*любовники	на	4
сразился	*сразился	воював	4
кипяток	*кипяток	окріп	4
подвёз	*подвёз	підвезе	4
львове	*львове	львів	4
дней	*до	днів	4
мочить	*мочить	мочити	4
высока	*высока	висока	4
парижа	*парижа	парижа	4
волнуюсь	*волнуюсь	хвилююся	4
признался	*признался	зізнався	4
ехать	*ехать	поїхати	4
обожает	*обожает	обожнює	4
униформа	*униформа	уніформа	4
ближайшая	*ближайшая	найближча	4
испекла	*испекла	зробила	4
алматы	*алматы	алмати	4
жительства	*жительства	проживання	4
воровать	*воровать	красти	4
дочери	*три	доньки	4
холоднокровные	*холоднокровные	холоднокровні	4
»	*смородина	»	4
.	*пожениться	.	4
мост	*мост	мосту	4
.	*увидимся	.	4
.	*разрыдалась	.	4
минутку	*минутку	хвилинку	4
язычество	*язычество	язичництво	4
таневич	*таневич	танєвич	4
разве	*разве	вийнятком	4
ильза	*ильза	ільзо	4
,	*одноразового	,	4
двери	*двери	двері	4
паша	*паша	павло	4
посмешищем	*посмешищем	посміховиськом	4
пробуждает	*пробуждает	пробуджує	4
тихом	*тихом	тихому	4
смущён	*смущён	збентежений	4
спится	*спится	спиться	4
прикольно	*прикольно	прикольно	4
джеком	*джеком	джека	4
прикажете	*прикажете	накажете	4
мяч	*мяч	м	4
грабли	*грабли	граблі	4
покрасили	*покрасили	пофарбували	4
элеватор	*элеватор	елеватор	4
спрячься	*спрячься	в	4
к	*к	і	4
другой	*другой	інша	4
здесь	*здесь	буде	4
вредил	*вредил	шкодив	4
потому	*потому	тому	4
атаковал	*атаковал	атакував	4
выбежал	*выбежал	вибіг	4
медитировать	*медитировать	медитувати	4
чёрного	*чёрного	чорного	4
свободные	*свободные	вільні	4
мороженое	*мороженое	морозиво	4
вашингтон	*вашингтон	вашингтон	4
америку	*америку	америку	4
затонул	*затонул	затонув	4
свойственно	*свойственно	властиво	4
к	*к	у	4
дух	*захватывало	дух	4
полного	*полного	повного	4
люси	*люси	люсі	4
ваш	*ваш	твій	4
львов	*львов	львів	4
путает	*путает	плутає	4
.	*ложными	.	4
плакать	*плакать	плакати	4
помню	*помню	я	4
вместо	*вместо	замість	4
встревожилась	*встревожилась	занепокоїлася	4
медитировать	*медитировать	міркувати	4
завоевание	*завоевание	завоювання	4
старше	*старше	старіший	4
литва	*литва	литва	4
долькой	*долькой	долькою	4
классовые	*классовые	класові	4
вернется	*вернется	повернеться	4
к	*к	а	4
порылся	*порылся	порився	4
ржаветь	*ржаветь	ржавіти	4
древние	*древние	стародавні	4
преградил	*преградил	заступив	4
других	*других	інших	4
марок	*марок	марок	4
кислорода	*атома	кисню	4
мягкий	*мягкий	м	4
.	*болят	.	4
.	*косметика	.	4
выйти	*выйти	вийти	4
любезен	*любезен	люб	4
присутствует	*присутствует	на	4
.	*скучна	.	4
вырастила	*вырастила	виростила	4
миннесоте	*миннесоте	мінесоті	4
троих	*троих	дітей	4
мексикой	*мексикой	мексикою	4
читал	*читал	часом	4
отправляюсь	*отправляюсь	вирушаю	4
лиха	*лиха	хвацька	4
угодно	*угодно	завгодно	4
выдались	*выдались	видалися	4
звонила	*звонила	телефонувала	4
.	*ванная	.	4
львов	*львов	левів	4
сиськи	*сиськи	цицьок	4
стеснительные	*порочно	соромливі	4
угарте	*угарте	угарт	4
станка	*станка	станко	4
пожаловать	*пожаловать	просимо	4
золото	*украл	золото	4
поосторожней	*поосторожней	обережно	4
пойдемте	*пойдемте	пливемо	4
последнюю	*последнюю	в	4
старик	*старик	дід	4
дитятко	*дитятко	дитинко	4
лимон	*лимон	лимон	4
убежать	*убежать	втекти	4
шоколадное	*шоколадное	шоколадне	4
наших	*дожили	наших	4
.	*ушёл	.	4
китая	*китая	китаю	4
руководитель	*классный	керівник	4
очевиден	*очевиден	очевидна	4
поливает	*поливает	поливає	4
сосёт	*сосёт	ссе	4
клубе	*клубе	клубі	4
летать	*летать	літати	4
презирать	*презирать	зневажати	4
справится	*справится	впорається	4
брубейкер	*брубейкер	брубейкер	4
парочка	*парочка	парочка	4
цветомузыка	*цветомузыка	квіткоджаз	4
цену	*какую	ціну	4
к	*к	тварини	4
поплаваем	*поплаваем	поплаваємо	4
.	*купаться	.	4
парочкой	*парочкой	парою	4
позабочусь	*позабочусь	клопіт	4
употреблять	*употреблять	вживати	4
усыновили	*мэри	усиновили	4
.	*тост	.	4
посылать	*посылать	посилати	4
благоприятствовала	*благоприятствовала	сприяла	4
пчёл	*пчёл	бджіл	4
поступок	*поступок	поведінка	4
летающие	*летающие	літаючі	4
передохли	*передохли	поморилася	4
новости	*чудесные	новина	4
баночку	*баночку	ікри	4
джинсам	*джинсам	джинсів	4
водить	*водить	водити	4
бесследно	*бесследно	безслідно	4
бумаги	*бумаги	папери	4
удалось	*удалось	вдалося	4
.	*опаздывает	.	4
концентрационных	*концентрационных	в	4
кулешов	*аркадий	кулешов	4
татоэбе	*татоэбе	татоебі	4
изучают	*изучают	вивчають	4
свободна	*свободна	вільна	4
,	*футуролог	,	4
волнуйся	*волнуйся	хвилюйся	4
облачно	*облачно	хмарно	4
навестишь	*навестишь	не	4
толерантным	*толерантным	толерантним	4
задала	*задала	поставила	4
ласковый	*ласковый	покірливе	4
нила	*нила	ніла	4
купаться	*купаться	купатись	4
светит	*светит	світить	4
родители	*родители	батьки	4
задумайся	*задумайся	поміркуй	4
кулак	*железный	кулак	4
двоичная	*двоичная	двоїчне	4
прямом	*прямом	повному	4
красивы	*красивы	красиві	4
храпит	*храпит	сну	4
есть	*три	слуги	4
вернёшься	*вернёшься	повернешся	4
париж	*париж	парижу	4
скрылись	*скрылись	мить	4
почетные	*почетные	відомі	4
различия	*различия	відмінності	4
спросил	*спросил	спитав	4
небеси	*небеси	,	4
нашим	*нашим	не	4
простудился	*простудился	застудився	4
наручные	*наручные	наручний	4
телёнок	*телёнок	телятко	4
гадкий	*гадкий	гидке	4
древнейшая	*древнейшая	найдайвніше	4
готовься	*готовься	готуйся	4
произношение	*произношение	вимову	4
женился	*женился	оженився	4
запакуй	*запакуй	запакуйте	4
буди	*буди	буди	4
мистером	*мистером	містером	4
вытащил	*вытащил	витягнув	4
фал	*фал	фал	4
изобретать	*изобретать	винаходити	4
становишься	*становишься	стаєш	4
банное	*банное	банний	4
языков	*других	мов	4
предпочитаю	*предпочитаю	перевагу	4
жалко	*жалко	жаль	4
нарита	*нарита	наріта	4
кобыла	*кобыла	кобила	4
потрогаю	*потрогаю	до	4
связывает	*связывает	з	4
к	*к	його	4
нью-йорка	*нью-*йорка	нью-йорка	4
просыпаются	*просыпаются	рано	4
водил	*водил	водив	4
техас	*техас	техас	4
спикировал	*спикировал	на	4
гилисом	*гилисом	джиллісом	4
сноповяза	*сноповяза	скиртяра	4
остальным	*остальным	інших	4
нижней	*нижней	нижній	4
жирафов	*жирафов	мають	4
сомневаюсь	*сомневаюсь	сумніваюся	4
лебедем	*лебедем	лебедем	4
дочитал	*дочитал	дочитав	4
!	*хмельницкий	!	4
покладисты	*покладисты	покладливими	4
нашим	*нашим	містом	4
поступят	*поступят	вступлять	4
хотелось	*хотелось	хотілося	4
...	*черточек	...	4
тараканы	*тараканы	таргани	4
ричард	*ричард	річард	4
сортирах	*сортирах	сортирах	4
зефир	*зефир	зефір	4
билл	*билл	біл	4
пожмём	*пожмём	потиснемо	4
омуте	*омуте	болоті	4
тяжелая	*какая	важка	4
фоторобот	*фоторобот	фоторобот	4
белу	*белу	белу	4
устроитесь	*устроитесь	приживетесь	4
ибрагим	*ибрагим	ібрагім	4
утёнок	*утёнок	каченя	4
...	*следов	.	4
пахнет	*пахнет	пахне	4
водятся	*водятся	плодяться	4
,	*наш	,	4
чешется	*чешется	свербить	4
японец	*японец	японець	4
головы	*головы	голови	4
дождливые	*дождливые	дощові	4
батут	*батут	батут	4
вяленая	*вяленая	’	4
маток	*маток	маток	4
.	*мертв	.	4
японцев	*ездит	їздить	4
истории	*нашей	землі	4
красивое	*красивое	гарне	4
съездить	*съездить	поїхати	4
петра	*петра	петра	4
тропинка	*тропинка	стежка	4
улыбнулась	*улыбнулась	посміхнулася	4
нашему	*нашему	нашій	4
позже	*позже	пізніше	4
отправляется	*отправляется	відправляється	4
синим	*синим	синіх	4
отвратительно	*отвратительно	гидко	4
казак	*будто	би	4
жирке	*жирке	жиркові	4
.	*босса	.	4
граничит	*граничит	межує	4
спальни	*спальни	спальні	4
братиславу	*братиславу	братиславу	4
насчёт	*насчёт	щодо	4
нудным	*нудным	нудним	4
полной	*полной	повної	4
упаковал	*упаковал	спакував	4
сумерках	*сумерках	сутінках	4
мне	*загородило	мені	4
станислав	*станислав	станіслав	4
мономорфизм	*мономорфизм	мономорфізм	4
большущий	*большущий	величезний	4
карфаген	*карфаген	карфаген	4
понравился	*понравился	колір	4
.	*иномарка	.	4
сладко	*сладко	солодко	4
кодировка	*кодировка	кодування	4
просить	*просить	просити	4
аж	*высохли	аж	4
помню	*помню	пам'ятаю	4
переливать	*переливать	переливати	4
странное	*странное	назва	4
утраченным	*утраченным	втраченим	4
?	*ягода	?	4
фирменные	*фирменные	фірмовий	4
.	*кулешов	.	4
младше	*младше	набагато	4
изяществом	*изяществом	грацією	4
формалистской	*формалистской	формалістичною	4
портят	*портят	освіту	4
ржавым	*ржавым	іржавим	4
черное	*черное	чорне	4
обязан	*обязан	мусить	4
марсель	*марсель	марселя	4
пустого	*пустого	пустого	4
певица	*певица	співачка	4
телевизорные	*телевизорные	телевізійні	4
вечность	*вечность	вічність	4
братиславе	*братиславе	братиславі	4
гей	*гей	!	4
переговорил	*переговорил	побалакав	4
светится	*светится	світиться	4
неверных	*неверных	невірні	4
становится	*становится	все	4
остальные	*остальные	інші	4
зонтик	*зонтик	парасольку	4
встаёт	*встаёт	встає	4
антенны	*антенны	антени	4
насекомых	*насекомых	комах	4
туфель	*вместо	черевиків	4
небогатых	*небогатых	небегатих	4
пожалел	*пожалел	пошкодував	4
потащим	*потащим	потягнемо	4
восьми	*восьми	восьмої	4
пожениться	*пожениться	одружитися	4
микробам	*микробам	мікробам	4
зелёной	*зелёной	зеленою	4
заполучить	*заполучить	дістати	4
низине	*низине	низині	4
пьёшь	*пьёшь	п	4
атомов	*атомов	атомів	4
гитаре	*гитаре	гітарі	4
пиццу	*пиццу	піццу	4
танцует	*танцует	танцює	4
...	*лагун	...	4
карие	*карие	карі	4
машин	*капотах	машин	4
.	*туфель	.	4
производится	*производится	виробляється	4
порожнее	*порожнее	порожнє	4
заезжают	*заезжают	бувають	4
чашку	*чашку	чашку	4
.	*удастся	.	4
марки	*марки	марки	4
танцевал	*танцевал	танцював	4
полегче	*полегче	легше	4
убираться	*убираться	прибирати	4
мачете	*мачете	мачете	4
нашу	*нашу	нашу	4
и	*боязливые	і	4
наших	*наших	наших	4
производит	*производит	виробляє	4
перекатился	*перекатился	’	4
нара	*нара	нара	4
черточку	*черточку	риску	4
классное	*классное	чудовий	4
удостовериться	*удостовериться	впевнитися	4
бузина	*бузина	бузина	4
коем	*коем	якому	4
прощай	*прощай	бувай	4
губка	*губка	губка	4
детки	*детки	діти	4
пчёлах	*пчёлах	бджіл	4
гналась	*гналась	гналася	4
водяной	*домовой	водяник	3
уеду	*уеду	поїду	3
кролики	*кролики	кролі	3
прибираться	*прибираться	черга	3
изобрёл	*изобрёл	винайшов	3
успокоиться	*успокоиться	запокоїтись	3
иве	*иве	вербі	3
заплакала	*заплакала	заплакала	3
отправилась	*отправилась	відправилася	3
!	*наделал	!	3
ехать	*ехать	їхати	3
.	*спросил	.	3
скользкие	*скользкие	слизькі	3
грина	*грина	гріна	3
мальчишками	*мальчишками	хлопцями	3
кошечку	*кошечку	кошеня	3
встал	*встал	пізно	3
поклялся	*поклялся	присягнув	3
клином	*клином	клином	3
склонен	*склонен	схильний	3
становились	*становились	ставали	3
дневника	*нашего	щоденника	3
и	*рейха	i	3
корень	*корень	корінь	3
катя	*катя	катя	3
другой	*другой	у	3
,	*скучаем	,	3
лос-анджелес	*лос-*анджелес	лос-анжелеса	3
одеты	*одеты	вдягнені	3
нельзя	*нельзя	різати	3
размножаться	*размножаться	розмножуватися	3
эстонской	*эстонской	естонській	3
стружке	*стружке	стружці	3
иву	*иву	вербу	3
сербии	*сербии	сербії	3
шекспире	*шекспире	шекспіра	3
помоне	*помоне	помоні	3
карьеру	*карьеру	’	3
лилли	*лилли	ліллі	3
компактную	*компактную	компактну	3
и	*смолистая	і	3
перерезать	*перерезать	перерізувати	3
здесь	*здесь	ласка	3
берт	*берт	берт	3
вполне	*вполне	цілком	3
расслабиться	*расслабиться	розслабитися	3
вставать	*вставать	вставати	3
москве	*москве	москви	3
перекусить	*перекусить	вас	3
водоросли	*водоросли	водорості	3
морковь	*морковь	морква	3
поздравления	*поздравления	вітання	3
деревню	*деревню	сполучається	3
чёрные	*чёрные	чорні	3
растерялся	*растерялся	розгубився	3
сандаю	*сандаю	сандаю	3
добраться	*добраться	дістатися	3
обследован	*обследован	досліджено	3
разрушили	*разрушили	зруйнували	3
починить	*починить	полагодити	3
всякое	*всякое	всяке	3
антикватис	*антикватис	антікватіс	3
поговорить	*поговорить	говорити	3
читая	*читая	читаючи	3
погулять	*погулять	погуляти	3
горькое	*горькое	гіркі	3
голландец	*голландец	голландцю	3
бригаднику	*бригаднику	бригадникові	3
кончается	*кончается	закінчується	3
проговорили	*проговорили	проговорили	3
буерак	*буерак	байрак	3
задаёт	*задаёт	задає	3
хм	*хм	гм	3
сглаз	*сглаз	вроки	3
.	*получится	.	3
жрать	*жрать	жерти	3
рыбалку	*рыбалку	я	3
поищи	*поищи	пошукай	3
а	*мертвым	а	3
фотографии	*потрясающие	вражаючі	3
передумал	*передумал	передумав	3
несет	*несет	білі	3
.	*касабланку	.	3
другого	*другого	іншого	3
забронировала	*забронировала	забронювала	3
пострижена	*пострижена	підстрижена	3
подобрала	*подобрала	підняла	3
кондиционирование	*кондиционирование	кондиціонування	3
бумаги	*бумаги	паперу	3
поделилась	*поделилась	поділилася	3
ерунда	*ерунда	дрібниці	3
мег	*мег	мег	3
шанхайский	*шанхайский	шанхайський	3
твиттер	*твиттер	твітер	3
берн	*берн	берн	3
здравствуй	*здравствуй	привіт	3
производят	*производят	виготовляють	3
критическая	*критическая	критична	3
тафтс	*тафтс	тафтс	3
ушёл	*ушёл	пішов	3
.	*вернуть	.	3
воде	*к	,	3
потеряли	*потеряли	хто	3
хмурый	*хмурый	похмурий	3
учетной	*учетной	облікового	3
ручей	*ручей	струмок	3
выколи	*выколи	виколи	3
здравствует	*здравствует	живе	3
замуж	*вышла	заміжня	3
.	*тоньше	.	3
.	*чеки	.	3
посоветуйся	*посоветуйся	порадься	3
клин	*клин	клин	3
никакого	*никакого	жодного	3
изучаю	*изучаю	вивчаю	3
глупый	*глупый	дурна	3
чуть	*чуть	ледве	3
садись	*садись	сідай	3
подумайте	*подумайте	подумайте	3
установили	*установили	встановили	3
зеркальце	*зеркальце	люстерко	3
стеснительные	*стеснительные	у	3
учетную	*учетную	обліковий	3
мари	*мари	марі	3
лужи	*лужи	вулиці	3
и	*пиджак	і	3
возле	*возле	біля	3
дуная	*дуная	дунаю	3
красивые	*красивые	красиві	3
никаких	*никаких	ні	3
сломался	*сломался	зламався	3
китов	*китов	мають	3
проехав	*проехав	проїхавши	3
комары	*комары	комари	3
воруешь	*воруешь	крадеш	3
непостоянные	*непостоянные	непостійні	3
совершенству	*совершенству	досконалості	3
кролика	*кролика	кролика	3
празднуется	*празднуется	святкується	3
прогрессирует	*прогрессирует	прогресує	3
тыква	*тыква	гарбуз	3
хоть	*хоть	хоч	3
керамикой	*керамикой	керамікою	3
зрелая	*зрелая	зріла	3
опять	*опять	не	3
лжец	*лжец	брехун	3
другими	*другими	іншими	3
богдан	*богдан	богдан	3
гилис	*гилис	джилліс	3
жарко	*жарко	жарко	3
тратишь	*тратишь	витрачаєш	3
макароны	*макароны	макарони	3
рукав	*рукав	рукав	3
приложение	*приложение	додаток	3
пуншем	*пуншем	пуншем	3
рад	*рад	дуже	3
повлияет	*повлияет	на	3
мародеры	*мародеры	мародери	3
поехала	*поехала	поїхала	3
притворяется	*притворяется	удає	3
поприветствовала	*поприветствовала	привітала	3
сани	*сани	сани	3
закоулок	*закоулок	закуток	3
спросил	*спросил	запитав	3
замужем	*замужем	заміж	3
испекла	*испекла	приготувала	3
бирманских	*бирманских	бірманських	3
здесь	*здесь	,	3
томатным	*томатным	томатним	3
древо	*древо	дерево	3
третичный	*третичный	третинний	3
всякого	*всякого	усякої	3
поторопись	*поторопись	поквапся	3
надевал	*надевал	одягав	3
опаздывай	*опаздывай	запізнюйся	3
сходила	*сходила	розпачі	3
евангелина	*евангелина	євангеліна	3
ложным	*ложным	фальшивою	3
бегает	*бегает	бігає	3
исходными	*исходными	програмним	3
измученный	*измученный	змучений	3
голову	*голову	голову	3
проглотить	*проглотить	проковтнути	3
вредить	*вредить	шкодити	3
стюардессе	*стюардессе	стюардесою	3
кассетный	*кассетный	касетний	3
а	*мертвым	адже	3
блондинкой	*блондинкой	білявкою	3
мавр	*мавр	мавр	3
коньках	*коньках	ковзанах	3
посчитай	*посчитай	порахуй	3
сбил	*сбил	збило	3
пота	*пота	поту	3
потеряла	*потеряла	втратила	3
,	*скрипят	,	3
.	*ружья	.	3
оденься	*оденься	вдягнися	3
произнеся	*произнеся	вимовивши	3
вернись	*вернись	повернись	3
;	*днесь	;	3
солнцезащитные	*солнцезащитные	сонцезахисні	3
читаю	*читаю	читаю	3
генеалогическое	*генеалогическое	генеалогічне	3
головную	*головную	головний	3
беспечности	*беспечности	недбалості	3
рассыпались	*рассыпались	розсипалися	3
сдастся	*сдастся	здається	3
пальме	*пальме	пальмі	3
черный	*черный	чорний	3
.	*проветри	.	3
черешня	*черешня	черешня	3
подрыва	*подрыва	терплю	3
посмот	*посмот	подив	3
полна	*полна	повна	3
приемнике	*приемнике	приймач	3
спешу	*спешу	поспішаю	3
великая	*великая	велика	3
массаж	*массаж	масаж	3
опаздывал	*опаздывал	запізнювався	3
хочется	*хочется	хочеться	3
крестный	*крестный	хресний	3
дарёному	*дарёному	дарованому	3
поклонник	*поклонник	шанувальник	3
социальная	*социальная	"соціальна	3
вкусный	*вкусный	смачна	3
охотился	*охотился	полював	3
безумцу	*безумцу	безумцеві	3
сбежал	*сбежал	втік	3
пожелаете	*пожелаете	добре	3
неслабо	*неслабо	неслабо	3
поэтому	*поэтому	встановив	3
бурбон	*бурбон	бурбон	3
опустить	*опустить	опустити	3
европейцы	*европейцы	європейці	3
угощайся	*угощайся	пригощайся	3
словио	*словио	словіо	3
оставил	*угарте	залишив	3
становились	*тоньше	тоншим	3
наверстать	*наверстать	надолужити	3
садитесь	*садитесь	сідайте	3
руки	*дрожат	руки	3
тайский	*тайский	тайська	3
прослушала	*прослушала	прослухала	3
стёрт	*стёрт	стертий	3
настоящая	*настоящая	спражня	3
хламу	*хламу	брухту	3
камень	*камень	камінчик	3
воровал	*воровал	крав	3
небольшой	*небольшой	маленька	3
возницы	*возницы	візника	3
-	*остальные	-	3
крухулик	*крухулик	крухулик	3
мексиканский	*мексиканский	мексиканський	3
немцы	*немцы	німці	3
пышный	*пышный	пишний	3
последнее	*последнее	ти	3
поиграем	*поиграем	пограймо	3
гораздо	*гораздо	набагато	3
браться	*браться	братися	3
разногласия	*разногласия	розбіжності	3
грей	*грей	ґрей	3
пожалуйста	*садитесь	,	3
бирюза	*бирюза	бірюза	3
потеря	*потеря	втрата	3
удачи	*удачи	щастя	3
прямоугольна	*прямоугольна	,	3
чуть	*чуть	ледь	3
липнут	*к	до	3
вентиля	*вентиля	вентиля	3
яна	*яна	яно	3
оран	*оран	орана	3
тушкан	*тушкан	тушкан	3
починил	*починил	полагодив	3
нашего	*нашего	нашого	3
руа	*руа	руа	3
дю	*дю	де	3
купались	*купались	купалися	3
удаётся	*удаётся	вдається	3
поплавать	*поплавать	в	3
мэрилин	*мэрилин	мерілін	3
брунцвик	*брунцвик	брунцвік	3
эгоистична	*эгоистична	егоїстична	3
свыкнись	*свыкнись	звикай	3
несчастную	*несчастную	нещасне	3
—	*петровщина	—	3
насекомые	*насекомые	комахи	3
зацветёт	*зацветёт	заквітне	3
бездонный	*бездонный	бездонну	3
деревней	*деревней	селом	3
нервничает	*нервничает	нервує	3
порез	*порез	подряпина	3
возьму	*возьму	візьму	3
римляне	*римляне	римляни	3
карьеры	*карьеры	’	3
хоббитов	*хоббитов	гобітів	3
морковку	*морковку	морквину	3
.	*задумываюсь	.	3
строг	*строг	строгим	3
левую	*левую	ліву	3
половину	*отсняли	половину	3
уродливая	*уродливая	потворна	3
ароматом	*ароматом	пахощами	3
мужчинами	*мужчинами	чоловіками	3
преподаю	*преподаю	викладаю	3
мальчишки	*мальчишки	хлопці	3
произвели	*произвели	справили	3
блокнота	*блокнота	блокноти	3
ильза	*ильза	ільза	3
гилис	*гилис	гілліс	3
лучшего	*лучшего	хлопця	3
опаздывать	*опаздывать	запізнюватися	3
ни	*ни	ані	3
гулять	*гулять	гуляти	3
поприветствовать	*поприветствовать	привітати	3
неразглашении	*неразглашении	нерозголошення	3
ручья	*ручья	струмка	3
замечательное	*замечательное	чудовий	3
будда	*будда	будда	3
читает	*читает	читає	3
портсигар	*портсигар	портсигар	3
покончил	*покончил	вкоротив	3
устал	*устал	втомлений	3
швейцарии	*швейцарии	швейцарії	3
боязливые	*бываем	боязкі	3
дышу	*дышу	дишу	3
дождливая	*дождливая	дощова	3
забавно	*забавно	цікаво	3
лихо	*лихо	лихо	3
пропущу	*пропущу	чи	3
богат	*богат	багатий	3
различить	*различить	розрізнити	3
таиланде	*таиланде	тайланді	3
высмеивать	*высмеивать	висміювати	3
к	*к	ди	3
ни	*ни	»	3
какой	*какой	що	3
кролик	*кролик	білий	3
выслушай	*выслушай	вислухай	3
мери	*мери	мері	3
неизвестно	*неизвестно	невідоме	3
благородного	*благородного	шляхетної	3
разрушил	*разрушил	зруйнував	3
плыть	*плыть	плисти	3
отличить	*отличить	відрізнити	3
трубкой	*трубкой	люлькою	3
точнее	*точнее	точніше	3
переспал	*переспал	переспав	3
полетел	*полетел	полетів	3
убежал	*убежал	утік	3
рыжеватые	*рыжеватые	волосся	3
убраться	*убраться	прибрати	3
приложение	*приложение	застосунок	3
леший	*вурдалаки	лісовик	3
прибыл	*касабланку	прибув	3
коелодонт	*коелодонт	коелодонт	3
кладите	*кладите	кладіть	3
помине	*помине	промовка	3
бывает	*бывает	трапляється	3
придирается	*придирается	чіпляється	3
джунглях	*джунглях	джунглях	3
бабушка	*бабушка	бабусю	3
великий	*великий	чудовий	3
преддвериях	*преддвериях	небом	3
шествие	*шествие	хід	3
поклонников	*поклонников	прихильників	3
подхалимов	*подхалимов	підспівувачів	3
задавать	*задавать	ставити	3
вертится	*вертится	крутиться	3
какому	*какому	якій	3
собственный	*собственный	власні	3
.	*лежит	.	3
жуки	*жуки	жуки	3
собственно	*собственно	зізнаюсь	3
подлец	*подлец	покидьку	3
участия	*участия	участі	3
заполнять	*заполнять	сторінку	3
спешит	*спешит	поспішає	3
бетти	*бетти	беті	3
такова	*такова	така	3
спорят	*спорят	сперечаються	3
рулите	*рулите	керу	3
вредят	*вредят	шкодять	3
идиотка	*идиотка	ідіотка	3
шило	*шило	бика	3
снотворного	*снотворного	снодійного	3
засеяна	*засеяна	засіяна	3
полна	*полна	повен	3
исписал	*исписал	списав	3
другой	*другой	інший	3
очнитесь	*очнитесь	прокиньтеся	3
сына	*единственного	сина	3
глупые	*глупые	нерозумні	3
голландца	*голландца	голландця	3
апартаменты	*апартаменты	апартаменти	3
,	*откладывал	а	3
юбки	*юбки	спідниці	3
белорусский	*изучает	білоруську	3
бритв	*бритв	лез	3
взял	*взял	узяв	3
меленяны	*меленяны	меленян	3
джордж	*джордж	джордж	3
выбивают	*выбивают	вишибають	3
поспать	*поспать	поспати	3
возраста	*возраста	віку	3
был	*америке	америці	3
нам	*даждь	нам	3
хлестала	*хлестала	сікла	3
чая	*чая	чаю	3
вылечил	*вылечил	вилікував	3
шкафах	*шкафах	шафі	3
»	*зелёная	»	3
хоббайт	*хоббайт	гобайт	3
товарного	*товарного	товарного	3
пообедали	*пообедали	пообідали	3
плыви	*плыви	пливи	3
милая	*милая	мила	3
задержался	*задержался	затримався	3
скучаю	*скучаю	скучаю	3
нянек	*нянек	няньок	3
последняя	*последняя	остання	3
старался	*старался	намагався	3
соусом	*соусом	соусом	3
,	*кен	,	3
булочной	*булочной	хлібному	3
поначалу	*поначалу	спочатку	3
насмешкам	*насмешкам	кпинів	3
вино	*вино	пиво	3
дударева	*дударева	дударева	3
помойте	*помойте	вимийте	3
ошибся	*ошибся	помилився	3
стиральная	*стиральная	пральна	3
непрактичное	*непрактичное	непрактична	3
какое	*какое	як	3
беле	*беле	белі	3
достать	*удалось	дістати	3
венецию	*венецию	венеції	3
осенила	*осенила	прийшла	3
привидения	*привидения	примари	3
конкурирует	*конкурирует	конкурує	3
бутылочку	*бутылочку	пляшки	3
высшая	*высшая	остаточна	3
тони	*тони	має	3
ужарил	*ужарил	вдарив	3
жгучей	*жгучей	пекучої	3
ранние	*ранние	ранні	3
никакого	*никакого	ні	3
становится	*становится	стає	3
постучал	*постучал	постукав	3
жениться	*жениться	одружитися	3
режут	*режут	ріжуть	3
спросить	*спросить	спитати	3
яна	*яна	яна	3
заполнять	*заполнять	першу	3
шляпа	*шляпа	капелюх	3
наше	*наше	наше	3
проплывали	*проплывали	пливли	3
подумали	*подумали	подумали	3
ах	*ах	ах	3
стеснялся	*стеснялся	соромився	3
свободен	*свободен	вільний	3
клубника	*клубника	полуниця	3
медикаменты	*медикаменты	медикаменти	3
молодые	*молодые	молоді	3
читаю	*читаю	з	3
женда	*женда	жендо	3
атами	*атами	атамі	3
целительница	*целительница	цілительниця	3
уехал	*уехал	поїхав	3
потому	*потому	через	3
пиклз	*пиклз	піклз	3
.	*касабланке	.	3
нашей	*до	до	3
иврите	*иврите	івриті	3
меряет	*меряет	міряє	3
обязательно	*обязательно	"обов'язково	3
вурдалаки	*водяной	вовкулаки	3
силура	*силура	силуру	3
других	*других	країнах	3
ёко	*ёко	йоко	3
поскорее	*поскорее	скоріше	3
какая	*какая	який	3
попросил	*попросил	попросив	3
похолодает	*похолодает	похолодає	3
.	*к	.	3
солнцезащитные	*солнцезащитные	сонячні	3
кишки	*кишки	кишки	3
заводь	*заводь	затока	3
развести	*развести	розвести	3
исключительно	*питаются	виключно	3
французы	*французы	французи	3
обсохнуть	*обсохнуть	обсохнути	3
-	*жневником	-	3
поцарапало	*поцарапало	пошкрябало	3
великим	*великим	великим	3
альто	*альто	альто	3
нашей	*нашей	нашого	3
франции	*франции	.	3
,	*травмирован	,	3
мечтаешь	*мечтаешь	мрієш	3
несла	*несла	несла	3
догадывался	*догадывался	здогадувався	3
попался	*попался	попався	3
.	*наших	.	3
покровительством	*покровительством	сприяння	3
чертят	*чертят	черкають	3
.	*резать	.	3
бездянкой	*бездянкой	бездянкою	3
костра	*костра	багаття	3
поумнел	*поумнел	помудрішала	3
наилучший	*наилучший	найкращий	3
буханку	*буханку	буханця	3
синяя	*синяя	синя	3
навестить	*навестить	провідати	3
уйду	*уйду	піду	3
тайфун	*тайфун	тайфун	3
читал	*читал	читав	3
чаша	*чаша	келих	3
шипов	*шипов	шипів	3
свет	*выключится	світло	3
это	*откладывал	це	3
они	*каковы	ми	3
подбежала	*подбежала	підбіг	3
меленянах	*меленянах	меленяни	3
одолжил	*одолжил	його	3
уподобляйся	*уподобляйся	уподібнюйся	3
.	*кончается	.	3
подскользнитесь	*подскользнитесь	посковзніться	3
потрясающей	*потрясающей	запаморочливою	3
вода	*льётся	ллється	3
поклонница	*поклонница	шанувальниця	3
.	*заглянули	.	3
канадка	*канадка	канадка	3
последнюю	*последнюю	останній	3
ругайся	*ругайся	лайся	3
что	*пообедал	пообідав	3
серийная	*серийная	серійна	3
нидо	*нидо	нідо	3
паразитирую	*паразитирую	паразитую	3
веранду	*веранду	веранду	3
плачешь	*плачешь	плачеш	3
захватчики	*захватчики	викрадачі	3
приговорены	*приговорены	засуджені	3
средиземное	*средиземное	середземне	3
возле	*возле	коло	3
восьмидесятых	*восьмидесятых	вісімдесятих	3
выхлопными	*выхлопными	вихлопними	3
штормовое	*штормовое	штормове	3
равнодушен	*равнодушен	байдужий	3
монро	*монро	монро	3
красивые	*красивые	"гарні	3
жюля	*жюля	жюля	3
поступили	*поступили	вчинили	3
поступить	*поступить	вступити	3
потерять	*потерять	втратити	3
залезайте	*залезайте	залазьте	3
ушла	*ушла	пішла	3
коронёром	*коронёром	коронером	3
отлагательства	*отлагательства	зволікання	3
трилобитов	*трилобитов	трилобітів	3
порносайт	*порносайт	порносайт	3
полчаса	*полчаса	півгодини	3
бурые	*бурые	бурі	3
всю	*украсть	всю	3
какое	*какое	яка	3
ушиб	*ушиб	забив	3
.	*устал	.	3
женюсь	*женюсь	одружуся	3
танабата	*танабата	танабата	3
джозеф	*джозеф	джозеф	3
—	*дэн	—	3
плевал	*плевал	раз	3
анжелика	*анжелика	анжеліка	3
оденемся	*оденемся	одягнутись	3
афины	*афины	афін	3
поедет	*поедет	поїде	3
бесчисленное	*бесчисленное	незлічена	3
женаты	*женаты	одружені	3
пахнут	*пахнут	пахнуть	3
простые	*простые	прості	3
радостней	*радостней	радісніший	3
спалось	*спалось	заснути	3
потребуется	*потребуется	знадобиться	3
уладьте	*уладьте	владнайте	3
заключённые	*заключённые	’	3
геттер	*геттер	ґеттер	3
зацветает	*папоротник	папороть	3
микроскопом	*микроскопом	мікроскопом	3
роста	*невысокого	зросту	3
и	*первооткрыватели	і	3
дима	*дима	діма	3
инъективный	*инъективный	ін'єктивний	3
опаздывает	*опаздывает	запізнюється	3
орест	*орест	орест	3
наклонилась	*наклонилась	нахилилася	3
оглядел	*оглядел	оглянув	3
камина	*камина	каміна	3
напрокат	*напрокат	напрокат	3
.	*отделяет	.	3
отцвели	*отцвели	відцвіли	3
палеозойскую	*палеозойскую	палеозойську	3
некоторые	*некоторые	дехто	3
рада	*рада	задоволенням	3
полагают	*полагают	вважається	3
начерти	*начерти	накресли	3
засыпать	*засыпать	засипати	3
другое	*другое	інша	3
чанг	*чанг	чанг	3
боже	*боже	боже	3
пелёнках	*пелёнках	в	3
огромный	*огромный	проміжок	3
роксолана	*роксолана	роксолана	3
промокли	*промокли	намокли	3
поговорить	*поговорить	про	3
.	*млекопитающие	.	3
бригадирши	*бригадирши	бригадниці	3
месье	*месье	мосьє	3
понадобится	*понадобится	знадобиться	3
пташки	*пташки	пташки	3
терпит	*терпит	терпить	3
убежала	*убежала	втекла	3
головы	*головы	на	3
лучших	*лучших	найкращих	3
жирки	*жирки	жирка	3
скучал	*скучал	мною	3
женат	*женат	одружений	3
черный	*черный	чорну	3
джил	*джил	джил	3
штатах	*штатах	штатах	3
убежал	*убежал	втік	3
перемен	*перемен	змін	3
ильзу	*ильзу	ільзу	3
сноповяз	*сноповяз	скиртяр	3
.	*избави	.	3
подвинуть	*подвинуть	посунути	3
три	*три	години	3
позавтракать	*позавтракать	поснідати	2
иже	*иже	єси	2
поживаешь	*поживаешь	справи	2
непростой	*непростой	непростий	2
форматировать	*форматировать	форматувати	2
юбка	*юбка	спідниця	2
якоже	*наша	і	2
удел	*удел	доля	2
никакого	*никакого	ніякого	2
барс	*барс	барс	2
повзрослел	*повзрослел	подорослішав	2
прижми	*прижми	тримай	2
искусственные	*искусственные	штучні	2
голубые	*голубые	блакитні	2
сухопутных	*сухопутных	наші	2
сырая	*сырая	сира	2
пекин	*пекин	пекін	2
хорхе	*хорхе	хорхе	2
орет	*орет	волає	2
деревню	*деревню	по	2
потерялся	*потерялся	загубився	2
возница	*возница	візник	2
токийский	*токийский	токійський	2
черная	*черная	чорна	2
до	*до	побачимось	2
мицкевича	*мицкевича	міцкевича	2
пересказываю	*пересказываю	переказую	2
ванг	*ванг	ванг	2
поэтому	*поэтому	не	2
возрасте	*возрасте	віці	2
мордочки	*мордочки	мордочки	2
узбекскую	*узбекскую	узбецьку	2
до	*до	.	2
неся	*неся	несучи	2
меня	*ненавидишь	мене	2
закурить	*закурить	запалити	2
ме	*ме	,	2
переговоров	*переговоров	перемовин	2
амфитриты	*амфитриты	,	2
хваталку	*хваталку	хваталку	2
ближнего	*ближнего	ближнього	2
помнишь	*помнишь	пам'ятаєш	2
буддизм	*буддизм	буддизм	2
пробке	*пробке	пробці	2
увидятся	*увидятся	побачаться	2
рейх	*рейх	рейх	2
марка	*марка	марка	2
посвечу	*посвечу	посвічу	2
трубку	*трубку	тютюн	2
парамаунта	*парамаунта	парамаунту	2
терплю	*терплю	переношу	2
поспешил	*поспешил	поквапився	2
забронировали	*забронировали	забронювали	2
председателя	*председателя	голову	2
каком	*каком	в	2
вернулся	*вернулся	вернувся	2
уважительные	*уважительные	вагомі	2
,	*подумал	подумав	2
рассмеяться	*рассмеяться	розсміятися	2
танака	*танака	танака	2
выпрашивать	*выпрашивать	випрошувати	2
времен	*до	часів	2
сам	*носить	сам	2
старше	*старше	за	2
споём	*споём	заспіваємо	2
мари	*мари	завершила	2
понятны	*понятны	зрозумілими	2
покачивается	*покачивается	гойдається	2
малибу	*малибу	малібу	2
свяжите	*свяжите	"зв'яжіть	2
гамлета	*гамлета	гамлета	2
выкрутить	*выкрутить	викрутити	2
избавиться	*избавиться	позбутися	2
поймал	*поймал	його	2
потрясающе	*потрясающе	потрясно	2
эпохальная	*эпохальная	епохальна	2
крупный	*крупный	розводить	2
потянулся	*потянулся	потягнувся	2
джеймс	*джеймс	джеймс	2
огурец	*огурец	огірок	2
согласились	*согласились	погодилися	2
покачал	*покачал	кілька	2
протрезел	*протрезел	протверезів	2
львов	*львов	львова	2
здравствуй	*здравствуй	вітаю	2
татоэба	*татоэба	татоеба	2
неразумно	*неразумно	нерозумно	2
хироси	*хироси	хіросі	2
старика	*старика	старого	2
познакомились	*познакомились	познайомилися	2
попробуем	*попробуем	спробуємо	2
плюшевая	*плюшевая	іграшка	2
предпочитаете	*предпочитаете	або	2
постой	*постой	чекай	2
матрос	*матрос	матрос	2
дядька	*дядька	дядько	2
весили	*весили	важили	2
познаются	*познаются	пізнаються	2
грамматически	*грамматически	граматично	2
холера	*холера	холера	2
насекомое	*насекомое	ця	2
несмотря	*несмотря	не	2
богата	*богата	багата	2
боюсь	*боюсь	боюсь	2
решился	*решился	зважився	2
другой	*другой	,	2
до	*до	на	2
шапку	*шапку	шапку	2
разрушен	*разрушен	зруйнований	2
вылетает	*вылетает	відлітає	2
женат	*женат	чи	2
мэри	*мэри	,	2
сэма	*сэма	піаніно	2
маркони	*маркони	марконі	2
насчёт	*насчёт	до	2
способен	*способен	здатен	2
успокоиться	*успокоиться	заспокоїтись	2
скобки	*скобки	дужки	2
исправишь	*исправишь	виправиш	2
какой	*какой	яку	2
другим	*другим	іншим	2
нарывался	*нарывался	наривався	2
мороженное	*мороженное	морозиво	2
взяла	*взяла	взяла	2
укусит	*укусит	одно	2
младшая	*младшая	молодша	2
мелодичен	*мелодичен	милозвучна	2
к	*к	сестри	2
установил	*установил	його	2
филипп	*филипп	філіпе	2
лунатик	*лунатик	сновида	2
полной	*полной	повній	2
штрассе	*штрассе	штрассер	2
попросил	*попросил	попрохав	2
энн	*энн	енн	2
замерли	*замерли	завмерли	2
ни	*ни	відповісти	2
захотите	*захотите	схочете	2
пейджер	*пейджер	пейджер	2
поймали	*поймали	зловили	2
панды	*панды	панди	2
джим	*джим	джиме	2
измерь	*измерь	зміряй	2
биллу	*биллу	біллу	2
докладывали	*докладывали	пари	2
садись	*садись	оідай	2
диваном	*диваном	канапою	2
леший	*леший	русалки	2
здешними	*здешними	тутейшими	2
вашим	*вашим	вашими	2
гей	*гей	ґей	2
дориана	*дориана	доріана	2
механизатор	*механизатор	механізатор	2
перемене	*перемене	зміни	2
форду	*форду	форду	2
средиземном	*средиземном	середземному	2
долги	*остави	нас	2
искупаться	*искупаться	купатись	2
наше	*наше	наша	2
горько	*горько	гірко	2
одета	*одета	вдягена	2
диалект	*диалект	,	2
моста	*моста	мосту	2
согласиться	*согласиться	погодитись	2
другой	*другой	але	2
наслушались	*наслушались	чули	2
значку	*значку	значку	2
галгаш	*галгаш	галгаш	2
перекуют	*перекуют	перекують	2
поймали	*поймали	упіймали	2
плаванье	*плаванье	плавання	2
стряслось	*стряслось	там	2
новоявленный	*новоявленный	новоспечена	2
риком	*риком	ріком	2
врождённая	*врождённая	природжена	2
стараться	*стараться	усієї	2
прошептал	*прошептал	прошепотів	2
последним	*последним	останнім	2
китае	*китае	китаї	2
.	*воевать	.	2
потрясающая	*потрясающая	потрясна	2
ложиться	*ложиться	лягати	2
майка	*майка	майка	2
настоящее	*настоящее	оце	2
рассудит	*рассудит	покаже	2
диалект	*диалект	це	2
единственные	*единственные	вважаємо	2
сноповязом	*сноповязом	скиртяром	2
блейна	*мистера	блейна	2
достаточных	*достаточных	достатніх	2
подумают	*подумают	за	2
камешки	*камешки	камінці	2
происшествию	*происшествию	події	2
ослом	*ослом	віслюком	2
убежала	*убежала	утік	2
!	*нашим	!	2
чикаго	*чикаго	чикаґо	2
чашкой	*чашкой	чашкою	2
прыгай	*прыгай	отрибай	2
моет	*моет	миє	2
невиновна	*невиновна	невинна	2
взял	*взял	легко	2
солгал	*солгал	збрехав	2
кена	*кена	кена	2
невежества	*невежества	за	2
укололась	*укололась	вкололась	2
вылечить	*вылечить	вилічити	2
крупным	*крупным	великим	2
наливай	*наливай	наливай	2
дракон	*дракон	дракон	2
удалить	*удалить	видалити	2
посторонним	*посторонним	стороннім	2
ногти	*ногти	і	2
потеряно	*потеряно	втрачено	2
пиццу	*пиццу	піцу	2
обманчива	*обманчива	оманлива	2
придумывал	*придумывал	придумував	2
смастерили	*смастерили	змайстрували	2
нашим	*нашим	прости	2
баскетбол	*баскетбол	баскетбол	2
поучительное	*поучительное	повчальне	2
лекарства	*лекарства	ліки	2
наплевать	*наплевать	начхати	2
аисты	*аисты	лелеки	2
транслитерацию	*транслитерацию	транслітерацію	2
присмотришь	*присмотришь	подбаєш	2
постарался	*постарался	намагатимуся	2
крупный	*рогатый	велику	2
замечательная	*замечательная	чудова	2
ко	*ко	зі	2
обое	*обое	обоє	2
пятом	*пятом	п'ятому	2
яндекс	*яндекс	яндекс	2
ошибиться	*ошибиться	помилитися	2
к	*к	будь-яка	2
малейшего	*малейшего	найменшого	2
пьёшь	*пьёшь	п'єш	2
сибуе	*сибуе	сібуя	2
великих	*великих	великих	2
циркулем	*циркулем	циркулем	2
постарше	*постарше	жінці	2
обязанностей	*обязанностей	на	2
чернильное	*чернильное	чорнильна	2
начеку	*начеку	напоготові	2
мертвого	*мертвого	мертвого	2
вращаются	*вращаются	обертаються	2
пульт	*пульт	пульт	2
покрыт	*покрыт	покрита	2
звонят	*звонят	церковні	2
свинец	*свинец	свинець	2
колебался	*колебался	вагався	2
застегни	*застегни	застібни	2
будильник	*будильник	будильник	2
мнения	*мнения	думки	2
яблони	*яблони	яблуньки	2
задуматься	*задуматься	задуматися	2
огромная	*огромная	величезна	2
альпийские	*альпийские	альпійськи	2
парагвай	*парагвай	парагвай	2
читала	*читала	читав	2
полная	*полная	повна	2
осчастливил	*осчастливил	ощасливив	2
абдул	*абдул	абдуле	2
трое	*трое	троє	2
отменяет	*отменяет	змінює	2
другие	*другие	інакші	2
спешила	*спешила	поспішала	2
старше	*старше	старший	2
развлекательная	*развлекательная	розважальна	2
,	*киборг	,	2
храни	*храни	храни	2
твиттер	*твиттер	''	2
жребий	*жребий	жереб	2
предпочитают	*предпочитают	перевагу	2
про	*собственную	власну	2
одень	*одень	надінь	2
ух	*ух	ух	2
мечтаю	*мечтаю	мрію	2
примерно	*примерно	якому	2
вернётесь	*вернётесь	повернетеся	2
строчки	*строчки	рядка	2
потерял	*потерял	,	2
плывут	*плывут	пливуть	2
наивный	*наивный	наївний	2
понтона	*понтона	понтону	2
помню	*помню	"я	2
возлюби	*возлюби	полюби	2
воевала	*воевала	воювала	2
расплачусь	*расплачусь	якщо	2
драгоценные	*драгоценные	дорогоцінне	2
барахлит	*барахлит	барахлить	2
одевай	*одевай	одягай	2
дверь	*дверь	дверi	2
хочется	*хочется	хочу	2
вылезайте	*вылезайте	вилазьте	2
зарплата	*низкая	зарплатня	2
осколки	*осколки	осколки	2
спускай	*спускай	спускай	2
к	*к	додачу	2
патчем	*патчем	dmenu	2
советолог	*советолог	совєтолог	2
зонтик	*зонтик	парасоля	2
испугался	*испугался	злякався	2
становились	*становились	все	2
прилежнее	*прилежнее	старанніше	2
когда-то	*здесь	колись	2
разобрать	*разобрать	розібрати	2
отнимает	*отнимает	в	2
гитаристом	*гитаристом	гітаристом	2
каком	*каком	якому	2
тварь	*тварь	тварюка	2
несчастных	*несчастных	нещасних	2
штора	*штора	штора	2
тихая	*тихая	тиха	2
какому	*какому	якому	2
трус	*трус	боягузе	2
ни	*ни	було	2
посылаю	*посылаю	надсилаю	2
особа	*особа	особою	2
опоздаете	*опоздаете	пропустите	2
типичный	*типичный	типовий	2
присядьте	*присядьте	cідайте	2
какая	*какая	яке	2
правит	*правит	керує	2
обманули	*обманули	ошукали	2
тратьте	*тратьте	втрачайте	2
наш	*наш	він	2
умоляю	*умоляю	благаю	2
рыбалку	*рыбалку	,	2
вернитесь	*вернитесь	повертайтесь	2
звонят	*звонят	дзвонять	2
поглощена	*поглощена	поглинена	2
постою	*постою	постою	2
останавливайтесь	*останавливайтесь	зупиняйтеся	2
выпускные	*выпускные	випускні	2
противоположность	*противоположность	протилежність	2
лицемер	*лицемер	лицемір	2
красивой	*красивой	прекрасна	2
сенная	*сенная	сінна	2
ставить	*ставить	складати	2
похож	*похож	схожий	2
подснежники	*подснежники	проліски	2
заноза	*заноза	скалка	2
лестнице	*лестнице	йти	2
получилось	*получилось	вийшло	2
к	*к	доступ	2
настоящая	*настоящая	справжнє	2
эй	*эй	що	2
,	*бизонов	і	2
.	*внешнеэкономическим	.	2
пирожки	*пирожки	пиріжки	2
дебил	*дебил	дебіл	2
осмеливаетесь	*осмеливаетесь	насмілюєтеся	2
согласен	*согласен	погоджуюсь	2
зеландии	*зеландии	зеландії	2
другие	*другие	тебе	2
возле	*возле	при	2
радостный	*радостный	радісний	2
белая	*другая	біла	2
падает	*падает	падає	2
подготовилась	*подготовилась	підготувалася	2
итальянцы	*итальянцы	італійці	2
попробовать	*попробовать	скуштувати	2
палуба	*палуба	палуба	2
списывал	*списывал	списував	2
футов	*футов	футів	2
опоздал	*опоздал	сьогодні	2
признателен	*признателен	вдячний	2
несмотря	*несмотря	незважаючи	2
дурацкого	*дурацкого	ідіотського	2
сандвичей	*сандвичей	лишилось	2
рвётся	*рвётся	рветься	2
смородина	*черная	?	2
двуокись	*двуокись	двуокис	2
пани	*пани	пані	2
собственного	*собственного	соромно	2
«	*звучит	звучить	2
крупные	*крупные	існують	2
коулом	*гордоном	коула	2
стрела	*стрела	стріла	2
этакой	*этакой	отакої	2
берут	*берут	беруть	2
витамины	*витамины	вітаміни	2
стричь	*стричь	нігті	2
изучать	*изучать	латинь	2
сердится	*сердится	сердиться	2
гадко	*гадко	бридко	2
древние	*древние	давні	2
поймана	*поймана	спіймана	2
лиссабоне	*лиссабоне	лісабоні	2
впустую	*впустую	намарно	2
бе	*бе	бе	2
моррис	*моррис	морріс	2
чтобы	*грею	аж	2
сеньора	*сеньора	сеньйора	2
дастин	*дастин	дастін	2
вышли	*вышли	вийшли	2
становились	*становились	ставало	2
плывет	*плывет	пливе	2
согласен	*согласен	згоден	2
раздражительный	*раздражительный	роздратованою	2
ваших	*ваших	!	2
порисовать	*порисовать	помалювати	2
одолжить	*одолжить	мені	2
сверкнула	*сверкнула	блиснула	2
ведра	*ведра	!	2
даждь	*насущный	насущний	2
заболел	*заболел	захворів	2
какой	*какой	якою	2
,	*бизонов	бізонів	2
префект	*префект	перфект	2
придти	*придти	прийти	2
окончил	*окончил	закінчив	2
летают	*летают	літають	2
понятны	*любой	будь-якій	2
ржавое	*ржавое	іржаве	2
каникулах	*едут	канікули	2
пахнет	*пахнет	смачно	2
вышивания	*вышивания	вишивання	2
ушли	*ушли	пішли	2
горит	*горит	палає	2
потерянный	*потерянный	загублений	2
плюнуть	*плюнуть	простого	2
смей	*смей	смій	2
отчитываться	*отчитываться	звітувати	2
починил	*починил	поремонтував	2
глупый	*глупый	дурне	2
гладить	*гладить	прасувати	2
карьеру	*карьеру	музичну	2
сексуален	*сексуален	сексуальний	2
маркс	*маркс	маркс	2
странное	*странное	дивний	2
потеря	*потеря	часу	2
.	*верхней	.	2
ухватился	*ухватился	схопився	2
выглядят	*выглядят	виглядає	2
.	*трилобитами	.	2
караулить	*караулить	чатувати	2
сдвинем	*сдвинем	зрушимо	2
,	*боязливые	і	2
диван	*диван	диван	2
липнут	*липнут	липнуть	2
отражалась	*отражалась	відбивався	2
бездянки	*бездянки	бездянки	2
саранча	*саранча	саранча	2
банан	*банан	банан	2
московиц	*московиц	московиц	2
настоящий	*настоящий	справжня	2
рыбалкой	*рыбалкой	рибальством	2
прошу	*прошу	перепрошую	2
обыскался	*обыскался	обшукався	2
ни	*ни	ни	2
незнакомцев	*незнакомцев	незнайомців	2
.	*пить	.	2
бельгии	*бельгии	бельгії	2
браузер	*браузер	оглядач	2
сомненья	*сомненья	сумніву	2
пробежал	*пробежал	пробіг	2
помолчи	*помолчи	помовчи	2
висит	*висит	висить	2
выклюет	*выклюет	виклює	2
лежал	*лежал	лежав	2
щётку	*щётку	щітку	2
анна	*анна	ганна	2
взяться	*взяться	взятися	2
однажды	*однажды	дня	2
настанет	*настанет	настане	2
берлине	*берлине	берліні	2
сердись	*сердись	сердся	2
мистер	*мистер	спитав	2
.	*коулом	.	2
польше	*польше	польщі	2
иероглифы	*иероглифы	ієрогліфи	2
мель	*здесь	мілина	2
воде	*к	води	2
смит	*смит	сміт	2
пью	*пью	,	2
колокола	*колокола	дзвонять	2
зелёный	*зелёный	зелений	2
других	*других	у	2
закричала	*закричала	закричала	2
оглянись	*оглянись	подивись	2
бабушка	*бабушка	бабуся	2
варьируется	*варьируется	коливається	2
пароме	*пароме	паромі	2
японцы	*японцы	японці	2
доброту	*доброту	доброту	2
шерстистые	*шерстистые	вовнисті	2
предназначена	*предназначена	призначена	2
нюнорска	*нюнорска	для	2
услышав	*услышав	почувши	2
знамо	*знамо	відома	2
вернётесь	*вернётесь	вернетеся	2
спорили	*спорили	сперечалися	2
согласна	*согласна	згодна	2
исияма	*исияма	ісіяма	2
синий	*синий	синій	2
спрыгнул	*спрыгнул	зстрибнув	2
полагаю	*полагаю	вважаю	2
пьёте	*пьёте	п'єте	2
несмотря	*несмотря	на	2
милая	*милая	люба	2
болячка	*болячка	болячка	2
сбрасывать	*сбрасывать	у	2
сыпь	*сыпь	висип	2
шелохнется	*шелохнется	рушить	2
приметы	*приметы	прикмети	2
неподвижно	*неподвижно	нерухомо	2
!	*мотоцикл	!	2
трилобита	*трилобита	трилобіта	2
учительницей	*учительницей	вчительку	2
пуговицы	*пуговицы	ґудзики	2
забавную	*забавную	кумедну	2
замуж	*вышла	,	2
боялась	*боялась	боялася	2
оправдались	*оправдались	справдилися	2
карл	*карл	карл	2
путешествовал	*путешествовал	подорожував	2
сегодняшний	*сегодняшний	сьогоднішній	2
мамонта	*мамонта	мамонта	2
меленянское	*меленянское	меленянське	2
осколки	*осколки	уламки	2
неверен	*неверен	невірна	2
давненько	*давненько	давно	2
америку	*америку	америки	2
дешевле	*дешевле	був	2
развлекались	*развлекались	розважалися	2
другая	*другая	інша	2
смеешь	*смеешь	смієш	2
здравствуйте	*здравствуйте	вітаю	2
туфли	*туфли	черевики	2
показались	*показались	здалися	2
переодеться	*переодеться	перевдягнутися	2
порядочных	*порядочных	вчинках	2
задолбалась	*задолбалась	задовбало	2
запонки	*запонки	запонки	2
обернулась	*обернулась	обернулася	2
кролик	*кролик	заєць	2
наши	*наши	речі	2
поменяетесь	*поменяетесь	поміняєтесь	2
жали	*жали	жали	2
евгений	*евгений	євген	2
.	*остальных	.	2
глядя	*глядя	на	2
прислужиться	*прислужиться	прислужитись	2
питательно	*питательно	поживне	2
тадеуш	*тадеуш	тадеуш	2
гордимся	*гордимся	гордуємо	2
сортируют	*сортируют	сортують	2
пауков	*пауков	павуків	2
улыбнись	*улыбнись	посміхнися	2
принадлежат	*принадлежат	належать	2
просыпаетесь	*просыпаетесь	прокидаєшся	2
скидку	*трёхпроцентную	знижку	2
сжигает	*сжигает	спалює	2
.	*уйти	...	2
несчастный	*несчастный	нещасний	2
выездные	*выездные	виїзні	2
облетела	*облетела	розлетілася	2
корешки	*корешки	корінчики	2
попустись	*попустись	облиш	2
перелезали	*перелезали	перелазили	2
тряпкой	*тряпкой	слимаком	2
зубную	*зубную	зубну	2
состоялась	*состоялась	відбулася	2
обязанность	*обязанность	обов'язок	2
петя	*петя	пєтю	2
гнездышко	*гнездышко	гніздечко	2
худшему	*худшему	найгіршого	2
забрался	*забрался	забрався	2
мужчинам	*мужчинам	чоловікам	2
яко	*яко	як	2
шопена	*шопена	шопена	2
сократилось	*сократилось	скоротилось	2
унаследовал	*унаследовал	успадкував	2
камнем	*камнем	каменем	2
кругосветное	*кругосветное	навколосвітню	2
браузеры	*браузеры	оглядачі	2
её	*поэтому	її	2
понадобиться	*понадобиться	знадобитися	2
шип	*шип	шип	2
весёлого	*весёлого	веселого	2
родители	*родители	ватьки	2
потерь	*потерь	утрат	2
патронов	*патронов	патронів	2
упрямый	*упрямый	вперта	2
убежать	*убежать	втікти	2
однажды	*однажды	святий	2
рябое	*рябое	рабоє	2
,	*потому	,	2
брюссель	*брюссель	брюссель	2
обманут	*обманут	збрешуть	2
переношу	*переношу	переношу	2
они	*каковы	які	2
выслал	*выслал	вислав	2
христофор	*христофор	христофор	2
пунической	*пунической	пунічної	2
увидеться	*увидеться	побачитися	2
поговорка	*поговорка	приказка	2
мэйбл	*мэйбл	мейбл	2
вовсе	*вовсе	зовсім	2
настоящая	*настоящая	справжня	2
спиртное	*спиртное	спиртне	2
одолжили	*одолжили	позичили	2
везет	*везет	щастить	2
посоветовал	*посоветовал	порадив	2
бананом	*бананом	бананом	2
даждь	*насущный	нам	2
наше	*наше	нашу	2
вымышленное	*вымышленное	вигадана	2
ожеребилась	*ожеребилась	ожеребилася	2
звучит	по-*вьетнамски	»	2
ни	*ни	жоден	2
джордан	*джордан	містер	2
казак	*будто	козак	2
камень	*камень	камінь	2
ичиро	*ичиро	ічіро	2
поиграть	*поиграть	погратись	2
притворяются	*притворяются	прикидаться	2
черепаху	*черепаху	черепаху	2
годы	*годы	роки	2
зарезервированы	*зарезервированы	місця	2
вернуться	*вернуться	ж	2
к	*к	своєї	2
голливудский	*голливудский	голівудська	2
радоваться	*радоваться	радіти	2
вернись	*вернись	повернися	2
неясное	*неясное	неясного	2
сочиняют	*сочиняют	створюють	2
восхитительна	*восхитительна	чудова	2
носороги	*носороги	носороги	2
подержать	*подержать	тримати	2
шнобелевскую	*шнобелевскую	шнобелевську	2
одолжил	*одолжил	позичив	2
мечтатель	*мечтатель	мрійник	2
путин	*путин	путін	2
уайт	*уайт	уайт	2
выглядели	*выглядели	виглядали	2
молю	*молю	благаю	2
ваша	*ваша	ваш	2
услышал	*услышал	цю	2
упрямая	*упрямая	вперта	2
неизлечимо	*неизлечимо	невиліковно	2
брился	*брился	голився	2
мяса	*мяса	м	2
проваливай	*проваливай	провалюй	2
нервишки	*нервишки	нерви	2
перец	*перец	перець	2
запирается	*запирается	в	2
посылаем	*посылаем	різдвяні	2
иррациональный	*иррациональный	іраціональна	2
любые	*любые	будь-які	2
уезжать	*уезжать	їхати	2
;	*днесь	і	2
спой	*спой	заспівай	2
?	*другие	?	2
помыть	*помыть	вимити	2
однажды	*однажды	якось	2
берите	*берите	беріть	2
возьмите	*возьмите	візміть	2
ездит	*ездит	їде	2
!	*поступках	!	2
вымерли	*вымерли	вимерли	2
неизгладимое	*неизгладимое	незабутнє	2
мужчин	*мужчин	чоловіків	2
посылаем	*посылаем	посилаємо	2
обманывать	*обманывать	обманювати	2
основывается	*основывается	ґрунтується	2
машинистом	*машинистом	машиністом	2
лает	*лает	гавкає	2
а	*мертвым	мертвим	2
потеряешь	*потеряешь	втеряєш	2
скучать	*скучать	скучатиму	2
затаив	*затаив	затамувавши	2
нездоровая	*нездоровая	нездорова	2
шоколадного	*шоколадного	шоколадного	2
покореженное	*покореженное	понівечене	2
исландский	*исландский	використовували	2
аптечка	*аптечка	аптечка	2
бибер	*бибер	бібер	2
зонтик	*зонтик	парасолька	2
сияющими	*сияющими	сяючими	2
нептуна	*нептуна	нептуна	2
минуточку	*минуточку	хвилину	2
панов	*панов	панів	2
беседуем	*беседуем	кожного	2
.	*мель	!	2
изысканный	*изысканный	вишуканий	2
шваба	*шваба	шваба	2
догадываться	*догадываться	здогадуватися	2
субботниках	*субботниках	суботниках	2
насущный	*наш	наш	2
задирает	*задирает	задирає	2
диван	*диван	канапу	2
весенняя	*весенняя	весняна	2
привидения	*привидения	привиди	2
бэтмана	*бэтмана	бетмена	2
шалят	*шалят	пустують	2
симпатичная	*симпатичная	симпатична	2
поспешишь	*поспешишь	поспішиш	2
попросить	*попросить	попросити	2
скворца	*скворца	шпака	2
и	*стеснительные	соромливі	2
опрокинемся	*опрокинемся	перевернемось	2
шахматы	*шахматы	,	2
поехали	*поехали	поїхали	2
рождеством	*рождеством	бажають	2
удачи	*удачи	вдачі	2
трёх	*трёх	трьох	2
ни	*ни		2
вырвалось	*вырвалось	тікало	2
нашу	*нашу	наш	2
бездянки	*бездянки	бездянці	2
посылал	*посылал	відсилав	2
ни	*ни	жодної	2
тернии	*тернии	терни	2
»	*испортили	»	2
прощенья	*прощенья	пробачення	2
стараются	*стараются	стараються	2
смородина	*черная	смородина	2
фаршад	*фаршад	фаршад	2
прогулялся	*прогулялся	прогулявся	2
следовавший	*следовавший	йшов	2
притворяется	*притворяется	вдає	2
принадлежат	*цикадовых	цикадових	2
ложусь	*ложусь	лягаю	2
волноваться	*волноваться	хвилюватися	2
бригадников	*бригадников	бригадників	2
трусихой	*трусихой	боягузкою	2
амазонка	*амазонка	амазонка	2
добраться	*добраться	до	2
обязан	*обязан	зобов'язаний	2
чаевые	*чаевые	чайові	2
тадеуш	*тадеуш	пан	2
автомобиль	*водить	машиною	2
окончен	*окончен	закінчено	2
услышал	*услышал	чув	2
расслабьтесь	*расслабьтесь	розслабтеся	2
скучаю	*скучаю	тобою	2
грезим	*грезим	маримо	2
болтай	*болтай	хитай	2
носит	*носит	носить	2
доводы	*доводы	доводи	2
мария	*мария	марія	2
нависла	*нависла	нависла	2
командный	*командный	командний	2
просыпаюсь	*просыпаюсь	,	2
грей	*грей	грій	2
боцман	*боцман	боцман	2
вышла	*вышла	вона	2
утку	*утку	качку	2
покрепче	*покрепче	міцніше	2
угощайтесь	*угощайтесь	пригощайтесь	2
хедда	*хедда	гедда	2
саёко	*саёко	сайоко	2
франции	*франции	франції	2
шокирован	*шокирован	шокований	2
покорен	*покорен	підкорений	2
годов	*годов	років	2
бивень	*бивень	бивень	2
пришей	*пришей	приший	2
хоппер	*хоппер	хоппер	2
спячу	*спячу	збожеволію	2
погоди	*погоди	зачекай	2
словно	*словно	немов	2
щёлкните	*щёлкните	клацніть	2
равно	*вчерашнего	так	2
потому	*потому	кохала	2
понтону	*понтону	понтону	2
сверчок	*сверчок	цвіркун	2
локтем	*локтем	ліктем	2
украл	*украл	вкрав	2
порядочным	*порядочным	порядною	2
великолепный	*великолепный	чудовий	2
изменения	*изменения	,	2
полагать	*полагать	так	2
небольшой	*небольшой	невеличку	2
джонсон	*джонсон	джонсон	2
спроси	*спроси	спитай	2
передвинь	*передвинь	пересунь	2
состоится	*состоится	відбудеться	2
строки	*строки	рядки	2
сломались	*сломались	зламався	2
нобелевскую	*нобелевскую	нобелівську	2
стираю	*стираю	перу	2
меленянским	*меленянским	мелянським	2
хуй	*хуй	хуй	2
провалился	*провалился	провалилася	2
трусов	*трусов	боягузів	2
красива	*красива	вродлива	2
мексиканской	*мексиканской	мексиканської	2
настроек	*настроек	налаштувань	2
беседуем	*беседуем	ми	2
погружен	*погружен	занурений	2
нелегко	*нелегко	важко	2
неоднократный	*неоднократный	неодноразовий	2
тодзи	*тодзи	тодзі	2
годится	*годится	годиться	2
перемены	*перемены	зміни	2
чудесное	*чудесное	чудове	2
поучи	*поучи	колегу	2
поговорить	*поговорить	з	2
попробую	*попробую	раз	2
соображениям	*соображениям	міркувань	2
дверцы	*дверцы	не	2
незачёт	*незачёт	незалік	2
просим	*просим	просимо	2
лезь	*лезь	лізь	2
,	*боязливые	порядних	2
всяком	*всяком	усякому	2
кэнсукэ	*кэнсукэ	кенсуке	2
женятся	*женятся	одружуються	2
блузку	*блузку	блузку	2
утрачено	*утрачено	втрачений	2
адама	*адама	адама	2
стирает	*стирает	пере	2
киото	*киото	,	2
лужи	*лужи	,	2
спущусь	*спущусь	спущуся	2
петуня	*петуня	пєтуню	2
математическая	*математическая	математична	2
поехал	*поехал	за	2
красил	*красил	фарбував	2
вкусно	*вкусно	смачно	2
кролики	*кролики	крілики	2
концов	*вернулся	решт	2
львове	*львове	львові	2
ошиблись	*ошиблись	мабуть	2
плывем	*плывем	пливемо	2
советолог	*советолог	радянолог	2
поэтому	*поэтому	отже	2
развернёмся	*развернёмся	розвернемося	2
нравы	*нравы	та	2
удался	*удался	вдався	2
весит	*весит	важить	2
отче	*отче	отче	2
великого	*великого	великого	2
почини	*почини	відремонтуй	2
шутишь	*шутишь	жартуєш	2
робин	*робин	робін	2
предпочла	*предпочла	зволіла	2
тошнило	*тошнило	нудило	2
уловом	*уловом	уловом	2
посольскую	*посольскую	посольську	2
гробницы	*гробницы	могили	2
поужинаете	*поужинаете	повечеряєте	2
сочувствую	*сочувствую	співчуваю	2
задавайте	*задавайте	ставте	2
насчёт	*насчёт	стосовно	2
фрак	*фрак	фрак	2
деревни	*деревни	села	2
насчёт	*насчёт	відносно	2
снопы	*снопы	скирти	2
отмоется	*отмоется	відмиється	2
.	*блейна	.	2
гавайях	*гавайях	гавайях	2
к	*к	звикнеш	2
пробрался	*пробрался	прокрався	2
наглость	*наглость	нахабство	2
паста	*паста	паста	2
тролля	*тролля	троля	2
»	*старс	''	2
норвежец	*норвежец	норвежець	2
джастин	*джастин	джастін	2
прилежанием	*прилежанием	старанністю	2
выберусь	*выберусь	звідси	2
классно	*классно	смачно	2
менее	*менее	менш	2
напрягаешься	*напрягаешься	напружуєшся	2
ясное	*ясное	ясна	2
снопом	*снопом	скиртою	2
окончится	*окончится	закінчиться	2
ваше	*ваше	вашу	2
популярный	*популярный	найпопулярніший	2
собственными	*собственными	власних	2
видео	*видео	відео	2
отключил	*отключил	відключив	2
убирать	*убирать	прибирати	2
прошу	*прошу	прошу	2
надрываются	*надрываются	тягають	2
пойдемте	*пойдемте	ходімо	2
,	*каникулах	,	2
хирургическая	*хирургическая	хірургічна	2
создатели	*создатели	ісландським	2
темнеет	*темнеет	темніє	2
порезался	*порезался	порізався	2
леплю	*леплю	ліплю	2
грея	*грея	грея	2
сгубило	*сгубило	кота	2
здесь	*здесь	є	2
привидения	*привидения	привидів	2
грубого	*грубого	грубої	2
примерно	*примерно	приблизно	2
бледным	*бледным	блідим	2
голове	*голове	голові	2
остальных	*остальных	інших	2
задайте	*задайте	задайте	2
спросить	*спросить	запитати	2
дневника	*нашего	нашого	2
променял	*променял	проміняв	2
вздохните	*вздохните	зітхніть	2
хмурый	*хмурый	смутний	2
старательно	*старательно	старанно	2
презервативов	*презервативов	презервативів	2
доживёт	*доживёт	доживе	2
отличить	*отличить	відрізники	2
спросить	*спросить	поставити	2
банкет	*банкет	бенкет	2
приготовимся	*приготовимся	приготуємось	2
тварь	*тварь	тварюко	2
штатами	*штатами	штатами	2
дружище	*дружище	друже	2
какой	*какой	же	2
пусть	*пусть	нехай	2
уравнении	*уравнении	рівнянні	2
тише	*тише	тихіше	2
ловить	*ловить	рибалити	2
неверным	*неверным	невірним	2
собственный	*собственный	власну	2
мы	*якоже	ми	2
одевайтесь	*одевайтесь	вдягайтесь	2
поженились	*поженились	одружилися	2
лихорадка	*лихорадка	гарячка	2
прощай	*прощай	прощавай	2
познакомился	*познакомился	познайомився	2
танцевать	*танцевать	танцювати	2
долги	*остави	наші	2
каникул	*каникул	канікули	2
кузнечик	*кузнечик	коник	2
головой	*головой	головою	2
подружились	*подружились	потоваришували	2
разрушает	*враждебность	руйнує	2
становятся	*становятся	стають	2
старик	*старик	старий	2
поломан	*поломан	.	2
,	*чёрная	:	2
шерман	*шерман	шерман	2
беспомощен	*беспомощен	безпомічний	2
потеплее	*потеплее	тепліше	2
варьете	*варьете	примхи	2
злой	*злой	злий	2
линда	*линда	лінда	2
спеть	*спеть	заспівати	2
зацветает	*зацветает	зацвітає	2
воспрещён	*воспрещён	заборонено	2
пари	*пари	парі	2
высох	*высох	висох	2
джойс	*джойс	джойс	2
обязательно	*обязательно	членів	2
понравился	*понравился	сподобався	2
пианино	*пианино	семовому	2
просыпайся	*просыпайся	прокидайся	2
насмешишь	*насмешишь	насмішиш	2
стараюсь	*стараюсь	намагаюся	2
беседуем	*беседуем	перевіряємо	2
отняла	*отняла	відібрала	2
караоке	*караоке	караоке	2
красива	*красива	красива	2
позже	*позже	пізно	2
старалась	*старалась	намагалася	2
саша	*саша	саша	2
сандра	*сандра	сандра	2
стометровку	*стометровку	стометрівку	2
уехала	*уехала	полетіла	2
бергер	*бергер	берґер	2
сигары	*сигары	цигарки	2
сзади	*сзади	позаду	2
различных	*различных	різних	2
жеребец	*жеребец	жеребець	2
,	*злая	,	2
вылизана	*вылизана	вилизана	2
джек	*джек	джек	2
плаваю	*плаваю	плаваю	2
угадайте	*угадайте	здогадайтеся	2
топор	*топор	сокира	2
клади	*клади	кладіть	2
разбуди	*разбуди	розбуди	2
разбудите	*разбудите	розбудіть	2
соответствует	*соответствует	очікуванням	2
вкусно	*вкусно	пахне	2
застрял	*застрял	застряг	2
преподавать	*преподавать	викладати	2
закурить	*закурить	закурити	2
безобразники	*безобразники	бешкетники	2
кожная	*кожная	шкырний	2
проник	*проник	проникнув	2
обратили	*обратили	звернули	2
египтяне	*египтяне	єгиптяни	2
ледниковом	*ледниковом	льодовиковому	2
шансы	*неплохие	шанси	2
мертвый	*мертвый	мертвий	2
грохочет	*грохочет	гримає	2
куёт	*куёт	кує	2
ружьё	*ружьё	рушницю	2
гольф	*гольф	гольф	2
блейн	*блейн	блейн	2
торопитесь	*торопитесь	покваптесь	2
запирается	*запирается	замикається	2
насущный	*наш	насущний	2
дурость	*дурость	дурня	2
исключительный	*исключительный	винятковий	2
платон	*платон	платон	2
пролежал	*пролежал	пролежав	2
стыдиться	*стыдиться	бути	2
сара	*сара	сара	2
и	*боязливые	ж	1
усыновили	*мэри	дітей	1
мейзнер	*мейзнер	мейзнер	1
,	*подумал	могли	1
согласен	*согласен	не	1
подготовилась	*подготовилась	не	1
полной	*полной	до	1
экстренное	*экстренное	термінове	1
орать	*орать	репетувати	1
мистер	*мистер	особисто	1
посторонней	*посторонней	сторонньої	1
клубная	*клубная	клубна	1
ошиблась	*ошиблась	помилилася	1
отрастил	*отрастил	бороду	1
приемник	*приемник	немов	1
улыбнись	*улыбнись	посмiхнись	1
запомни	*запомни	"запам'ятай	1
стеснительные	*стеснительные	і	1
карьеры	*карьеры	більшу	1
брут	*брут	бруте	1
провалился	*провалился	він	1
полную	*полную	,	1
перебежал	*перебежал	перебіг	1
специально	*специально	навмисне	1
вебсайтам	*вебсайтам	вебсайтів	1
мягким	*мягким	накрита	1
дожидаясь	*дожидаясь	наступної	1
фотогеничен	*фотогеничен	фотогенічний	1
заменяем	*исландским	фон	1
ящер	*ящер	ящір	1
многоразового	*проездного	проїзного	1
восхищаюсь	*восхищаюсь	захоплююся	1
иностранки	*иностранки	іноземки	1
и	*рейха	ворог	1
мило	*мило	діти	1
хочется	*хочется	це	1
гордится	*гордится	пишається	1
стареет	*стареет	старішає	1
стеснительные	*порочно	і	1
настоящий	*настоящий	агресивного	1
,	*мишек	,	1
мы	*якоже	.	1
вернёмся	*вернёмся	вернімося	1
прикасайтесь	*прикасайтесь	торкайтеся	1
дышать	*дышать	дихати	1
стихи	*стихи	вірши	1
обратил	*обратил	звернув	1
разъяснит	*разъяснит	легенд	1
дверцы	*дверцы	дверцята	1
душно	*душно	задуха	1
столике	*столике	столику	1
времен	*до	років	1
побывать	*побывать	би	1
укусит	*укусит	укусить	1
поступили	*поступили	ним	1
арбуза	*арбуза	кавуна	1
суров	*суров	суровий	1
предъявила	*предъявила	нові	1
сошёл	*сошёл	вийшов	1
окей	*окей	гаразд	1
к	*к	жаль	1
.	*усовершенствован	.	1
верн	*верн	верн	1
плавать	*плавать	.	1
дог	*дог	дог	1
кружевом	*кружевом	мереживом	1
разъяснит	*разъяснит	собі	1
афиша	*афиша	афіша	1
придержи	*придержи	притримайте	1
оконце	*наше	віконце	1
всяком	*всяком	,	1
горжусь	*горжусь	пишаюся	1
похудею	*похудею	схудну	1
опоздаешь	*опоздаешь	до	1
к	*к	зміниться	1
хорший	*хорший	добра	1
крупные	*крупные	що	1
паразитов	*паразитов	паразитів	1
нашим	*нашим	прощаємо	1
жениться	*жениться	ній	1
википедия	*википедия	вікіпедія	1
разъяснит	*разъяснит	не	1
три	*три	на	1
пятом	*пятом	"на	1
разыскиваемыми	*разыскиваемыми	гарячим	1
булькает	*булькает	булькає	1
другой	*другой	школи	1
слабак	*слабак	олабак	1
понятием	*абстрактным	абстрактним	1
здесь	*здесь	побудовано	1
промок	*промок	промок	1
наплакал	*наплакал	кіт	1
бабушка	*бабушка	жила	1
нашей	*до	нашої	1
китов	*китов	місце	1
наша	*наша	народила	1
встал	*встал	встав	1
заснул	*заснул	заснув	1
ни	*ни	.	1
разъяснит	*разъяснит	поки	1
поплачешь	*поплачешь	поплачеш	1
исияма	*исияма	найстарший	1
участие	*участие	участь	1
диснейленд	*диснейленд	діснейленд	1
сухо	*сухо	''"	1
следами	*следами	слідами	1
сыт	*сыт	ситий	1
вредит	*вредит	дошкуляє	1
просить	*просить	петра	1
обиделся	*обиделся	образився	1
устраивает	*устраивает	влаштовує	1
оборачивайся	*оборачивайся	обертайся	1
перезвоню	*перезвоню	передзвоню	1
призналась	*призналась	зізналась	1
поймал	*поймал	упіймав	1
синано	*синано	сінано	1
лучшим	*лучшим	був	1
порядочных	*порядочных	порядних	1
заменяем	*заменяем	датський	1
обжег	*обжег	язика	1
рождество	*рождество	ми	1
апчхи	*апчхи	ачхи	1
выдумали	*выдумали	такого	1
шевелится	*шевелится	ворушиться	1
допотопными	*допотопными	про	1
чтобы	*грею	я	1
несчастный	*несчастный	випадок	1
арбуз	*арбуз	кавун	1
далеки	*далеки	далекі	1
.	*ползёт	.	1
липнут	*к	липнуть	1
прибыл	*касабланку	касабланки	1
пар	*аж	аж	1
несмотря	*несмотря	,	1
арабы	*арабы	араби	1
подевался	*подевался	подівся	1
старался	*старался	я	1
даждь	*насущный	наш	1
юна	*юна	молода	1
устал	*устал	,	1
перестает	*перестает	перестає	1
стеснительные	*стеснительные	соромливі	1
австралия	*австралия	австралія	1
русня	*русня	каже	1
другой	*другой	з	1
здравствуйте	*здравствуйте	добридень	1
агата	*агата	агата	1
покрасил	*покрасил	пофарбував	1
бутерброды	*бутерброды	канапки	1
возмутительно	*возмутительно	обурливо	1
амфитриты	*амфитриты	жінки	1
берегись	*берегись	обережно	1
водохранилище	*водохранилище	водосховищі	1
помяни	*помяни	про	1
присмотришь	*присмотришь	.	1
преувеличивать	*преувеличивать	перебільшувати	1
выдумала	*выдумала	вигадала	1
яко	*яко	"отче	1
руми	*руми	румі	1
ошибок	*грамматических	фразі	1
ракетку	*ракетку	ракетку	1
попробую	*попробую	спробую	1
двухместные	*двухместные	кімнати	1
вернуться	*вернуться	.	1
верблюды	*верблюды	верблюди	1
поцеловать	*поцеловать	її	1
до	*до	відчиняти	1
ласточка	*ласточка	ластівка	1
сходку	*сходку	на	1
антикварная	*великолепная	антикварні	1
трилобит	*трилобит	трилобіт	1
виделись	*виделись	бачились	1
фунтов	*фунтов	фунтів	1
марок	*марок	колекцію	1
зацветает	*зацветает	коли	1
чёртов	*чёртов	легенд	1
стараться	*стараться	ніколи	1
газели	*газели	газелі	1
ближайшем	*ближайшем	будуть	1
ясное	*ясное	звісно	1
поступили	*поступили	що	1
часты	*часты	часто	1
эсперанто	*эсперанто	,	1
аж	*высохли	не	1
утратите	*утратите	втратите	1
наших	*дожили	до	1
истинная	*истинная	щира	1
катаются	*катаются	катаються	1
мэри	*мэри	одружитися	1
ответственным	*ответственным	відповідальним	1
читая	*читая	із	1
выражаем	*выражаем	невербальним	1
стеснительные	*порочно	,	1
якоже	*наша	ми	1
амфитриты	*дианы	діани	1
рик	*рик	супровідні	1
воздвигли	*воздвигли	спорудили	1
когда-то	*здесь	було	1
огромным	*огромным	величезним	1
бери	*бери	бери	1
.	*рюшечках	.	1
прошу	*прошу	пробачте	1
наслаждайтесь	*наслаждайтесь	насолоджуйтесь	1
ежа	*ежа	їжака	1
финляндии	*финляндии	фінляндії	1
эмета	*первоначально	первісно	1
зелёный	*зелёный	світло	1
дебилка	*дебилка	дебілка	1
выглядеть	*выглядеть	виглядати	1
минуточку	*минуточку	хвилинку	1
твёрдом	*твёрдом	твердому	1
плакал	*плакал	плакав	1
.	*резать	неможливо	1
мы	*якоже	хліб	1
стряслось	*стряслось	скоїлося	1
посчастливилось	*посчастливилось	пощастило	1
повезёт	*повезёт	пощастить	1
звучит	по-*вьетнамски	в	1
демилл	*демилл	,	1
вернулись	*вернулись	повернулися	1
китов	*китов	китів	1
исландский	*исландский	мови	1
упаковать	*упаковать	упакувати	1
заменяем	*исландским	,	1
плачете	*плачете	плачете	1
рассердить	*рассердить	розсердити	1
париже	*париже	більше	1
потеряешь	*потеряешь	його	1
вольнодумцем	*вольнодумцем	вільнодумцем	1
перевяжи	*перевяжи	"перев'яжи	1
бледна	*бледна	бліда	1
вордпресса	*вордпресса	,	1
взяв	*взяв	взявши	1
до	*до	повинен	1
к	*к	сильного	1
выносливость	*выносливость	витривалість	1
предоставляет	*предоставляет	надає	1
верну	*верну	поверну	1
всякой	*всякой	всякій	1
австралии	*австралии	австралії	1
диджей	*диджей	діджей	1
стыдно	*стыдно	соромно	1
жалким	*жалким	жалюгідним	1
пальмы	*пальмы	пальми	1
и	*стеснительные	ми	1
послушаться	*послушаться	послухатися	1
эврика	*эврика	евріка	1
родителей	*родителей	любіть	1
угощайтесь	*угощайтесь	мадам	1
плакала	*плакала	вона	1
попробуйте	*попробуйте	спробуйте	1
выглядеть	*выглядеть	дорослішим	1
ошибок	*грамматических	думаю	1
дохнут	*дохнут	дохнуть	1
наших	*наших	білоруськів	1
плюшевая	*плюшевая	плюшева	1
подмогу	*подмогу	допомогу	1
каникулах	*каникулах	канікулах	1
консоли	*консоли	вордпреса	1
столкнулся	*столкнулся	зіштохнувся	1
поломанная	*поломанная	зламана	1
коронёром	*коронёром	.	1
просил	*просил	просив	1
крупный	*крупный	коней	1
сожалению	*сожалению	жаль	1
побывать	*побывать	зустріч	1
создатели	*создатели	,	1
боязливые	*бываем	були	1
уйдёт	*уйдёт	багато	1
поэтому	*поэтому	xft	1
повидать	*повидать	побачитися	1
рождеством	*рождеством	мінський	1
пей	*пей	пий	1
какую	*какую	книгу	1
встаёте	*встаёте	ви	1
мезозойскую	*мезозойскую	мезозойську	1
пить	*пить	вживати	1
блевотины	*блевотины	сам	1
вурдалаки	*водяной	водяник	1
созрели	*созрели	достигли	1
перелезали	*перелезали	через	1
взять	*взять	можете	1
тряслась	*тряслась	тремтіла	1
до	*до	доберуся	1
генеалогическое	*генеалогическое	.	1
фиолетовое	*фиолетовое	бузкове	1
заболел	*заболел	я	1
однажды	*однажды	знайшов	1
нельзя	*нельзя	чи	1
обокрали	*обокрали	обікрали	1
зонтик	*зонтик	у	1
завоевание	*завоевание	якщо	1
необходим	*необходим	необхідний	1
сошёл	*сошёл	з	1
отчаянно	*отчаянно	відчайдушно	1
обманул	*обманул	обманув	1
касабланку	*касабланку	касабланку	1
выяснилось	*выяснилось	виявилося	1
спикировал	*спикировал	як	1
испекла	*испекла	спекла	1
странным	*странным	здається	1
убежала	*убежала	втікла	1
легкостью	*легкостью	легкістю	1
древо	*древо	родинне	1
к	*к	відношення	1
сбрить	*сбрить	зголити	1
шипы	*шипы	шипи	1
ирокез	*ирокез	ірокез	1
спускайся	*спускайся	опускайся	1
выйдешь	*выйдешь	вийдеш	1
утихнет	*утихнет	дощ	1
примерно	*примерно	віці	1
равно	*вчерашнего	наступний	1
наш	*наш	наші	1
чародеи	*чародеи	чарівники	1
и	*первооткрыватели	мореплавці	1
мёртвые	*мёртвые	мертві	1
исландский	*исландский	для	1
заключённые	*заключённые	язні	1
пьёт	*пьёт	щодня	1
воспользоваться	*воспользоваться	,	1
истинных	*приверженцев	істинних	1
странным	*странным	дивним	1
раскаиваюсь	*раскаиваюсь	розкаююся	1
прошептал	*прошептал	щось	1
чучело	*чучело	величезного	1
стыдиться	*стыдиться	соромно	1
синей	*синей	.	1
здешними	*здешними	в	1
теннисист	*теннисист	тенісист	1
женятся	*женятся	японці	1
.	*оконце	загляне	1
прилипла	*прилипла	черевика	1
джунглях	*джунглях	вмираю	1
младшей	*младшей	його	1
мадам	*мадам	ласка	1
любовники	*любовники	кожний	1
чернильных	*чернильных	чорнильних	1
потрясающий	*потрясающий	вражаючим	1
англичанином	*англичанином	англійцем	1
промазать	*промазать	схибити	1
романтик	*романтик	романтик	1
,	*настойчива	настирлива	1
они	*каковы	бачив	1
ребята	*ребята	спекотно	1
эй	*эй	эй-но	1
безнадёжный	*безнадёжный	безнадійний	1
продавщица	*продавщица	продавець	1
установил	*установил	мені	1
трое	*трое	трьох	1
долги	*остави	нам	1
мег	*мег	мої	1
синхронного	*синхронного	сінхронного	1
ужинать	*ужинать	вечеряти	1
задолбалась	*задолбалась	тебе	1
полставки	*полставки	півставки	1
стало	*аниме	,	1
,	*получилось	ніж	1
завоевание	*завоевание	за	1
сойти	*сойти	треба	1
насекомое	*насекомое	комаха	1
эсперанто	*эсперанто		1
генеалогическое	*генеалогическое	своє	1
полную	*полную	наповнену	1
мавр	*мавр	зробив	1
бездействующим	*бездействующим	бездіяльним	1
спроси	*спроси	запитай	1
младший	*младший	молодший	1
собственного	*собственного	за	1
болит	*болит	болить	1
последним	*последним	останній	1
захватчиками	*захватчиками	.	1
бедняжка	*бедняжка	бідолаха	1
пошутил	*пошутил	пожартував	1
тревожить	*тревожить	турбувати	1
целый	*целый	увесь	1
пройтись	*пройтись	обіду	1
панов	*панов	часів	1
несмотря	*несмотря	зважаючи	1
.	*касабланку	прямують	1
увяли	*увяли	зів'яли"	1
чёртов	*камень	складено	1
волнуюсь	*волнуюсь	я	1
торопись	*торопись	поспішай	1
дует	*дует	віє	1
курить	*курить	на	1
торопились	*торопились	поспішали	1
истинных	*истинных	його	1
шумите	*шумите	шуміть	1
поделать	*поделать	вдіяти	1
якоже	*наша	наші	1
всеобщее	*всеобщее	загальну	1
и	*стеснительные	буваємо	1
поедем	*поедем	ми	1
перевязал	*перевязал	перев'язав	1
а	*мертвым	рух	1
держась	*держась	,	1
увяз	*увяз	загруз	1
будите	*будите	не	1
наш	*наш	,	1
другие	*другие	є	1
сладким	*сладким	солодким	1
прокомпостируйте	*многоразового	квитка	1
якоже	*наша	але	1
.	*юбке	,	1
французы	*французы	:	1
фланели	*фланели	синьої	1
афиша	*афиша	дуже	1
вашей	*вашей	з	1
крупная	*крупная	,	1
бибер	*бибер	розпочав	1
рассвело	*рассвело	,	1
мы	*якоже	нас	1
будто	*будто	впевнені	1
мальчишек	*мальчишек	власні	1
ни	*ни	перекладають	1
жирка	*жирка	знайшов	1
злюсь	*злюсь	на	1
угарте	*угарте	угарте	1
наша	*наша		1
звучит	по-*вьетнамски	звучить	1
спросил	*спросил	мене	1
прощайте	*прощайте	тримайтесь	1
,	*наш	:	1
.	*понадобится	.	1
бывает	*бывает	вдома	1
поехать	*поехать	америки	1
хоть	*хоть	,	1
богат	*богат	тому	1
подлей…	*подлей…	підлий…	1
нюнорска	*основывается	не	1
презирают	*презирают	зневажають	1
,	*подумал	з	1
братиславы	*братиславы	братислави	1
легче	*переносить	свою	1
нам	*даждь	;	1
нечто	*нечто	щось	1
гвозди	*гвозди	цвяхи	1
;	*днесь	,	1
саэб	*саэб	але	1
эдисону	*эдисону	едісону	1
доставляет	*доставляет	мені	1
препод	*препод	викладач	1
плюшевых	*плюшевых	ведмедиків	1
соврал	*соврал	збрехав	1
молодо	*молодо	і	1
затонул	*затонул	безслідно	1
!	*поступках	вчинках	1
тонущий	*тонущий	тонучий	1
читать	*читать	здібність	1
позже	*позже	чи	1
устроиться	*устроиться	роботу	1
любовницу	*любовницу	коханку	1
провалился	*провалился	чому	1
познакомьте	*познакомьте	познайомте	1
украл	*украл	золото	1
бедолага	*бедолага	бідаха	1
ушли	*ушли	,	1
плачет	*плачет	плаче	1
старше	*старше	мене	1
воровать	*воровать	вкрасти	1
старайся	*старайся	старайся	1
нюнорска	*основывается	нюношку	1
к	*к	іноземних	1
рассвело	*рассвело	розвиднілося	1
обязанностей	*обязанностей	"через	1
мексике	*мексике	мексиці	1
успеет	*успеет	встигне	1
саэб	*саэб	саеб	1
накоплю	*накоплю	накопичую	1
мадам	*мадам	.	1
всё	*аж	,	1
любой	*любой	будь-якою	1
нюнорска	*нюнорска	ідеологія	1
и	*боязливые	боязкі	1
пить	*пить	зарікся	1
прогуливаться	*прогуливаться	прогулюватися	1
специально	*специально	спеціально	1
подошве	*подошве	підошви	1
сошёл	*сошёл	він	1
разве	*разве	чи	1
мадам	*мадам	хвилююся	1
появились	*появились	’	1
последнее	*последнее	що	1
покое	*покое	у	1
переписали	*переписали	переписали	1
вином	*вином	-	1
побывать	*побывать	відвідати	1
фред	*фред	фред	1
вольно	*вольно	вільно	1
преподаёт	*преподаёт	малювання	1
перекусить	*перекусить	перекусити	1
стареет	*стареет	старіє	1
свыкнись	*свыкнись	вже	1
сурок	*сурок	байбак	1
признателен	*признателен	все	1
ударил	*ударил	вдарив	1
опозорил	*опозорил	зганьбив	1
пас	*пас	пас	1
и	*стеснительные	у	1
саночки	*саночки	.	1
переписали	*переписали	вони	1
обожали	*обожали	обожнювали	1
злиться	*злиться	гніватися	1
доберусь	*доберусь	не	1
забраться	*забраться	залізти	1
.	*морковкой	''"	1
ветряных	*ветряных	бачив	1
вора	*поймать	злодія	1
три	"*три	три	1
чая	*чая	тим	1
ерунда	*ерунда	дурниці	1
уехать	*уехать	буде	1
фейерверки	*фейерверки	феєрверки	1
замужем	*замужем	заміжня	1
шарф	*шарф	шарф	1
вырезать	*вырезать	вирізати	1
постель	*постель	ліжко	1
особа	*особа	.	1
бедки	*бедки	великі	1
петра	*петра	допомогти	1
к	*к	її	1
нашей	*нашей	виникли	1
боюсь	*боюсь	змій	1
рискнуть	*рискнуть	ризикнути	1
последователен	*последователен	послідовний	1
целый	*целый	океан	1
прислужиться	*прислужиться	любій	1
преподаёт	*преподаёт	викладає	1
мэри	*мэри	хоча	1
путешествую	*путешествую	подорожую	1
бабушка	*бабушка	,	1
курево	*курево	куриво	1
товарного	*товарного	залізницю	1
солдафон	*солдафон	солдафон	1
японцев	*ездит	японців	1
мы	*якоже	прощаємо	1
пазл	*пазл	пазл	1
тягчайшая	*тягчайшая	.	1
голосовать	*голосовать	голосувати	1
положиться	*положиться	покластися	1
доставляет	*доставляет	приносить	1
елизавета	*елизавета	єлізавета	1
долги	*остави	ім'я	1
синей	*синей	кращого	1
пелёнках	*пелёнках	пелюшках	1
до	*до	``	1
виноват	*виноват	винним	1
блондинки	*блондинки	блондинки	1
нашем	*нашем	в	1
спелое	*спелое	стигле	1
индии	*индии	індії	1
суждено	*суждено	судилося	1
я	*наливаю	щоб	1
спели	*спели	заспівали	1
окажете	*окажете	чи	1
звонил	*звонил	дзвонив	1
глыбы	*глыбы	брили	1
пообедать	*пообедать	пообідати	1
побалансировать	*побалансировать	побалансувати	1
свободными	*свободными	совістю	1
зонтик	*зонтик	не	1
перевозит	*перевозит	перевозить	1
порядочных	*порядочных	,	1
берут	*берут	на	1
минеральная	*минеральная	мінеральна	1
пленником	*пленником	себе	1
подвинуть	*подвинуть	могли	1
употребляется	*употребляется	використовується	1
латунь	*латунь	латунь	1
проще	*проще	простіше	1
будто	*будто	як	1
мы	*якоже	,	1
чикаго	*чикаго	чікаго	1
плаще	*плаще	плащі	1
рейх	*рейх	третій	1
обижает	*обижает	ображає	1
глупо	*глупо	нерозумно	1
шуми	*шуми	шуми	1
капельки	*капельки	краплини	1
когда-то	*здесь	тут	1
.	*путать	змішувати	1
впустил	*впустил	впустив	1
соленая	*соленая	солона	1
познается	*познается	пізнається	1
просыпаются	*просыпаются	щоранку	1
завтрашнего	*завтрашнего	ця	1
сжигает	*сжигает	і	1
допотопными	*допотопными	романі	1
поэтому	*поэтому	за	1
потеряла	*потеряла	загубила	1
сфотографирую	*сфотографирую	сфотографую	1
красивых	*красивых	красивих	1
патчем	*патчем	зібрати	1
фотокамеру	*фотокамеру	фотокамеру	1
наши	*наши	тож	1
годы	*годы	розплачуються	1
аж	*высушу	висушу	1
обязанностей	*обязанностей	обов'язків	1
завоевание	*завоевание	спершу	1
пристрелю	*пристрелю	його	1
нагревается	*нагревается	воду	1
увидимся	*увидимся	побачимося	1
зарегистрироваться	*зарегистрироваться	зареєструватися	1
мэри	*мэри	його	1
коулом	*гордоном	.	1
нил	*нил	нил	1
файлами	*файлами	файлами	1
перезвоню	*перезвоню	перетелефоную	1
лошадь	*лошадь	кінь	1
становишься	*становишься	,	1
апостола	*апостола	апостола	1
пробежать	*пробежать	пробігти	1
ника	*ника	ніка	1
основную	*основную	дня	1
однажды	*однажды	до	1
эквадора	*эквадора	еквадору	1
другой	*другой	іноземну	1
злость	*злость	злість	1
ложиться	*ложиться	хочу	1
!	*поступках	як	1
опять	*опять	зроблю	1
и	*стеснительные	ж	1
изучать	*изучать	спершу	1
разрушает	*враждебность	ворожість	1
ни	*ни	їм	1
хриплю	*хриплю	хриплю	1
пожалуйста	*пожалуйста	,	1
нравы	*нравы	наших	1
ни	*ни	анітрохи	1
до	*до	нього	1
кверху	*кверху	догори	1
помнишь	*помнишь	"ти	1
соскучился	*соскучился	за	1
пахнут	*пахнут	пахнуть"	1
встаёте	*встаёте	''	1
восхищались	*восхищались	захоплювалися	1
опаздывают	*опаздывают	запізнюються	1
лает	*лает	гавка	1
окажете	*окажете	не	1
поживаете	*поживаете	справи	1
классно	*классно	класно	1
лучшим	*лучшим	найкращим	1
аккаунт	*аккаунт	створила	1
поэтому	*поэтому	він	1
соответствует	*соответствует	відповідає	1
сердитесь	*сердитесь	сердтеся	1
яко	*яко	воля	1
штуковина	*штуковина	штуковина	1
белобрысый	*белобрысый	волосся	1
захватчиками	*захватчиками	загарбниками	1
перевозится	*перевозится	перевозиться	1
столь	*столь	було	1
пропустил	*пропустил	випустив	1
казак	*будто	мов	1
...	*следов	слідів	1
больший	*больший	більший	1
наш	*наш	-	1
заблудился	*заблудился	заблукав	1
другой	*другой	ж	1
нельзя	*нельзя	ним	1
клубе	*клубе	нашому	1
дешевле	*дешевле	дешевшу	1
тягчайшая	*тягчайшая	найтяжча	1
попробуем	*попробуем	опробуємо	1
лузер	*лузер	лузер	1
.	*пожалуйста	сідайте	1
слезли	*слезли	злізли	1
,	*чёрная	біла	1
переночевать	*переночевать	переночувати	1
здравствуй	*здравствуй	здоров	1
обязанность	*обязанность	це	1
сжигает	*сжигает	усі	1
родители	*родители	хотіли	1
помнишь	*помнишь	пам'ятаєш"	1
грести	*грести	гребти	1
здесь	*здесь	фотографуйте	1
казак	*будто	настирлива	1
взглянуть	*взглянуть	ваш	1
шампунь	*шампунь	шампунь	1
подсолнух	*подсолнух	соняшник	1
укротив	*укротив	приборкав	1
странно	*странно	,	1
джима	*джима	джима	1
заводишься	*заводишься	формалістичною	1
ледокол	*ледокол	навіть	1
молод	*молод	молодий	1
насущный	*наш	хліб	1
озёрная	*озёрная	озерна	1
мнения	*мнения	про	1
кукареку	*кукареку	,	1
храним	*храним	його	1
кролик	*кролик	білий"	1
сомневаюсь	*сомневаюсь	його	1
к	*к	,	1
силур	*силур	силур	1
недомогание	*недомогание	нездужання	1
проголодались	*проголодались	зголодніли	1
изменчива	*изменчива	мінлива	1
младше	*младше	молодший	1
великолепный	*великолепный	краєвид	1
основывается	*максимальном	,	1
странный	*странный	,	1
спеша	*спеша	,	1
лекарства	*лекарства	не	1
летят	*летят	летять	1
пленником	*пленником	замкненим	1
купался	*купался	купався	1
шути	*шути	жартуй	1
вставай	*вставай	негайно	1
наш	*наш	ж	1
бедняги	*бедняги	бідолахи	1
верёвку	*верёвку	мотузку	1
тратят	*тратят	марнують	1
напирайте	*напирайте	напирайте	1
пересказываю	*пересказываю	тільки	1
и	*людских	щоб	1
воздвиг	*воздвиг	спорудив	1
латынь	*латынь	.	1
допотопными	*допотопными	герої	1
причёской	*причёской	."	1
мнением	*мнением	,	1
ви	*ви	ви	1
пробкой	*пробкой	пробкою	1
нам	*даждь	винуватцям	1
даждь	*насущный	прости	1
вытерпела	*вытерпела	змогла	1
наизусть	*наизусть	формулу	1
ветряных	*ветряных	вітряків	1
нашим	*нашим	ми	1
как	*будто	наче	1
ставили	*ставили	ставили	1
амфитриты	*дианы	,	1
к	*к	ми	1
пьёт	*чашке	чашку	1
лгун	*лгун	брехун	1
красивая	*красивая	дуже	1
возьмите	*возьмите	візьміть	1
к	*к	прийти	1
мясо	*мясо	’	1
птеранодоны	*птеранодоны	птеранодони	1
синее	*синее	синє	1
окутал	*окутал	оповив	1
лучшая	*лучшая	енциклопедія	1
мудренее	*мудренее	мудріший	1
бывает	*бывает	багато	1
.	*юбке	.	1
стало	*аниме	.	1
захотите	*захотите	.	1
сыпать	*сыпать	сипати	1
размещая	*размещая	розміщуючи	1
лежат	*лежат	лежать	1
три	*три	ласкаві	1
ваш	*ваш	?	1
услышав	*услышав	цей	1
установил	*установил	меню	1
запел	*запел	заспівав	1
перестроил	*перестроил	гараж	1
леший	*леший	лісовик	1
издали	*издали	здалеку	1
красивой	*красивой	жінка	1
утратил	*утратил	повагу	1
какое	*какое	яке	1
гораздо	*гораздо	було	1
становится	*становится	часом	1
ян	*ян	ян	1
сытый	*сытый	ситий	1
низкий	*низкий	учень	1
касабланку	*касабланку	у	1
покататься	*покататься	я	1
богат	*богат	багатим	1
лекарства	*лекарства	мають	1
кюрасао	*кюрасао	в	1
создатели	*создатели	заміняємо	1
беле	*беле	відказав	1
рад	*рад	рад	1
заменяем	*заменяем	,	1
ушел	*ушел	звідти	1
завидую	*завидую	заздрю	1
истинных	*приверженцев	висловлювань	1
антикварная	*великолепная	меблі	1
долги	*остави	як	1
исландский	*исландский	.	1
старших	*три	старших	1
вечность	*вечность	,	1
обязанностей	*обязанностей	"на	1
покуковать	*покуковать	кукувати	1
присутствовал	*присутствовал	на	1
оденься	*оденься	вдягнись	1
зонтик	*зонтик	в	1
выпал	*выпал	падъ	1
побрил	*побрил	поголив	1
хромую	*хромую	заховати	1
выйдет	*выйдет	вийде	1
саэб	*саэб	хоче	1
.	*отделяет	відділяє	1
апельсины	*апельсины	помаранчі	1
разбрасывающего	*разбрасывающего	плюшевих	1
сбрасывать	*сбрасывать	вазі	1
;	*днесь	хліб	1
бей	*бей	вдар	1
нашим	*нашим	з	1
скользили	*скользили	ковзали	1
ни	*ни	,	1
французы	*французы	як	1
грааль	*грааль	,	1
чудесна	*чудесна	чудова	1
нашей	*нашей	нашою	1
долги	*остави	на	1
пьёшь	*пьёшь	завджи	1
одолжить	*одолжить	позичити	1
эсперанто	*эсперанто	—	1
стеснительные	*стеснительные	як	1
опечалены	*опечалены	засмучені	1
танцевали	*танцевали	танцювали	1
храпит	*храпит	він	1
потерь	*потерь	усіх	1
врун	*врун	більший	1
нептуна	*нептуна	,	1
»	*испортили	її	1
бьорк	*бьорк	бьорк	1
уходом	*уходом	би	1
ненавидела	*ненавидела	ненавиділа	1
римлян	*римлян	за	1
пусто	*пусто	пусто	1
солгал	*солгал	мені	1
припев	*припев	приспів	1
повлияет	*повлияет	їхні	1
до	*до	,	1
родила	*родила	місяця	1
боязливые	*бываем	такі	1
измерим	*измерим	виміряємо	1
употребляется	*употребляется	у	1
плюшевых	*плюшевых	розкидував	1
забеременела	*забеременела	завагітніла	1
средиземном	*средиземном	у	1
!	*мотоцикл	мотоцикл	1
многоразового	*проездного	квитка	1
небеси	*небеси	на	1
ушёл	*ушёл	я	1
курить	*курить	не	1
подготовиться	*подготовиться	готуватися	1
сыро	*сыро	сиро	1
развлекались	*развлекались	,	1
другой	*другой	порядки	1
помни	*помни	"пам'ятай	1
до	*до	години	1
какие-нибудь	*какие-*нибудь	якісь	1
неспокойно	*неспокойно	неспоійно	1
будто	*боялся	боявся	1
ричард	*ричард	,	1
всякий	*всякий	всякий	1
обопрись	*обопрись	обіпрись	1
жарко	*жарко	чуєтете	1
янина	*янина	яніна	1
спальне	*спальне	втнули	1
»	*испортили	не	1
.	*франции	.	1
боязливые	*бываем	соромливі	1
даждь	*насущный	прощаємо	1
униформа	*униформа	?	1
чек	*чек	чек	1
,	*догнать	наздогнати	1
улыбнулась	*улыбнулась	усміхнулась	1
голубом	*голубом	перроті	1
футов	*футов	на	1
тише	*тише	те	1
венера	*венера	венера	1
уборная	*уборная	прибиральня	1
насущный	*наш	ми	1
родила	*родила	народила	1
увяз	*увяз	по	1
какие-нибудь	*какие-*нибудь	з	1
пакистан	*пакистан	пакістан	1
жениться	*жениться	,	1
опыта	*никакого	досвіду	1
рик	*рик	рік	1
возле	*возле	до	1
зацветает	*папоротник	зацвітає	1
марко	*марко	марко	1
поговорить	*поговорить	потеревеніти	1
жениться	*жениться	на	1
поживаешь	*поживаешь	ся	1
обманули	*обманули	обдурили	1
чтобы	*грею	не	1
теннис	*теннис	в	1
эсперанто	*эсперанто	за	1
бесследно	*бесследно	,	1
афины	*афины	до	1
здешними	*здешними	складено	1
разыскиваемыми	*разыскиваемыми	номером	1
фланели	*фланели	чоловіка	1
всю	*украсть	з	1
шёпотом	*шёпотом	пошепки	1
.	*уходили	ними	1
сдвинулась	*сдвинулась	зрушилася	1
госпоже	*госпоже	мої	1
ива	*ива	верба	1
атласе	*атласе	атласі	1
предназначение	*предназначение	призначення	1
обманывают	*обманывают	дурять	1
дешевле	*дешевле	дешевший	1
беседуем	*беседуем	i	1
понравилось	*понравилось	сподобалось	1
иврит	*иврит	іврит	1
шляпу	*шляпу	капелюха	1
признателен	*признателен	,	1
петр	*петр	петр	1
грей	*грей	,	1
потому	*потому	,	1
клевещет	*клевещет	мене	1
филипп	*филипп	,	1
крупными	*крупными	великими	1
сладкий	*сладкий	солодкий	1
боится	*боится	не	1
лентяй	*лентяй	ледар	1
капельки	*капельки		1
взял	*взял	бог	1
летают	*летают	летають	1
фотографируйте	*фотографируйте	,	1
услышала	*услышала	що	1
отрастил	*отрастил	відростив	1
уганды	*уганды	уганди	1
шпионила	*шпионила	шпигувала	1
годится	*годится	користним	1
гольф	*гольф	вправно	1
целый	*целый	цілу	1
картонных	*картонных	картонних	1
сильнейшее	*сильнейшее	найсильніша	1
неудачник	*неудачник	невдаха	1
автомобиль	*водить	.	1
разозлился	*разозлился	розлютився	1
следами	*следами	він	1
рыгаю	*рыгаю	відригую	1
сентиментален	*сентиментален	сентементальний	1
.	*благоденствовать	процвітати	1
свободен	*свободен	завжди	1
огромное	*огромное	величезне	1
отличить	*отличить	,	1
многая	*многая	многая	1
глуп	*глуп	дурний	1
несчастных	*несчастных	випадків	1
младшей	*младшей	молодшою	1
другие	*другие	й	1
кивнул	*кивнул	кивнув	1
ни	*ни	жодне	1
одноклассники	*одноклассники	однокласники	1
измерим	*измерим	,	1
однажды	*однажды	одного	1
старше	*старше	стаєш	1
отлынивает	*отлынивает	страйкує	1
стеснялся	*стеснялся	розмовляти	1
уехать	*уехать	потрібно	1
сбылась	*сбылась	здійснилася	1
читал	*читал	вже	1
.	*ящерицу	.	1
похожа	*похожа	схожа	1
курит	*курит	палить	1
купальник	*купальник	купальник	1
основывается	*максимальном	на	1
концов	*вернулся	він	1
двадцатилетняя	*двадцатилетняя	минулого	1
возрасте	*возрасте	в	1
наш	*наш	як	1
невербальным	*невербальным	.	1
мы	*якоже	твоє	1
ни	*ни	за	1
гораздо	*гораздо	коли	1
пораньше	*пораньше	.	1
наша	*наша	дочка	1
андрееску	*андрееску	передайте	1
товарного	*товарного	всю	1
рейх	*рейх	кажете	1
якоже	*наша	прийде	1
намажь	*намажь	намаж	1
небольшая	*небольшая	невелика	1
интригует	*интригует	інтригує	1
блузка	*блузка	пасуватиме	1
пожалуйста	*пожалуйста	полагодьте	1
суматра	*суматра	суматра	1
волнуюсь	*волнуюсь	про	1
стало	*аниме	де	1
воровать	*воровать	може	1
исполнение	*исполнение	виконання	1
стеснительные	*стеснительные	боязкі	1
успокойся	*успокойся	заспокойся	1
траходон	*траходон	траходон	1
младше	*младше	мене	1
нашей	*нашей	.	1
ребятя	*ребятя	хлопці	1
чашечку	*чашечку	"ще	1
истории	*нашей	землі"	1
орала	*орала	меча	1
опять	*опять	знов	1
снился	*снился	снився	1
спячу	*спячу	з	1
лифтовой	*лифтовой	мінятимете	1
поскорее	*поскорее	повертайся	1
последнего	*последнего	останнього	1
пышный	*пышный	важке	1
повлияло	*повлияло	їх	1
возьми	*возьми	мою	1
истоптана	*истоптана	потоптана	1
мерцавшие	*мерцавшие	що	1
следуйте	*следуйте	слідуйте	1
демилл	*демилл	"мілль	1
таковы	*таковы	такі	1
а	*мертвым	—	1
пить	*пить	,	1
бойся	*бойся	бійся	1
горечь	*горечь	гіркоту	1
утонул	*утонул	потонув	1
богаты	*богаты	багаті	1
понос	*понос	діарея	1
африке	*африке	африці	1
и	*людских	людських	1
потерялся	*потерялся	я	1
какой	*какой	...	1
сэндае	*сэндае	сендаї	1
усерднее	*усерднее	він	1
заменяем	*исландским	датський	1
симпатичен	*симпатичен	симпатичний	1
ме	*ме	бе	1
они	*каковы	вони	1
гораздо	*гораздо	мій	1
,	*боязливые	вчинках	1
шевелитесь	*шевелитесь	ворушіться	1
пиццу	*пиццу	не	1
исландский	*исландский	створювачі	1
сыроед	*сыроед	сироїд	1
преуспеть	*преуспеть	досягти	1
основывается	*максимальном	через	1
будто	*будто	теба	1
несла	*несла	корзину	1
рассердиться	*рассердиться	боку	1
чёртов	*чёртов	:	1
стараться	*стараться	робити	1
эмета	*первоначально	емета	1
горит	*горит	повно	1
заменяем	*заменяем	датською	1
лестницу	*лестницу	сходи	1
молча	*молча	мовчки	1
уснула	*уснула	заснула	1
посмела	*посмела	наважилась	1
похожую	*похожую	схожу	1
странных	*странных	дивних	1
обрати	*обрати	:	1
теннис	*теннис	у	1
джонсон	*джонсон	вчений	1
фарфор	*фарфор	порцеляну	1
,	*догнать	щоб	1
похожи	*похожи	,	1
бирманских	*бирманских	я	1
аспирин	*аспирин	аспірин	1
комиксы	*комиксы	комікси	1
столь	*столь	архітектурі	1
наши	*наши	наша	1
спикировал	*спикировал	смак	1
сливок	*сливок	вершків	1
всё	*аж	них	1
сбываются	*сбываются	збуваються	1
они	*каковы	він	1
низкий	*низкий	найнижчий	1
вместо	*вместо	приймач	1
грязной	*грязной	брудного	1
изучать	*изучать	світу	1
несмотря	*несмотря	і	1
десерт	*десерт	десерт	1
нашей	*нашей		1
летает	*летает	крокодила	1
мицкевича	*мицкевича	«	1
беременна	*беременна	вагітна	1
другой	*другой	одною	1
госпоже	*госпоже	,	1
нептуна	*нептуна	зі	1
заменяем	*заменяем	з	1
шутит	*шутит	жартує	1
эгоистичным	*эгоистичным	егоїстичним	1
великой	*великой	величезною	1
джинсам	*джинсам	блуза	1
латынь	*латынь	латинь	1
и	*смолистая	горить	1
вдвоём	*вдвоём	ми	1
потому	*потому	люди	1
женда	*женда	женда	1
консоли	*консоли	до	1
погас	*погас	згас	1
устаёт	*устаёт	втомлюється	1
эмета	*эмета	емета	1
услышать	*услышать	хочуть	1
столь	*столь	настільки	1
киото	*киото	у	1
двадцатерых	*двадцатерых	двадцятьох	1
поступил	*поступил	не	1
нюнорска	*основывается	нюношка	1
приснилось	*приснилось	що	1
понадобится	*понадобится	нам	1
лёко	*лёко	льоко	1
невербальным	*невербальным	невербальним	1
угодно	*угодно	,	1
каким	*каким	ятаю	1
перепадала	*перепадала	отримував	1
перестроил	*гараж	у	1
порвала	*порвала	порвала	1
поедем	*поедем	поїдемо	1
лекарство	*лекарство	перед	1
понкьелли	*понкьелли	понк'єллі"	1
а	*мертвым	не	1
жирафов	*жирафов	жирафи	1
равно	*вчерашнего	само	1
одолжи	*одолжи	позич	1
родителей	*родителей	своїх	1
богат	*богат	заможним	1
настоящие	*настоящие	теперішні	1
амфитриты	*амфитриты	амфітрити	1
окончено	*окончено	закінчено	1
родители	*родители	познайомилися	1
и	*боязливые	такі	1
.	*мастей	.	1
швартовы	*швартовы	швартові	1
огромный	*огромный	величезний	1
услышать	*услышать	про	1
слепа	*слепа	сліпа	1
дианы	*адониса	адоніса	1
,	*боязливые	соромливі	1
купаюсь	*купаюсь	купаюся	1
наплакал	*наплакал	наплакав	1
мебель	*антикварная	.	1
хуйня	*хуйня	малята	1
боязливые	*бываем	буваємо	1
повлияет	*повлияет	вплине	1
и	*людских	не	1
вытерла	*вытерла	витерла	1
создались	*создались	створились	1
тягаться	*тягаться	змагатися	1
приходится	*приходится	це	1
дешевле	*дешевле	камеру	1
стеснительные	*порочно	хибно	1
однажды	*однажды	ти	1
убирайся	*убирайся	забирайся	1
малайзии	*малайзии	малайзії	1
огромное	*огромное	задоволення	1
любом	*любом	випадку	1
оглядывайся	*оглядывайся	озирайся	1
поторапливайся	*поторапливайся	поспішай	1
другой	*другой	ви	1
какого	*какого	ти	1
пазл	*пазл	якби	1
мяса	*мяса	’	1
пожалуйста	*пожалуйста	увімкнути	1
дурой	*дурой	ідіоткою	1
вините	*вините	звинувачуйте	1
нюнорска	*нюнорска	прапора	1
аж	*высохли	щоб	1
интернет	*интернет	інтернет	1
невежества	*невежества	невігластво	1
одноклассников	*одноклассников	любіть	1
женятся	*женятся	якому	1
мы	*якоже	і	1
женаты	*женаты	одружений	1
таинственные	*таинственные	загадкові	1
младше	*младше	,	1
угощайтесь	*угощайтесь	пригощайтеся	1
.	*оконце	.	1
,	*настойчива	хвацька	1
предстоящего	*предстоящего	майбутнього	1
лучшим	*лучшим	року	1
пустой	*пустой	пуста	1
чеки	*чеки	чеки	1
показалась	*показалась	показалася	1
стучал	*стучал	стукав	1
устроиться	*устроиться	влаштуватися	1
равно	*вчерашнего	,	1
прижиться	*прижиться	прижитися	1
стегозавр	*стегозавр	стегозавр	1
поймает	*поймает	біле	1
старше	*старше	він	1
пародию	*пародию	пародію	1
чтобы	*грею	та	1
кстати	*кстати	до	1
основную	*основную	основну	1
японцы	*японцы	?	1
другой	*другой	?	1
атаковала	*атаковала	атакувала	1
адама	*адама	міцкевича	1
старшая	*старшая	старша	1
успокоиться	*успокоиться	може	1
я	*наливаю	аж	1
предпочитаю	*предпочитаю	намагаюсь	1
некоторые	*некоторые	хтось	1
обналичьте	*обналичьте	беріть	1
допотопными	*допотопными	землі	1
синей	*синей	для	1
крис	*крис	кріс	1
попытался	*попытался	я	1
одинок	*одинок	самотнім	1
спячу	*спячу	я	1
уловил	*уловил	вловити	1
летает	*летает	опудало	1
дружелюбные	*дружелюбные	дружелюбні	1
опоздаешь	*опоздаешь	спізнишся	1
жалует	*жалует	.	1
возрасте	*возрасте	одружуються	1
крупный	*рогатый	.	1
становилось	*становилось	ставало	1
пожалуйста	*пожалуйста	ласкаві	1
чёртов	*камень	людьми	1
к	*к	підготувалася	1
встал	*встал	вранці	1
довольна	*довольна	задоволена	1
фриман	*фриман	фріман	1
пожалуйста	*пожалуйста	прошу	1
здесь	*здесь	отут	1
приступа	*приступа	нападу	1
лучший	*лучший	накращий	1
к	*к	війни	1
к	*к	звикнути	1
якоже	*наша	нам	1
строки	*строки	варто	1
огромным	*огромным	монстром	1
другие	*другие	цієї	1
деревне	*деревне	не	1
опять	*опять	знову	1
афиша	*афиша	впала	1
ни	*ни	слова	1
бешена	*бешена	дурна	1
сам	*носить	,	1
направляются	*сообщники	.	1
присутствовало	*присутствовало	присутньо	1
соломинка	*соломинка	ооломинка	1
мягкий	*мягкий	’	1
одета	*одета	одягнена	1
стало	*аниме	аніме	1
чёртов	*чёртов	складено	1
париже	*париже	я	1
уйдёт	*уйдёт	я	1
орали	*орали	орали	1
специально	*специально	навмисно	1
нюнорска	*нюнорска	.	1
садилось	*садилось	сідало	1
меленяны	*меленяны	золота	1
познакомились	*познакомились	в	1
нюнорска	*нюнорска	нюношку	1
щёки	*щёки	щоки	1
собственная	*собственная	життя	1
устал	*устал	зморився	1
заменяем	*исландским	ісландським	1
,	*мишек	плюшевих	1
джимми	*джимми	джиммі	1
повстречал	*повстречал	зустрів	1
звучала	*звучала	лунала	1
формалистской	*формалистской	заводишся	1
влюбился	*влюбился	закохався	1
танцовщица	*танцовщица	.	1
пожалуйста	*пожалуйста		1
болтай	*болтай	базікай	1
возросло	*возросло	зросла	1
уходим	*уходим	тільки	1
услышала	*услышала	ніколь	1
упорядоченное	*упорядоченное	множина	1
двадцатилетняя	*двадцатилетняя	дівчинку	1
чёртов	*камень	камінь	1
к	*к	цієї	1
патчем	*патчем	,	1
чесал	*чесал	спробував	1
допотопными	*допотопными	допотопними	1
курить	*курить	тереторії	1
бэтти	*бэтти	,	1
квантовая	*квантовая	квантова	1
вернула	*вернула	повернула	1
токио	*токио	з	1
токио	*осакой	.	1
истинных	*приверженцев	,	1
кинозвездой	*великой	кінозіркою	1
мюриэл	*мюриэл	мене	1
оконце	*наше	загляне	1
истинных	*истинных	істинних	1
дом	*собственный	дім	1
присмотришь	*присмотришь	них	1
несмотря	*несмотря	те	1
перевернись	*перевернись	перевернися	1
задал	*задал	йому	1
кататься	*кататься	смородину	1
неверные	*неверные	невірні	1
вернусь	*вернусь	я	1
мы	*якоже	твоя	1
чародеи	*чародеи	привиди	1
другой	*другой	другої	1
употребляется	*употребляется	дієслово	1
.	*заказывал	.	1
курить	*курить	школи	1
амфитриты	*дианы	жінки	1
потребовалась	*потребовалась	знадобиться	1
послушаться	*послушаться	тобі	1
ломит	*ломит	ломить	1
столь	*столь	ж	1
.	*пожалуйста	будь	1
помню	*помню	пам	1
джерри	*джерри	джері	1
пустую	*пустую	пусту	1
крупный	*рогатый	рогату	1
взгляни	*взгляни	подивись	1
выбрасывают	*выбрасывают	але	1
посоветовала	*посоветовала	порадила	1
синим	*синим	нова	1
создатели	*создатели	помітили	1
медный	*медный	мідний	1
закурю	*закурю	я	1
двадцатилетняя	*двадцатилетняя	дочка	1
сегодняшний	*сегодняшний	день	1
чтобы	*грею	,	1
«	*звучит	єтнамською	1
зажечь	*зажечь	будь	1
сердита	*сердита	зла	1
ближайшем	*ближайшем	найближчому	1
черным	*черным	чорним	1
нюнорска	*нюнорска	ось	1
разрушена	*разрушена	зруйнована	1
нептуна	*нептуна	день	1
таинственные	*таинственные	подобалися	1
,	*подумал	досягли	1
насущный	*наш	і	1
лучшая	*лучшая	геттер	1
якоже	*наша	святиться	1
выбирать	*гноя	вибирати	1
виделись	*виделись	бачилися	1
повесила	*повесила	повісила	1
три	*три	і	1
времен	*до	мамонтів	1
уставшей	*уставшей	втомлена	1
свари	*свари	звари	1
аист	*аист	лелека	1
огромного	*огромного	крокодила	1
сожалению	*сожалению	,	1
певица	*певица	яані	1
морковкой	*прозвали	прозвали	1
ускакал	*ускакал	поскакав	1
ужинал	*ужинал	вечеряв	1
поговорить	*поговорить	побалакати	1
крупными	*крупными	дуже	1
противились	*противились	противилися	1
америки	*америки	південну	1
мужчины	*мужчины	синьої	1
.	*вышло	.	1
моцарта	*моцарта	моцарта	1
старших	*три	сестер	1
расчитывали	*расчитывали	очікували	1
прямоугольна	*прямоугольна	не	1
выглядит	*выглядит	має	1
вчерашнем	*вчерашнем	у	1
пуговица	*пуговица	.	1
наш	*наш	великий	1
происшествию	*происшествию	.	1
польша	*польша	польща	1
вставай	*вставай	вставай	1
ручей	*ручей	без	1
неизвестной	*неизвестной	невідома	1
звонил	*звонил	телефонував	1
дослужилась	*дослужилась	пошти	1
залезешь	*залезешь	залізеш	1
нежно	*нежно	ніжно	1
белоруссии	*белоруссии	білорусі	1
теннисную	*теннисную	тенісну	1
и	*пиджак	брюки	1
покрасят	*покрасят	пофарбують	1
обжег	*обжег	собі	1
андрееску	*андрееску	вітання	1
молодой	*молодой	молодої	1
и	*стеснительные	,	1
удалась	*удалась	вдалося	1
гугла	*гугла	допомогою	1
уин-та-тати-терий	*уин-та-*тати-*терий	уін-та-таті-терий	1
шелдрейк	*шелдрейк	шелдрейк	1
таинственные	*таинственные	персонажі	1
,	*бизонов	малював	1
погладить	*погладить	попрасувати	1
ведро	*ведро	відро	1
разрядился	*разрядился	розрядився	1
ваш	*ваш	парасолю	1
похожий	*похожий	схожий	1
поцарапал	*поцарапал	подряпав	1
и	*рейха	рейху	1
долги	*остави	прийде	1
услышал	*услышал	почув	1
и	*стеснительные	боязкі	1
боюсь	*боюсь	не	1
создатели	*полноэкранных	створювачі	1
кейко	*кейко	вона	1
концентрационных	*концентрационных	концентраційних	1
рассердиться	*рассердиться	рогніватись	1
вчерашнего	*вчерашнего	хворий	1
асоциален	*асоциален	не	1
установил	*установил	патчем	1
шансы	*неплохие	на	1
бросилась	*бросилась	йому	1
аж	*высушу	аж	1
жирки	*жирки	за	1
разбудило	*разбудило	розбудило	1
забраться	*забраться	вилізти	1
пародию	*пародию	відрізнити	1
сводит	*сводит	зводить	1
большей	*большей	більшої	1
,	*наш	це	1
долги	*остави	;	1
якоже	*наша	буде	1
мамонт	*мамонт	мамонт	1
мужчин	*мужчин	продаються	1
близких	*близких	близьких	1
меленянах	*меленянах	.	1
старших	*три	трьох	1
волнует	*волнует	хвилює	1
рыдала	*рыдала	ридала	1
банкет	*банкет	,	1
карьеру	*карьеру	свою	1
черная	*черная	білі	1
вдвоём	*вдвоём	вдвох	1
.	*вытерплю	.	1
детектив	*читаю	.	1
другой	*другой	мова	1
просыпаются	*просыпаются	прокидаються	1
ивонн	*ивонн	івон	1
пунктуальный	*пунктуальный	пунктуальний	1
французы	*французы	їм	1
глупцы	*глупцы	пустомудрі	1
вегетарианец	*вегетарианец	вегетаріанець	1
нам	*даждь	насущний	1
всю	*украсть	товарного	1
стремглав	*стремглав	хутко	1
закурю	*закурю	закурю	1
разбрасывающего	*разбрасывающего	що	1
здраств	*здраств	добриде	1
долги	*остави	і	1
крупный	*крупный	велику	1
звонить	*звонить	дзвонити	1
врун	*врун	брехун	1
обязательно	*обязательно	випий	1
майк	*майк	думав	1
направляются	*направляются	можливі	1
опоздаем	*опоздаем	запізнимось	1
злись	*злись	злостися	1
леший	*вурдалаки	вовкулаки	1
ни	*ни	що	1
нагасаки	*нагасаки	нагасакі	1
содовая	*содовая	сода	1
библии	*библии	біблії	1
охотился	*охотился	оленів	1
приманке	*приманке	.	1
драконы	*драконы	дракони	1
здравствуйте	*здравствуйте	привіт	1
выдумали	*выдумали	в	1
дослужилась	*дослужилась	стенографісткою	1
часты	*часты	землетруси	1
налей	*налей	налий	1
грааль	*грааль	грааль	1
нуждается	*нуждается	потребує	1
выражаем	*выражаем	висловлюємо	1
нюнорска	*основывается	.	1
причёской	*причёской	"з	1
разряжена	*разряжена	розряджена	1
великой	*великой	,	1
гнилое	*гнилое	яблуко	1
нечётные	*нечётные	це	1
обходили	*обходили	оминали	1
вышла	*вышла	за	1
помнится	*помнится	пам'ятається	1
какао	*какао	какао	1
ни	*ни	скажеш	1
преуспеете	*преуспеете	досягли	1
путать	*нельзя	можна	1
переносили	*переносили	м	1
догадываться	*догадываться	,	1
твердят	*твердят	стверджують	1
жюля	*жюля	про	1
фламинго	*фламинго	фламінго	1
смыло	*смыло	змило	1
кукареку	*кукареку	«	1
укрыта	*укрыта	була	1
диарея	*диарея	діарея	1
двери	*двери	ці	1
барабана	*барабана	барабана	1
прилипла	*жвачка	прилипла	1
шутить	*шутить	зі	1
великолепно	*великолепно	чудово	1
дианы	*адониса	та	1
дует	*дует	дме	1
учетную	*учетную	"свій	1
.	*задумываюсь	над	1
колумб	*колумб	христофор	1
,	*настойчива	мов	1
браузер	*браузер	не	1
хромую	*хромую	кульгаве	1
блейк	*блейк	блейка	1
единственные	*единственные	,	1
.	*кинозвездой	.	1
воспользоваться	*воспользоваться	скористатися	1
никакой	*никакой	жодної	1
?	*ягода	»	1
богат	*богат	.	1
нару	*нару	нару	1
терпеливым	*терпеливым	терплячим	1
,	*скрипят	скриплять	1
направляетесь	*направляетесь	направляєтеся	1
подчиниться	*подчиниться	підкоритися	1
различными	*различными	кілька	1
кассету	*кассету	касету	1
обмякните	*обмякните	розслабтеся	1
взлома	*взлома	злому	1
перегораживайте	*перегораживайте	шлях	1
именно	*кончилось	саме	1
задал	*задал	поставив	1
а	*мертвым	душі	1
к	*к	роботу	1
,	*боязливые	як	1
тает	*тает	тане	1
деревню	*деревню	рідного	1
плавает	*плавает	плаває	1
ерунды	*ерунды	дурниць	1
зелёный	*зелёный	на	1
и	*людских	і	1
ездит	*карпаты	карпати	1
больший	*больший	не	1
выберемся	*выберемся	виберимося	1
сутках	*сутках	добі	1
мебель	*антикварная	меблі	1
мягкий	*мягкий	погляд	1
пиджак	*пиджак	піджак	1
простудиться	*простудиться	застудитися	1
пригородный	*пригородный	приміський	1
завтракает	*завтракает	снідає	1
злить	*злить	злити	1
какую	*какую	яку	1
чучело	*чучело	літає	1
джейн	*джейн	джейн	1
поводу	*поводу	здавання	1
успокойся	*успокойся	розслабся	1
пазл	*пазл	скласти	1
зарезервированы	*зарезервированы	зарезервовані	1
решились	*решились	зважилися	1
искупаться	*искупаться	скупатись	1
нептун	*нептун	нептун	1
успокоиться	*успокоиться	це	1
уставший	*уставший	втомлений	1
ок	*ок	гаразд	1
чихаю	*чихаю	чихаю	1
сухопутных	*сухопутных	у	1
приамурье	*приамурье	приамур	1
японцев	*японцев	багато	1
несет	*несет	несе	1
опоздает	*опоздает	запізниться	1
нагревается	*нагревается	стає	1
строгий	*строгий	суворий	1
»	*михалово	день	1
чашку	*чашку	перед	1
успеет	*успеет	чи	1
согласиться	*согласиться	погодитися	1
потеряли	*потеряли	втратили	1
!	*аж	!	1
вытрите	*вытрите	витирайте	1
утихнет	*утихнет	вщухне	1
китай	*китай	китай	1
последнее	*последнее	мюріел	1
впустую	*впустую	.	1
вашей	*вашей	вашою	1
редьку	*редьку	редьку	1
ездит	*ездит	їздить	1
теннис	*теннис	.	1
последнее	*последнее	останнім	1
апельсины	*апельсины	ростуть	1
старше	*старше	ще	1
разыскивали	*разыскивали	розшукували	1
детки	*детки	малий	1
,	*боязливые	це	1
пятница	*пятница	п'ятниця	1
пропустишь	*пропустишь	пропустиш	1
прихожей	*прихожей	.	1
справимся	*справимся	впораємося	1
задала	*задала	декілька	1
для	*необходимы	збалансованого	1
тётя	*тётя	дала	1
страстно	*страстно	пристрасно	1
пар	*аж	них	1
здравствуйте	*здравствуйте	драстуйте	1
поделаешь	*поделаешь	поробиш	1
допотопными	*допотопными	з	1
ширину	*ширину	вшир	1
ни	*ни	анi	1
дорого	*дорого	дорого	1
чёртов	*чёртов	чортів	1
молодому	*молодому	молодому	1
предоставляя	*предоставляя	,	1
чёрный	*чёрный	чорний	1
укрыта	*укрыта	вкрита	1
сладостей	*сладостей	солодощів	1
стенографистки	*стенографистки	стенографісткою	1
просыпаешься	*просыпаешься	прокидаєшся	1
тяжеловоз	*тяжеловоз	ваговоз	1
заменяем	*исландским	датською	1
к	*к	:	1
стрекотун	*стрекотун	стрекотун	1
красивые	*красивые	міста	1
прокисло	*прокисло	скисло	1
создатели	*создатели	прапора	1
одета	*одета	.	1
вебсайтам	*вебсайтам	заборонено	1
жирный	*жирный	гладкий	1
ледокол	*ледокол	криголам	1
билл	*билл	білл	1
другой	*другой	вчити	1
поехал	*поехал	народження	1
смазал	*смазал	змастив	1
покончил	*покончил	покінчив	1
»	*грушевка	метро	1
заснуть	*заснуть	заснути	1
пить	*пить	їсти	1
огромного	*огромного	світом	1
йокогама	*йокогама	.	1
диарея	*диарея	пронос	1
взял	*взял	позичив	1
.	*вышло	не	1
преуспеете	*преуспеете		1
вернёмся	*вернёмся	на	1
вордпресса	*вордпресса	вордпреса	1
патчем	*патчем	патчем	1
гораздо	*гораздо	значно	1
участие	*участие	прийняти	1
мягкий	*мягкий	знак	1
глупую	*глупую	таку	1
кредиткой	*кредиткой	кредиткою	1
почините	*почините	іграшку	1
докладывали	*докладывали	докладали	1
оказываемых	*оказываемых	учинених	1
,	*боязливые	боязкі	1
бывшего	*бывшего	колишнього	1
направляются	*сообщники	і	1
участвовать	*участвовать	взяти	1
японцы	*японцы	віці	1
парикмахера	*парикмахера	перукаря	1
бросилась	*бросилась	афіша	1
непуганых	*непуганых	неляканих	1
суждено	*суждено	зустріти	1
всё	*аж	це	1
следить	*следить	стежити	1
жгучей	*жгучей	смаги	1
.	*млекопитающие	люди	1
тревожит	*тревожит	хвилює	1
постели	*постели	ліжку	1
допотопными	*допотопными	подумав	1
прождал	*прождал	прочекав	1
трусихой	*трусихой	і	1
»	*испортили	ж	1
укусила	*укусила	вкусив	1
мавр	*мавр	,	1
доберусь	*доберусь	доберуся	1
величайших	*величайших	найвидатніших	1
греет	*греет	гріє	1
сэм	*сэм	сем	1
.	*вкусный	.	1
якоже	*наша	,	1
всю	*украсть	вкрасти	1
кое	*кое	ютер	1
домохозяйка	*домохозяйка	домогосподарка	1
мэри	*мэри	був	1
выпендриваться	*выпендриваться	хизуватися	1
скучаю	*скучаю	за	1
фотографируйте	*фотографируйте	не	1
чёртов	*камень	розум	1
.	*мебель	.	1
касабланку	*касабланку	?	1
аой	*аой	аой	1
небольшой	*небольшой	легкий	1
падают	*падают	падають	1
согласен	*согласен	згодний	1
кимуру	*кимуру	кімуру	1
меленянах	*меленянах	про	1
спешить	*спешить	поспішати	1
москалик	*москалик	москалику	1
создатели	*создатели	прапор	1
съедобное	*съедобное	їстівне	1
,	*получилось	краще	1
стегозавра	*стегозавра	стегозавра	1
какой	*какой	якої	1
будто	*будто	,	1
подушку	*голову	голову	1
непредвиденный	*непредвиденный	непередбачений	1
ошибок	*грамматических	,	1
вырваться	*вырваться	можеш	1
римлян	*римлян	римлян	1
познакомиться	*познакомиться	познайомитися	1
побуду	*побуду	побуду	1
заменяем	*заменяем	заміняємо	1
глупо	*отвергать	відкидувати	1
отнимает	*отнимает	забирає	1
какое	*какое	ж	1
бывал	*бывал	яким	1
аж	*высохли	озеро	1
изобилие	*изобилие	кущів	1
уговорила	*уговорила	умовляла	1
избавься	*избавься	позбався	1
доволен	*доволен	їхнім	1
к	*к	мій	1
едете	*едете	їдете	1
высшее	*высшее	найвищий	1
взял	*взял	.	1
мнил	*мнил	уявляв	1
держись	*держись	тримайся	1
доисторической	*доисторической	доісторичної	1
бизон	*бизон	бізон	1
социальные	*социальные	соціальні	1
дует	*дует	дує	1
неплохая	*неплохая	непогана	1
пломбы	*пломбы	пломби	1
социальная	*социальная	"мережа	1
