уже	уже	вже	107
школу	школу	школи	46
со	з	зі	46
нет	нi	ні	42
с	з	із	38
.	.	."	30
мама	мама	мамо	26
тем	тем	тим	25
из	з	із	25
английский	англійський	англійську	25
человек	людей	людина	23
добрый	добрий	доброго	23
том	том	тому	23
зачем	нащо	навіщо	22
тебе	тобі	тебе	20
отец	тато	батько	19
же	ж	же	19
вечер	вечір	вечора	18
да	так	та	18
цветы	цвіти	квіти	17
нам	нам	нас	17
учитель	учитель	вчитель	17
это	це	цей	16
из	з	зі	16
язык	мова	мову	16
бела	біла	бела	15
мне	мені	мене	14
любите	любите	любіть	14
играю	граюся	граю	14
дома	дому	вдома	14
всё	все	усе	13
то	то	те	13
несколько	кілька	декілька	12
реку	ріку	річку	12
бела	біла	бело	12
был	був	була	12
играть	гратися	грати	12
снова	снова	знов	12
столе	стілі	столі	11
это	це	ця	11
английский	англійський	англійська	11
года	року	роки	10
помешали	завадили	заважали	10
тома	тому	тома	10
я	я	"я	10
весь	весь	увесь	10
всех	всіх	усіх	10
все	всі	все	10
японию	японію	японії	10
иди	йди	іди	10
шесть	шість	шостій	10
кровати	ліжка	ліжку	10
часы	години	годинник	10
господин	пан	пане	9
было	було	була	9
италию	італію	італії	9
извините	вибачите	вибачте	9
смотри	дивися	дивись	9
свой	свій	свою	9
девочка	дівча	дівчинка	9
пассажиры	поважати	пасажири	9
доброе	добре	доброго	9
утро	ранок	ранку	9
идти	йти	іти	9
него	його	нього	9
улучшить	поліпшити	покращити	8
аэропорт	аеропорт	аеропорту	8
китайский	китайський	китайську	8
зовут	звуть	звати	8
книгу	книзі	книгу	8
капитан	капітан	капітане	8
большой	великої	великий	8
продаются	продають	продаються	8
остаётся	лишається	залишається	8
снова	снова	знову	8
тебе	тобі	тобою	8
был	був	було	8
пойдем	підімо	підемо	8
со	з	із	8
дождя	дощу	дощ	8
английском	англійськім	англійській	8
человека	людину	людини	8
минский	мінський	міська	7
уж	уже	вже	7
доктор	доктор	докторе	7
так	так	такий	7
твой	твій	твою	7
будем	будьмо	будемо	7
всё	все	весь	7
зоопарк	зоопарк	зоопарку	7
посмотрите	подивитеся	подивіться	7
таком	такім	такому	7
одно	одне	один	7
еда	їда	їжа	7
утра	ранки	ранку	7
правда	правда	справді	7
том	том	томе	7
всего	всього	усього	7
дня	дня	дні	7
ради	ради	заради	7
своё	своє	свою	7
заметил	замітив	помітив	7
давай	давай	давайте	7
в	що	до	6
интересуюсь	цікавлю	цікавлюся	6
идёт	йде	іде	6
лондон	лондона	лондону	6
поезде	поїзді	потязі	6
руку	руці	руку	6
это	це	ці	6
стола	стіла	столу	6
очень	сильне	сильно	6
два	два	дві	6
построил	збудував	побудував	6
немецкий	німецький	німецьку	6
вокзала	хвиль	хвилин	6
найти	знайти	віднайти	6
осталось	лишилося	залишилось	6
с	з	зі	6
английского	англійського	англійської	6
свет	світ	світло	6
нас	наc	нас	6
дочери	дочки	дочок	6
утром	ранком	ранку	6
две	дві	два	6
была	була	було	6
норма	норма	нормо	6
море	море	морі	6
выход	вихід	виходу	6
играл	грався	грав	6
полотенце	рушник	рушника	6
огонь	вогонь	вогню	6
наверное	напевне	напевно	6
полезное	корисне	корисна	6
рассказал	розказав	розповів	5
сказать	сказати	казати	5
едва	ледь	ледве	5
шёл	йшов	ішов	5
будущем	майбутнім	майбутнє	5
запрещено	заборонене	заборонено	5
любят	люблять	полюбляють	5
иногда	іноді	інколи	5
прописанное	прописане	прописані	5
с	з	за	5
две	дві	двох	5
этих	цих	цим	5
затраты	затрати	витрати	5
битве	битві	битви	5
доброго	доброго	добраніч	5
украинском	українськім	українській	5
вошли	увійшли	зайшли	5
бы	що	щоб	5
пойдём	підімо	підемо	5
веков	віка	віків	5
если	якщо	якби	5
рыбаку	рибаку	рибалки	5
одного	одного	однієї	5
будет	буде	будуть	5
формой	формою	формі	5
английское	англійське	англійську	5
берег	берег	берега	5
себе	собі	себе	5
берегу	берегу	берега	5
оружие	зброя	зброю	5
осторожен	обережний	обережним	5
своём	своєму	своє	5
а	а	та	5
музыку	музиці	музику	5
доллара	долара	долари	5
подарков	дарунків	подарунки	5
учиться	навчатися	вчитися	5
летом	літом	влітку	5
своё	своє	свій	5
оставайся	лишайся	залишайся	5
сумку	сумку	сумки	5
ребёнку	дитині	дитини	5
белом	білім	біле	5
случится	станеться	трапиться	5
забудем	забудьмо	забудемо	5
польский	польський	польский	5
минуту	хвилю	хвилину	5
так	так	таке	5
кофе	кави	кава	5
всём	всьому	усьому	5
пассажира	пасажира	пасажири	5
шага	кроку	кроки	5
едой	їдою	їжею	5
своих	своїх	твоїх	5
автобус	автобус	автобусу	5
часов	годин	година	5
врачу	лікарю	лікаря	5
вчера	вчора	учора	5
комнату	кімнату	кімнати	5
на	направду	насправді	5
час	година	годину	5
внезапно	раптово	раптом	5
подождите	почекайте	зачекайте	5
этом	цім	цому	5
уверены	упевнені	впевнені	5
люблю	люблю	полюбляю	4
большая	велика	велику	4
вспомнили	пригадали	згадали	4
предупреждён	попередлений	попереджений	4
вооружён	озброєний	озброєнний	4
поезда	поїзда	потяга	4
таким	таким	таке	4
меняется	міняє	міняється	4
подождите	почекайте	почекай	4
всегда	завжди	завджи	4
врачом	лікарем	лікаря	4
словах	словах	словами	4
такой	такій	таку	4
честной	чесній	чесної	4
он	він	вона	4
официальный	офіційний	офіційна	4
рис	ріс	рис	4
так	так	така	4
хозяйству	господі	господарству	4
не	не	це	4
реке	ріці	річці	4
вопрос	питання	запитання	4
ждали	чекали	чекають	4
включено	включене	включено	4
года	пору	року	4
все	всі	усі	4
двое	двоє	двох	4
японской	японській	японської	4
союз	союз	союзу	4
разобрался	розібрався	розбирався	4
стал	став	стало	4
большие	великі	великих	4
решать	вирішувати	вирішити	4
девушке	дівчині	дівчиною	4
минуту	хвилю	хвилинку	4
челюсти	щелепи	щелепі	4
европейский	європейський	європейського	4
старым	старим	старою	4
перерыв	хвиль	хвилин	4
уверена	упевнена	впевнена	4
достаточно	достатньо	достатнього	4
такой	такий	така	4
краской	барвою	фарбою	4
слишком	занадто	надто	4
страусы	струсі	страуси	4
случилось	сталося	трапилося	4
тебя	тебе	теба	4
оставаться	лишатися	залишатися	4
собираюсь	збираюся	збираюсь	4
раз	раз	разу	4
вопросов	питань	запитань	4
учителях	учителях	вчителів	4
книгу	книзі	книжку	4
птицах	птахах	птахів	4
телу	тілу	тіла	4
сена	сіна	сена	4
растут	зростають	ростуть	4
этом	цім	цим	4
ты	ти	"ти	4
берегам	берегам	берегах	4
переводят	переводять	перекладають	4
рой	рий	рій	4
актрисе	актрисі	актрисою	4
природе	природі	природи	4
свободе	свободі	свободу	4
голосу	голосу	голосом	4
начальник	начальник	начальнику	4
это	всі	все	4
виды	види	видів	4
сравнению	порівнянню	порівнянні	4
часов	годин	годині	4
большом	великім	великому	4
коллекция	колекція	колекцію	4
папа	тато	батько	4
обвинён	звинувачений	обвинуватили	4
моё	моє	моя	4
ангела	ангела	янгола	4
рака	рака	рак	4
ногу	нозі	ногу	4
чём	чому	чого	4
интересное	цікаве	цікава	4
то	то	та	4
эфиопию	ефіопію	ефіопії	4
обычно	зазвичай	звичайно	4
прошлом	минулім	минулому	4
твои	твої	твоїх	4
коню	коню	коневі	4
открывать	відкривати	відчиняти	4
сна	сону	сну	4
запрещён	заборонений	заборонено	4
своей	своїй	своєму	4
недели	тижня	тижні	4
на	на	не	4
сажает	саджає	садить	4
дорогу	дорозі	дорогу	4
выбрал	вибрав	обрав	4
белой	білої	білою	4
большая	велика	великий	4
саду	саду	саді	4
нем	ньому	нього	4
будущем	майбутнім	майбутньому	4
такое	таке	такий	4
по	що	по	4
подарок	дарунок	подарунок	4
качественные	якісні	якісний	4
вещество	речовину	речовина	4
новый	новий	нову	4
тебе	всі	все	4
людях	людях	людей	4
эксперимент	експеримент	експеремент	4
части	частини	частині	4
?	?	?"	4
заплатили	сплатили	заплатили	4
убийстве	убивстві	вбивстві	4
пиццу	поділи	розділи	4
жёлтая	жовта	жовті	4
это	це	те	4
построен	збудований	побудовано	4
перевожу	переводжу	перекладаю	3
полудня	півдня	опівдня	3
девочки	дівчати	дівчата	3
экзамена	екзамену	екзамена	3
пиву	пиву	пива	3
химическое	хімічне	хімічна	3
красная	вона	червона	3
нравиться	подобатися	подобається	3
кому	кому	котрому	3
опасность	небезпеку	небезпечність	3
останусь	лишуся	залишуся	3
заполнена	заповнена	наповнена	3
восточной	східної	східною	3
пошёл	пішов	пішла	3
узнают	дізнаються	довідуються	3
мы	сталі	стали	3
киеве	києву	києві	3
пришёл	прийшов	прибув	3
открытыми	відкритими	відкритим	3
не	не	ну	3
внешности	зовнішності	зовнішістю	3
лукашенко	лукашенка	лукашенко	3
обеда	обіду	обід	3
поражённый	вражений	уражений	3
умираю	помираю	вмираю	3
экземпляром	екземпляром	екземпляр	3
одиннадцать	одинадцятеро	одинадцята	3
минут	хвиль	хвилин	3
позор	ганьбу	ганьба	3
козыря	козиря	козирів	3
я	одяг	одягу	3
норма	норма	нoрмa	3
вкусах	смаках	смаки	3
воскресенье	неділі	неділю	3
туалетной	туалетної	туалетного	3
учить	навчати	вивчати	3
юрист	юрист	юристом	3
отдохнете	відпочинете	відпочините	3
вопросы	питання	запитання	3
нашего	новим	новий	3
газету	газету	газети	3
темный	темний	темну	3
дитя	дитя	дитина	3
ты	ти	ви	3
комнате	кімнаті	кімнату	3
японский	японський	японська	3
скоростью	швидкістю	швидкості	3
учебное	навчальне	навчальний	3
невозможна	неможлива	неможливе	3
играли	гралися	грали	3
прислушавшись	прислухавшись	послухавши	3
момоти	момоти	момоті	3
обоим	обом	обох	3
умеет	вміє	уміє	3
международного	міжнародного	міжнародної	3
сразу	зразу	одразу	3
ничто	ніщо	нічого	3
горная	гірнича	гірська	3
убийцы	убивці	вбивця	3
маленькую	маленьку	маленьке	3
прекрасную	прекрасну	прекрасного	3
кодами	кодами	кодом	3
удерживал	утримував	притримував	3
столичном	столичнім	столичному	3
вспомнил	пригадав	згадав	3
взрослому	дорослому	дорослої	3
поможет	допоможе	допоможуть	3
шести	шести	шість	3
я	кави	каву	3
японский	рідний	рідна	3
пока	поки	доки	3
ключом	ключем	ключом	3
вошёл	увійшов	ввійшов	3
учёный	учений	вчений	3
реки	ріки	річки	3
рту	роту	роті	3
учителем	учителем	вчителем	3
ты	ти	ты	3
книги	книги	книжки	3
деньгами	грішми	грошима	3
японский	японський	японську	3
больной	хворою	хворий	3
востоку	сходу	схід	3
майор	майор	майоре	3
кузнецу	ковалю	ковалеві	3
старший	старший	найстарший	3
горные	гірничі	гірські	3
деревенская	сільська	сільське	3
повернулась	повернулася	розвернулася	3
комната	кімната	кімнаті	3
он	він	вiн	3
мари	їїзавдання	завдання	3
легенде	легенді	легендою	3
загрязнен	забруднений	забруднене	3
не	не	ще	3
делаешь	робиш	робитимеш	3
сыну	сину	сина	3
исполнено	виконане	виконано	3
рай	рай	раю	3
прячется	ховає	ховається	3
кофе	кавами	кава	3
шло	йшло	було	3
парк	парк	парку	3
найти	знайти	знайшли	3
плохого	поганого	погане	3
длине	довжині	довжиною	3
поменял	поміняв	проміняв	3
папа	тато	татко	3
ты	ти	чи	3
на	на	за	3
языку	мові	мови	3
десять	десять	десятій	3
допустил	допустив	припустився	3
бог	бога	бог	3
жалуется	жаліється	жалівся	3
официант	офіціант	офіціанте	3
собрались	зібралися	збиралися	3
курения	куріння	паління	3
упадке	занепаді	занепад	3
паутине	павутинню	павутиння	3
рациональны	раціональні	раціональними	3
вы	ви	чи	3
убийца	убивця	вбивця	3
японскому	японському	японської	3
рака	рака	раку	3
вошёл	увійшов	зайшов	3
сразу	зразу	відразу	3
мы	всі	все	3
причина	причина	причину	3
старом	старім	старому	3
квалифицированный	кваліфікований	кваліфікованим	3
здесь	нову	новий	3
осознают	усвідомлять	усвідомлюють	3
кроме	окрім	крім	3
должен	повинен	винен	3
старая	стара	старий	3
руле	кермі	керма	3
рыбы	риби	рибини	3
войне	війні	війни	3
лес	ліс	лісу	3
останутся	лишаться	залишаться	3
угрожать	погрожувати	загрожувати	3
университет	університет	університету	3
я	чув	почув	3
своим	своїм	своє	3
велосипед	велосипед	велосипеда	3
отношение	ставлення	ставитися	3
гордость	зір	зірок	3
персидский	перський	перська	3
верят	вірять	вірить	3
удивило	здивувало	здивувала	3
остались	лишилися	лишились	3
километров	кілометрів	километрів	3
специализируюсь	спеціалізуюся	спеціалізуюсь	3
колледж	коледж	коледжу	3
болеет	боліє	хворіє	3
давно	давно	довго	3
рассказала	розказала	розповіла	3
собаке	собаці	собаку	3
отдыха	спочинку	відпочинку	3
пациенте	пацієнті	пацієнта	3
холода	холоду	холоди	3
старый	старий	старе	3
родной	рідної	рідна	3
что-то	щось	чогось	3
смотрят	доглядають	заглядають	3
уберите	приберіть	прибери	3
ошибку	помилку	помилки	3
это	це	цю	3
тупой	тупої	тупий	3
добавить	додати	добавити	3
заставили	змусили	примусили	3
колодец	криниця	криницю	3
таким	таким	такою	3
мы	ми	ви	3
грех	сміх	гріх	3
детстве	дитинстві	дитинство	3
еду	їду	їжу	3
фотографиям	фотографіям	фотографій	3
глаз	темне	темно	3
язык	мову	вимову	3
меня	мене	мені	3
наполнить	наповнити	заповнити	3
вам	вам	вами	3
прекрасна	прекрасна	прекрасним	3
свою	свою	свій	3
спокоен	спокійний	спокійним	3
извините	вибачите	пробачте	3
папа	тато	тату	3
испанию	іспанію	іспанії	3
публичном	публічнім	публічному	3
верна	вірна	верна	3
японском	японськім	японському	3
брось	кинь	покинь	3
можете	можете	зможете	3
иду	йду	іду	3
маленькой	маленькій	маленькому	3
красной	червоною	червоним	3
и	засіб	засоб	3
национальности	національності	національністю	3
тому	тому	того	3
быстро	швидко	швидше	3
на	на	знак	3
короткими	короткими	коротким	3
молоком	молоком	молоко	3
ужин	готовий	готова	3
куском	шматом	шматком	3
остался	лишився	залишився	3
умереть	померти	вмерти	3
иностранный	іноземний	іноземну	3
еде	їді	їжі	3
вагона	вагона	вагону	3
тёмные	темні	темне	2
осталась	лишилася	лишилась	2
.	цейсценарій	сценарій	2
здоровый	здоровий	здоровезний	2
жива	жива	живою	2
религии	релігії	релігію	2
книг	книг	книжок	2
одной	одної	однієї	2
тихо	тихо	тиша	2
целую	цілую	цілу	2
всем	всім	усім	2
джон	джон	джоне	2
вы	всі	все	2
никто	ніхто	"ніхто	2
идите	йдіть	ідіть	2
экономично	економічно	економно	2
диаметре	діаметрі	диаметрі	2
тёмная	темна	темний	2
прекратил	припинив	припинило	2
всерьёз	всерйоз	серйозно	2
вообще	взагалі	узагалі	2
нестерпимой	нестерпної	нестерпний	2
сном	соном	сном	2
дочери	дочки	доньки	2
языке	мові	мовою	2
привлечь	залучити	зацікавити	2
делает	робить	чинить	2
мире	вісті	вести	2
это	це	не	2
заплатил	сплатив	заплатив	2
правильном	правильнім	правильному	2
большие	великі	великий	2
почтовый	поштовий	поштова	2
водой	водою	води	2
бессильный	безсилий	безсильний	2
французский	французький	французьку	2
были	були	біли	2
посмотреть	подивитися	подивитись	2
только	тільки	тiльки	2
воздержаться	утриматися	утриматись	2
чашкой	цейпитання	питання	2
серьёзное	серйозне	серйозну	2
твоих	твоїх	своїх	2
нужен	потрібний	потрібна	2
сложено	складене	складено	2
нравилось	подобалося	подобалась	2
выгнал	вигнав	прогнав	2
счастью	щастю	щастя	2
особенный	особливий	особлива	2
учит	навчає	вивчає	2
подаёте	подаєте	надаєте	2
младенца	немовляти	немовля	2
,	освіту	освіта	2
чём-то	чомусь	чому	2
это	це	це"	2
чувствовал	відчував	почував	2
науке	науці	науку	2
столу	стілу	столу	2
ним	ним	цим	2
телефона	телефону	телефоні	2
обед	обід	обіду	2
вы	ви	ти	2
меняет	міняє	змінює	2
приедет	приїде	прибуде	2
сдала	здала	склала	2
подальше	подальше	подалі	2
высокое	високе	висока	2
учёных	учених	вчених	2
я	початки	початок	2
почувствовала	почула	відчула	2
завтра	завтра	затра	2
выбрали	вибрали	обирали	2
сделано	зроблене	зроблено	2
прекрасной	прекрасної	прекрасним	2
остаться	лишитися	залишитися	2
кошка	кішка	кицька	2
считается	вважає	вважається	2
есть	їсти	поїсти	2
не	не	на	2
люди	люди	людей	2
прямо	прямо	просто	2
трудная	скрутна	складна	2
диалог	діалог	діалоги	2
прошли	пройшли	проминули	2
но	ж	же	2
доброй	доброю	доброї	2
поворачивается	повертається	повертає	2
священником	священиком	священником	2
вспомнила	пригадала	згадала	2
были	були	бути	2
инструкциям	інструкціям	інструкціями	2
дорожной	дорожньої	дорожною	2
помоги	допоможи	поможи	2
правонарушение	першеправопорушення	правопорушення	2
запишите	запишіть	запишите	2
мире	мирі	мир	2
запри	замкни	зачини	2
вы	ви	"ви	2
тома	томи	тома	2
остановились	зупинилися	зупинився	2
внимание	увагу	уваги	2
занимаюсь	займаюся	займаюсь	2
а	а	на	2
он	він	"він	2
украинский	український	українська	2
сказал	сказав	казав	2
подождёшь	почекаєш	почекаєте	2
бесконечна	нескінченна	нескінченний	2
эта	біла	бела	2
надеюсь	сподіваюся	сподіваюсь	2
ребёнка	дитини	дитину	2
голоса	голоси	голосу	2
отказал	відмовив	відказав	2
дома	доми	удома	2
всему	всьому	усього	2
верят	вірять	довіряють	2
доверять	довіряти	вірити	2
задачу	задачу	завдання	2
вы	готелі	готелю	2
женщиной	жінкою	жінка	2
толстый	товстий	товста	2
брошен	кинутий	кинуто	2
тёмную	темну	темний	2
прав	прав	правий	2
началось	почалося	почалася	2
важная	важлива	важливою	2
осталось	лишилося	залишилося	2
повсюду	повсюди	всюди	2
свежими	свіжими	свіжим	2
уверен	упевнений	впевнений	2
неизвестное	невідоме	невідомого	2
цветы	цвіти	квітки	2
учителю	учителю	вчителю	2
добудь	здобудь	добудь	2
номере	номер	номері	2
ходил	ходив	ходила	2
книгу	цюкнигу	книгу	2
не	сильне	сильно	2
нет	ні	нє	2
отличную	відмінну	відмінне	2
нам	нам	наші	2
сплошные	суцільні	оуцільні	2
езды	хвиль	хвилин	2
отличается	відзначається	відрізняється	2
интересуется	цікавить	цікавиться	2
начнём	почнемо	розпочнемо	2
пожилом	літнім	літню	2
приготовила	налаштувала	приготувала	2
audley	audley	auldey	2
облака	хмари	хмарини	2
остановилось	зупинилося	зупинилась	2
японию	японію	японіі	2
плохом	поганім	поганому	2
государственное	всі	все	2
арабский	арабський	арабська	2
осторожней	обережнішийий	обережніше	2
шутками	жартами	жартів	2
,	всістихії	стихії	2
заставил	змусив	примусив	2
получила	отримала	одержала	2
нету	нема	немає	2
следующего	білої	белою	2
задания	всізавдання	завдання	2
учёным	ученим	вченим	2
живьем	живцем	живим	2
повернись	повернися	повернись	2
перейти	перейти	переходити	2
хватало	вистачало	висточало	2
позвонить	зателефонувати	потелефонувати	2
семейству	сімейству	сімейства	2
присоединиться	приєднатися	приєднатись	2
сама	сама	сам	2
своевременно	своєчасно	вчасно	2
смотри	дивися	подивись	2
закончился	закінчився	скінчилася	2
,	знати	взнати	2
шума	шуму	шум	2
отца	тата	батька	2
такой	такий	такою	2
открыть	відкрити	відчинити	2
держитесь	тримаєте	тримайтеся	2
том	том	тома	2
французский	французький	французька	2
нужен	потрібний	потрібен	2
приятное	приємне	приємніше	2
открылась	відкрилася	відчинились	2
объявлен	оголошений	оголошено	2
убила	убила	вбила	2
десять	десять	десята	2
смотрите	дивитеся	дивіться	2
животных	тваринах	тварин	2
тонко	тонке	тонко	2
рекомендуется	рекомендує	рекомендується	2
была	була	бувала	2
французским	французьким	французською	2
ухе	усі	вусі	2
остаться	лишитися	залишитись	2
серьезное	серйозне	серйозна	2
юбилеем	ювілеєм	юбілеєм	2
прекраснее	прекраснішийий	прекрасніше	2
постоянная	постійна	постійний	2
гарантия	гарантія	гарантією	2
расскажу	розказажу	розкажу	2
хорошая	хороша	погода	2
выжили	вижили	вижило	2
аризону	аризону	арізоні	2
встретимся	зустріньмося	зустрінемось	2
я	цукерки	цукеркам	2
отсюда	звідси	звідки	2
голоса	голосу	голоси	2
работают	працюють	працює	2
наличными	готівками	готівкою	2
внимание	увага	увагу	2
английском	англійськім	англійською	2
приведите	приведіть	наведіть	2
помогает	допомагає	помогає	2
нос	ніс	носа	2
мэру	меру	мера	2
ухо	ухо	вухо	2
такой	такий	таким	2
можешь	можеш	можете	2
сад	сад	садок	2
песенном	пісеннім	пісенному	2
нет	фраза	фразі	2
присутствие	присутність	"присутність	2
игры	гри	ігри	2
дух	духа	дух	2
менять	міняти	змінювати	2
работники	працівники	працівними	2
закончились	закінчилися	закінчились	2
родного	рідного	власного	2
обучаться	навчати	навчатися	2
осталась	лишилася	лишалася	2
оценено	оцінене	оцінено	2
живёт	живе	живуть	2
разрешите	дозволите	дозвольте	2
шутки	жарти	жарту	2
музей	музей	музею	2
учу	навчаю	вивчаю	2
вора	злодія	крадія	2
краже	крадіжці	крадіжку	2
правду	правду	правди	2
поднимается	піднімається	здіймається	2
важный	важливий	важлива	2
бы	би	ти	2
ещё	що	ще	2
какое-то	якесь	якось	2
обвинение	звинувачення	обвинувачення	2
этот	цей	це	2
пирог	пиріг	пирога	2
напомнили	нагадали	нагадав	2
можем	можемо	зможемо	2
настроения	настрої	настрою	2
хорошем	хорошім	хорошому	2
диво	диво	дивина	2
внизу	внизу	унизу	2
французского	французького	французької	2
летних	літніх	літні	2
переводить	переводити	перекладати	2
прошлом	минулім	минуле	2
было	було	вуло	2
услышал	цюісторію	історію	2
совет	раду	пораду	2
рукой	рукою	руку	2
на	на	"на	2
оставайтесь	лишайтеся	залишайтеся	2
девочками	дівчатами	дівчата	2
книга	книга	книжка	2
кормил	годував	годувала	2
воздух	свіжий	свіже	2
знала	знала	знає	2
починил	години	годинник	2
мальчик	хлопчик	хлопець	2
маленькой	маленької	маленькою	2
адаптируется	адаптує	адаптується	2
что	що	щоб	2
проходите	проходите	проходьте	2
товарищ	товариш	товарише	2
пока	поки	коли	2
скорость	значуще	значно	2
советов	рад	порад	2
началась	почалася	почалося	2
новою	новою	нову	2
воздерживаться	утримуватися	утримуватись	2
кофе	кави	каву	2
наступала	наставала	наступала	2
почини	години	годинник	2
яблоко	яблуко	яблучко	2
слабо	слабо	слабко	2
отличием	відміною	відзнакою	2
закрыть	закрити	замкнути	2
продолжился	продовжився	продовжилася	2
девочка	дівча	дівчина	2
за	за	на	2
французский	рідний	рідна	2
начнем	почнемо	почнімо	2
человека	людини	людину	2
входите	входьте	заходьте	2
гуся	гусака	гуски	2
господа	пани	панове	2
посмотрите	подивитеся	дивіться	2
наличных	готівок	готівки	2
нравился	подобався	сподобався	2
немного	трохи	трошки	2
сколько	скількираз	скільки	2
могут	можуть	можут	2
открывай	відкривай	відчиняй	2
острый	гострий	гостра	2
экономическим	економічним	економічних	2
первому	першому	першим	2
количество	зір	зірок	2
часов	годин	години	2
вечером	вечором	вечора	2
белорусских	білоруських	білоруськів	2
будущее	майбутнішій	майбутнє	2
этому	цьому	цього	2
спрячешь	заховаєш	сховаєш	2
прошлым	минулим	минулого	2
итальянский	італійський	італійську	2
слушай	слухай	послухай	2
человеке	людині	людину	2
же	що	ще	2
радиоактивное	радіоактивне	радіоактивна	2
это	марне	марно	2
сделаем	зробимо	зробімо	2
просто	просто	простий	2
профессор	професор	професоре	2
загорелась	зайнялася	загорілася	2
чей	чий	чия	2
эту	зустріну	зустріч	2
единомышленники	однодумці	однодумцi	2
играем	граємося	граємо	2
этом	цім	цій	2
минуту	хвилі	хвилини	2
книгой	книгою	книжкою	2
начнется	почнеться	розпочнеться	2
примеры	приміри	приклади	2
вспоминать	пригадувати	згадувати	1
том	том	тім	1
сколько	скільки	окільки	1
цветы	цвіти	"квіти	1
посмотри	подивися	подивись	1
чужой	чужий	чужого	1
шеи	довгий	довгі	1
алгебре	алгебрі	"алгебрі	1
практике	практику	практиці	1
сами	сами	самі	1
голые	голі	гола	1
учёные	учені	вчені	1
секрет	мійсекрет	секрет	1
не	більше	більш	1
заходите	заходите	заходьте	1
разных	різнім	різних	1
темноте	темряві	темряви	1
дала	дала	надала	1
держит	тримає	тримав	1
маки	маки	макі	1
слова	потрібний	потрібні	1
надеемся	сподіваємося	сподіваємось	1
театр	театр	театру	1
расписанию	розпису	розкладу	1
вошла	увійшла	зайшла	1
минуте	хвилі	хвилині	1
недавно	недавно	нещодавно	1
нужна	потрібна	потрібен	1
вам	вам	вас	1
любят	люблять	полюблять	1
книгу	книгу	книжку	1
почему	це	не	1
закончился	закінчився	зкінчивсь	1
внимания	уваги	увагу	1
весь	весь	день	1
покойной	покійної	покійну	1
честная	чесна	чесний	1
тратой	витратою	тратою	1
опоздание	запізнення	спізнення	1
эта	ця	цю	1
голодны	голодні	голодний	1
подруги	дочки	доньки	1
я	я	як	1
больше	більше	більш	1
собираетесь	збираєтеся	збираєтесь	1
делается	робить	робиться	1
датский	данський	датський	1
тянутся	точаться	тягнуться	1
подарков	дарунків	подарунків	1
тот	той	тому	1
ходите	ходіть	ходите	1
плачем	плачем	плачемо	1
знают	всі	усі	1
воде	порі	воді	1
.	сестри	сестер	1
простой	простій	простим	1
ничего	лишається	залишається	1
автомобиля	свогоавтомобіля	автомобіля	1
минский	мінський	міський	1
статей	цікавий	цікавих	1
прибытия	йогоприбуття	прибуття	1
упал	впав	упав	1
казахский	казахський	казахська	1
хотят	хочуть	почути	1
задача	цязадача	задача	1
свиней	свиней	свинях	1
японии	японії	японію	1
бы	би	якби	1
мне	подобається	подобатися	1
услугу	послузі	послугу	1
лист	листя	лист	1
ощущал	відчував	почував	1
пор	його	того	1
рассказывал	розказував	розповідав	1
результате	результаті	результат	1
среда	середа	"середа	1
прогулок	тривалий	тривалих	1
безопасности	безпеки	безпеці	1
месте	місці	місті	1
сильно	сильне	сильно	1
биологию	біологію	біології	1
французского	французького	французьку	1
расскажите	розказажіть	розкажіть	1
комитет	мінський	міський	1
рядом	поруч	поряд	1
касается	торкається	стосується	1
самый	самий	самим	1
пожарное	пожежне	пожежного	1
зимой	зимою	узимку	1
немного	трохи	трошики	1
девушек	дівчат	дівчин	1
нравится	подобається	подобаться	1
в	у	"у	1
ценное	цінне	цінний	1
французском	французькім	французькою	1
внимательны	уважні	уважними	1
благодаря	дякуючи	дякую	1
удовлетворить	задовольнити	задовільнити	1
когда	коли	ніколь	1
отец	тато	ватько	1
понятно	зрозуміло	розуміло	1
твоя	потрібна	потрібні	1
уважают	всі	усі	1
день	кавами	кави	1
ночном	нічнім	нічному	1
перелезали	цідерева	дерева	1
ядерного	ядерного	ядерної	1
откуда	звідки	звідкіля	1
одиннадцать	одинадцятьох	одинадцять	1
следов	їхній	їхніх	1
прошлом	минулім	минулого	1
не	не	де	1
чувствуешь	відчуваєш	почуваєш	1
номерами	номерами	номером	1
под	би	боги	1
заплатит	сплатить	заплатить	1
качество	якість	якості	1
обвинения	цізвинувачення	звинувачення	1
можно	ріці	річці	1
когда	коли	коли"	1
тьма	тьма	пітьма	1
она	вона	"вона	1
телефону	телефону	телефоном	1
видел	бачив	побачив	1
гомоморфизм	гомоморфізм	гомоморфізм"	1
миновать	минати	минути	1
болото	уха	вуха	1
прекрасна	прекрасна	прекрасне	1
.	нових	нові	1
сигарет	сигарет	цигарок	1
слез	сліз	зліз	1
добро	добро	"добре	1
собрались	зібралися	позбиралися	1
деньги	гроші	грошей	1
этот	такий	самий	1
наступайте	настайте	наступайте	1
теорию	цютеорію	теорію	1
дуба	дубу	дуба	1
на	на	наша	1
не	це	не	1
телефонную	телефонну	телефону	1
многим	багатьма	багатьом	1
чувствовала	відчувала	почувалася	1
держите	тримаєте	тримайте	1
нужен	потрібний	потрібним	1
поезде	поїзді	поїхав	1
любят	люблять	любить	1
половина	половина	половину	1
чего	чого	того	1
страна	країна	красива	1
приглашена	запрошена	запросили	1
дочь	дівча	дівчинку	1
оставалось	лишалося	залишалося	1
показываем	показуємо	показують	1
были	були	було	1
денег	грошей	гроші	1
свои	своївідповіді	відповіді	1
кому	кому	кого	1
столом	стілом	столом	1
закончится	закінчиться	скінчиться	1
замка	замка	замка́	1
врагу	ворогу	ворогові	1
многому	багатьом	багато	1
лишь	лише	лишень	1
.	є	є"	1
приготовил	налаштував	приготував	1
был	був	буде	1
добрый	добрий	добридень	1
никто	ніхто	нікого	1
временное	тимчасове	тимчасова	1
.	вага	вазі	1
перейдём	перейдімо	перейдемо	1
высказываний	висловлень	висловлювань	1
бостон	бостон	бостона	1
океану	океану	океаном	1
уха	уха	вуха	1
рекомендуете	рекомендуватимете	рекомендуєте	1
часов	годин	годинників	1
переведут	переведуть	перекладуть	1
французском	французькім	французькій	1
сыну	сину	синові	1
английский	англійський	англійскій	1
на	на	та	1
месяца	місяця	місяці	1
глухой	глухої	глухий	1
один	один	наодинці	1
дочь	дочка	донька	1
рыбки	рибки	рибини	1
врет	бреше	більше	1
а	а	"а	1
неизвестное	невідомий	невідоме	1
холодное	холодне	холодна	1
выбери	вибери	обери	1
горячие	гарячі	гаряче	1
зрелище	видовище	видовисько	1
но	але	"але	1
выбрать	вибрати	обрати	1
кофе	кави	каві	1
бесплатная	безплатна	безкоштовна	1
комната	цякімната	кімната	1
продаётся	продає	продається	1
дочерью	дочкою	донькою	1
встречаемся	зустрічаємося	зустрінемося	1
прибудут	прибудуть	прийдуть	1
отказываюсь	відмовляюся	відмовляюсь	1
холоднее	холоднішийий	холодніше	1
счетом	ліком	лічбою	1
разрешить	дозволити	розв'язати	1
уже	майбутнішій	майбутнє	1
убийство	убивство	вбивство	1
сном	соном	сном"	1
занятой	зайнятої	зайнятий	1
кладбища	цвинтарі	цвинтаря	1
поцелуй	поцілунок	поцілуй	1
иностранным	іноземним	іноземних	1
грозил	погрожував	загрожував	1
поздравляю	здоровлю	поздоровляю	1
прекратите	припините	припиніть	1
идиот	ідіот	ідіоте	1
заплатят	сплатять	заплатять	1
она	вона	вечора	1
развернем	розгорнемо	розвернемо	1
ищу	шукаю	"шукаю	1
а	що	ще	1
неправильного	неправильного	неправильне	1
выучить	вивчити	вчити	1
французским	французьким	французькою	1
подадут	подадуть	подаватимуть	1
:	дочки	доньки	1
эмоции	емоції	емоцій	1
сесть	сісти	всістися	1
сильнее	сильнішийий	сильніше	1
как	як	якщо	1
она	вона	воно	1
в	граюся	граю	1
могу	можу	можна	1
улиток	петриків	равликів	1
десяти	десяти	десятої	1
невозможно	неможливо	"неможливо	1
французской	французької	французьку	1
мостик	місток	мостик	1
сложнее	складнішийий	складніше	1
скажем	скажемо	скажім	1
спасибо	спасибі	опасибі	1
людских	сліз	сльоз	1
венгерский	угорський	угорська	1
что	що	бо	1
бы	би	чи	1
эксперимента	експерименту	експеримента	1
русской	руської	російської	1
чёрта	риса	біса	1
написано	написане	написано	1
когда	коли	вони	1
такими	такими	великими	1
победа	цяперемога	перемога	1
сегодня	сьогодні	оьогодні	1
,	,	,"	1
бы	би	ви	1
ожидают	очікують	чекають	1
останься	лишись	залишися	1
страшно	страшно	страшенно	1
идти	йти	піти	1
двадцатого	двадцятоговіки	двадцятого	1
идет	йде	іде	1
землетрясения	землетрусу	землетруси	1
перевёл	перевів	переклав	1
сворачивает	звертає	завертає	1
посмотрю	подивлюся	подивлюсь	1
ничего	нічого	ничого	1
смейтесь	сміяйтеся	смійтеся	1
приглашён	запрошений	запросили	1
он	він	від	1
продолжала	продовжувала	продовжила	1
чувствуете	відчуваєте	почуваєте	1
фермеры	фермери	феремери	1
отцом	татом	батьком	1
нам	нам	на	1
может	мене	може	1
выбирая	вибираючи	обираючи	1
сорок	сорок	скоро	1
третий	третійтип	третій	1
бесплатно	безплатно	безкоштовно	1
посещение	відвідання	відвідування	1
то	то	бо	1
при	прі	при	1
twitter	twitter	twitter'i"	1
сообщите	повідомите	повідомте	1
деньгам	грошям	грошам	1
голоден	голодний	зголоднів	1
знают	знають	знатимуть	1
вмешиваться	втручатися	втручатись	1
языка	французький	французької	1
летом	літом	літа	1
учителя	учителя	вчителя	1
почувствовал	почув	відчув	1
сестра	моясестра	сестра	1
большой	великої	велика	1
плохое	погане	поганий	1
большое	велике	величезне	1
высокое	високе	високу	1
зарезервированы	цімісця	місця	1
нам	нам	нашим	1
цветов	цвітів	квітів	1
виктор	віктор	вікторе	1
общий	спільний	спільна	1
галстуку	краватці	краватки	1
подарок	йогодарунок	подарунок	1
приятен	приємний	приємним	1
улиц	львівський	львівських	1
приготовим	налаштуємо	приготуємо	1
довольно	досить	достатньо	1
не	не	те	1
месяце	місяці	місяця	1
всю	всю	все	1
курс	курсу	курс	1
деньгами	грішми	грошами	1
равно	рівно	дорівнює	1
поддержать	підтримати	підтримувати	1
переведу	переведу	перекладу	1
чтобы	хороший	хороші	1
двадцать	двадцятьох	двадцять	1
зло	зло	злеє	1
называют	білоруський	білоруські	1
простой	простій	простий	1
корабль	сировина	сировину	1
не	не	неба	1
датским	данським	датською	1
телефона	телефону	телефонним	1
на	на	наш	1
думаете	думаєте	гадаєте	1
днём	жити	миті	1
умный	розумний	розумним	1
это	це	"це	1
признал	визнав	зізнався	1
сила	сила	"сила	1
вести	поводитися	поводити	1
том	човна	чьлна	1
нож	ніж	ножа	1
бы	би	аби	1
похоронен	похований	поховано	1
уши	великий	великі	1
сравните	порівняєте	порівняйте	1
его	отримати	одержати	1
родится	народиться	родиться	1
меньше	менше	менша	1
то	то	що	1
уступить	вступити	поступитися	1
мозга	мозку	мозок	1
эти	ці	ці"	1
темноты	темряви	темрявою	1
отказываться	відмовлятися	відмовлятись	1
разговариваешь	розмовляєш	розмовляеш	1
шага	кроку	крока	1
студию	студію	студії	1
интересуешься	цікавиш	цікавишся	1
полицейский	поліцай	поліцейський	1
он	упевнений	впевнений	1
песня	їїпісня	пісня	1
зовут	звуть	звати"	1
встрече	зустрічі	зустріч	1
входе	прі	при	1
где	головний	головні	1
первое	перше	перший	1
дом	стане	стає	1
позвоните	зателефонуєте	зателефонуйте	1
равны	всі	усі	1
стеклянных	жити	живуть	1
учителя	учителі	вчителі	1
было	було	були	1
умерли	померли	вмерли	1
сегодня	сьогодні	сьогоднi	1
заново	заново	знову	1
кто-то	хтось	"хтось	1
пока	поки	вони	1
поезда	поїзда	поїзди	1
раза	разу	рази	1
однако	ж	же	1
его	його	нього	1
границу	кордон	закордон	1
образованы	утворені	освічені	1
сеть	сіть	сітка	1
светлого	світлого	світлої	1
сильному	сильному	сильного	1
одного	одного	одної	1
птицы	птаха	птахи	1
он	живе	живє	1
зимой	зимою	взимку	1
счастлив	щасливий	нещасливий	1
не	не	мене	1
оно	воно	вона	1
страус	струсь	страус	1
ты	ти	би	1
переведите	переведіть	перекладіть	1
святой	святої	святий	1
приятелю	приятелю	приятелеві	1
заплатить	сплатити	заплатити	1
чародеи	різного	різних	1
японского	японського	японської	1
я	початку	спочатку	1
кофе	міцний	міцну	1
как	як	якби	1
почте	пошті	пошти	1
хватает	вистачає	вистачало	1
продолжить	продовжити	продовжувати	1
прячусь	ховаю	ховаюсь	1
усилий	їїзусиль	зусиль	1
сказала	сказала	наказала	1
спит	спить	хропить	1
?	ціпереваги	переваги	1
будок	буд	будок	1
ответ	відповідь	відповіді	1
входи	входь	заходь	1
