una	una	un	11
una	una	un	11
un	un	una	7
—dice	—diu	-diu	5
descubrir	descobrir	descubrir	5
siempre	sempre	siempre	4
estudio	estudi	estudio	4
bolsa	borsa	bossa	4
día	dia	día	4
vuelvas	tornis	tornaràs	3
este	est	aquest	3
encendida	encesa	encès	3
sea	sigui	"sigui	3
sea	sigui	"sigui	3
sea	sigui	"sigui	3
paró	parar	aturar	3
aquí	aquí	aqui	3
error	error	errada	3
lista	llista	llest	3
virtudes	virtuts	virtuds	3
el	el	els	3
araña	aranya	aranys	3
duermas	dormis	durmis	3
en	en	el	3
telaraña	teranyina	telaranya	3
un	una	un	3
en	en	un	3
dos	dos	dies	3
comprobado	comprovat	comprobat	2
estupidez	estupidesa	estupidesa"	2
papá	papà	papá	2
pienso	pinso	penso	2
morales	morals	morales	2
empezado	començat	començar	2
partieron	partir	marxar	2
prefiero	prefereixo	preferisc	2
policía	policia	policía	2
increíble	increïble	increíble	2
jersey	jersei	jersey	2
el	el	ell	2
buscar	buscar	cercar	2
primera	primera	primer	2
no	no	ho	2
valentín	valentín	valentí	2
está	està	esta	2
llamaré	cridaré	trucaré	2
cenamos	sopem	sopar	2
cenamos	sopem	sopar	2
jugar	jugar	jogar	2
repasar	repassar	repasar	2
considerada	considerada	considera	2
porque	perquè	perque	2
llueva	plogui	ploga	2
tenis	tennis	tenis	2
hobby	hobby	hobbi	2
actúa	actua	actúa	2
visité	visitar	visitat	2
camiseta	samarreta	camiseta	2
trabajo	treball	traballo	1
serbios	serbis	serbs	1
crie	criï	criar	1
plan	pla	plan	1
conocí	conèixer	conéixer	1
té	te	tè	1
portugal	portugal	"portugal	1
mojar	mullar	mollar	1
solos	solos	sols	1
será	serà	sirà	1
si	si	sí	1
permite	permet	permeten	1
permite	permet	permeten	1
que	que	què	1
que	que	què	1
unas	unes	uns	1
unas	unes	uns	1
calor	calor	calorós	1
partiéramos	partíssim	marxéssim	1
septiembre	setembre	septembre	1
atrapé	atrapar	agafar	1
nací	néixer	nèixer	1
dieron	van	varen	1
la	la	lt	1
helen	helen	hellen	1
venden	venen	vénen	1
cepilla	raspalla	raspatlla	1
surgido	sorgit	surgit	1
fotografía	fotografia	fotografía	1
tratando	tractant	tractes	1
enfadada	enfadada	empipada	1
danza	dansa	dança	1
sino	sinó	sinò	1
siempre	sempre	"sempre	1
leas	llegeixis	llegeixes	1
si	si	sinó	1
tenista	tennista	tenista	1
gratis	gratis	gratuïta	1
espera	espera	esperra	1
número	nombre	número	1
algunas	algunes	"algunes	1
algunas	algunes	"algunes	1
fantasía	fantasia	fantasía	1
llamar	cridar	trucar	1
verdes	verdes	verds	1
centrales	centrals	"centrals	1
centrales	centrals	"centrals	1
leído	llegit	llegir	1
estudies	estudiïs	estudiis	1
esta	aquesta	aquest	1
esta	aquesta	aquest	1
