,	*dover	,	5
hiroshi	*hiroshi	hiroshi	4
parks	*parks	parks	3
gofres	*gofres	gofres	3
minesota	*minesota	minesota	3
mesero	*mesero	cambrer	3
taro	*taro	taro	3
me	*sermonee	sermonegi	3
parecían	*ochos	vuits	3
mustafá	*mustafá	mustafà	2
chao	*chao	adéu	2
,	*dover	de	2
kemal	*kemal	kemal	2
blanc	*blanc	blanc	2
sr	*sr	sr	2
zürich	*zürich	zuric	2
y	*uigur	uiguir	2
sato	*sato	sato	2
potra	*potra	sort	2
ikeda	*ikeda	ikeda	2
ganzúa	*ganzúa	espanyaportes	2
palmó	*palmó	morir	2
serruchando	*serruchando	serrant	2
sayoko	*sayoko	sayoko	2
keller	*keller	keller	1
mayuko	*mayuko	mayuko	1
okonatta	*okonatta	lt	1
empleó	*empleó	emprar	1
janet	*janet	qui	1
janet	*janet	ser	1
.	*taninna	.	1
darby	*darby	darby	1
serruchando	*serruchando	veure	1
janet	*janet	janet	1
,	*dover	anglaterra	1
mantilla	*mantilla	mantellina	1
serruchando	*serruchando	un	1
miyuki	*miyuki	miyuki	1
inviertiendo	*inviertiendo	invertint	1
edison	*edison	edisor	1
sato	*sato	en	1
robinson	*robinson	robinsor	1
darby	*darby	el	1
robinson	*robinson	robinson	1
seiko	*seiko	seiko	1
carter	*carter	carter	1
sally	*sally	sally	1
