una	una	un	11
es	és	es	9
un	un	una	7
a	a	la	6
papá	papà	pare	5
ese	aquest	aquell	5
sepa	ho	no	5
—dice	—diu	-diu	5
descubrir	descobrir	descubrir	5
hay	hi	ha	4
la	a	la	4
—esto	—això	-això	4
.	deliciós	deliciosa	4
siempre	sempre	siempre	4
estudio	estudi	estudio	4
bolsa	borsa	bossa	4
supieron	van	varen	4
día	dia	día	4
buen	bon	bona	4
llegaron	van	varen	4
tarta	vostre	vostra	4
desde	des	de	4
quiere	dividim	dividem	4
deberían	deurien	"haurien	3
vuelvas	tornis	tornaràs	3
este	est	aquest	3
encendida	encesa	encès	3
sea	sigui	"sigui	3
paró	parar	aturar	3
dijo	va	vaig	3
la	la	va	3
aquí	aquí	aqui	3
error	error	errada	3
interpretaron	van	varen	3
lista	llista	llest	3
.	borsa	bossa	3
trabajo	meu	meva	3
virtudes	virtuts	virtuds	3
el	el	els	3
araña	aranya	aranys	3
duermas	dormis	durmis	3
tu	a	la	3
en	en	el	3
decidieron	van	varen	3
estar	estar	d'estar	3
telaraña	teranyina	telaranya	3
eso	això	allò	3
un	una	un	3
?	escriguem	escrivim	3
en	en	un	3
deberías	deuries	hauries	3
dos	dos	dies	3
comprobado	comprovat	comprobat	2
sus	els	el	2
estampillas	col·leccionar	coleccionar	2
estupidez	estupidesa	estupidesa"	2
sudáfrica	sud-àfrica	sudàfrica	2
pan	ha	pa	2
miedo	por	poc	2
chica	noia	nena	2
papá	papà	papá	2
;	límits	límit	2
,	boníssima	boníssim	2
desde	des	desde	2
éstos	aquests	aquestes	2
leer	llegir	llegiré	2
pienso	pinso	penso	2
morales	morals	morales	2
es	dreta	dretra	2
empezado	començat	començar	2
partieron	partir	marxar	2
prefiero	prefereixo	preferisc	2
.	tallat	tallades	2
policía	policia	policía	2
increíble	increïble	increíble	2
diez	deu	déu	2
jersey	jersei	jersey	2
el	el	ell	2
dover	de	des	2
payaso	pallasso	paiaso	2
sufrieron	van	varen	2
buscar	buscar	cercar	2
primera	primera	primer	2
no	no	ho	2
valentín	valentín	valentí	2
está	està	esta	2
llamaré	cridaré	trucaré	2
límites	seus	seu	2
cenamos	sopem	sopar	2
jugar	jugar	jogar	2
en	al	el	2
chismosa	xafardera	tafanera	2
repasar	repassar	repasar	2
elegidos	ser	èsser	2
considerada	considerada	considera	2
partieron	van	varen	2
sola	sola	tota	2
porque	perquè	perque	2
llueva	plogui	ploga	2
tenis	tennis	tenis	2
hobby	hobby	hobbi	2
actúa	actua	actúa	2
visité	visitar	visitat	2
camiseta	samarreta	camiseta	2
ahora	tòquio	tòkio	2
volvería	tornaria	tornaría	1
trabajo	treball	traballo	1
serbios	serbis	serbs	1
musulmanes	croats	croates	1
crie	criï	criar	1
plan	pla	plan	1
rojas	vermelles	"vermelles	1
conocí	conèixer	conéixer	1
té	te	tè	1
fuerte	fort	forta	1
que	el	es	1
haré	faré	fare	1
y	i	"i	1
marchitan	marceixen	panseixen	1
usted	vostè	vosté	1
portugal	portugal	"portugal	1
mojar	mullar	mollar	1
cosas	coses	moltes	1
solos	solos	sols	1
será	serà	sirà	1
si	si	sí	1
permite	permet	permeten	1
que	que	què	1
pizca	un	una	1
,	ha	hi	1
unas	unes	uns	1
calor	calor	calorós	1
otras	altres	d'altres"	1
partiéramos	partíssim	marxéssim	1
septiembre	setembre	septembre	1
deberes	els	seus	1
esa	aquesta	aquella	1
hay	hi	n'hi	1
atrapé	atrapar	agafar	1
nací	néixer	nèixer	1
es	tarda	tard	1
hombres	són	son	1
dieron	van	varen	1
de	la	la"	1
perro	ha	hi	1
conversación	conversa	conversació	1
fue	va	la	1
la	la	lt	1
le	li	la	1
helen	helen	hellen	1
venden	venen	vénen	1
de	de	he	1
robaron	van	varen	1
la	a	a"	1
ojalá	tant	tan	1
a	a	"a	1
más	més	és	1
están	estan	estàn	1
cepilla	raspalla	raspatlla	1
fueses	anessis	fossis	1
entre	traïdor	traidor	1
surgido	sorgit	surgit	1
cuanto	quant	quan	1
fotografía	fotografia	fotografía	1
tratando	tractant	tractes	1
dijo	va	la	1
puerta	porta	part	1
volver	van	varen	1
enfadada	enfadada	empipada	1
concepto	déu	deu	1
media	quarts	quatre	1
comes	menges	menjes	1
danza	dansa	dança	1
mis	els	meus	1
a	a	fa	1
es	és	més	1
alianza	frança	aliança	1
a	véns	vens	1
sino	sinó	sinò	1
ella	ella	esta	1
su	ser	per	1
que	que	qu	1
nucleares	nuclears	"nuclears	1
a	a	va	1
que	que	aquest	1
siempre	sempre	"sempre	1
ha	ha	la	1
algunas	són	"són	1
conmigo	paraigua	paraigües	1
leas	llegeixis	llegeixes	1
quería	volia	volía	1
si	si	sinó	1
fueran	els	meus	1
a	tornar	tornés	1
era	era	meva	1
tenista	tennista	tenista	1
gratis	gratis	gratuïta	1
tardaron	van	varen	1
soltera	seva	seua	1
espera	espera	esperra	1
número	nombre	número	1
algunas	algunes	"algunes	1
fantasía	fantasia	fantasía	1
vinieron	van	varen	1
vimos	vam	varem	1
querer	voler	volver	1
peor	és	es	1
.	infància	infantesa	1
llamar	cridar	trucar	1
toques	tocs	toquis	1
me	em	en	1
haga	faci	faça	1
verdes	verdes	verds	1
centrales	centrals	"centrals	1
leído	llegit	llegir	1
es	es	és	1
estudies	estudiïs	estudiis	1
esta	aquesta	aquest	1
