люблю	*люблю	люблю	14
люся	*люся	люся	12
клава	*клава	клава	10
твой	*твой	твой	7
твой	*твой	твой	7
су	*су	су	6
яані	*яані	яани	6
цао	*цао	цао	6
педафілы	*педафілы	педофилы	5
нюнорска	*нюнорска	нюнорска	5
ўмееш	*ўмееш	умеешь	5
бэці	*бэці	бетти	5
спаць	*спаць	спать	4
люсі	*люсі	люси	4
роджэр	*роджэр	роджер	4
пісаць	*пісаць	писать	4
бегаць	*бегаць	бегать	3
задаваць	*задаваць	задавать	3
абама	*абама	обама	3
чытаць	*чытаць	читать	3
вольныя	*вольныя	свободные	3
цзыю	*цзыю	цзыю	3
плаваць	*плаваць	плавать	3
смяяліся	*смяяліся	смеялись	3
клясе	*клясе	классе	3
пагаварыць	*пагаварыць	поговорить	3
рон	*рон	рон	3
звуць	*звуць	зовут	3
бэна	*бэна	бена	3
дарэнда	*дарэнда	доренда	3
кенам	*кенам	кен	3
дакранулася	*дакранулася	дотронулось	3
выйгралі	*выйгралі	выиграли	3
свеціць	*свеціць	светит	3
маркс	*маркс	маркс	2
нла	*нла	нло	2
чытаеш	*чытаеш	читаешь	2
люсе	*люсе	люсе	2
іграць	*іграць	играть	2
называецца	*называецца	называется	2
прэзыдэнт	*прэзыдэнт	президент	2
ціма	*ціма	тима	2
дантэ	*дантэ	данте	2
кнопки	*кнопки	кнопки	2
дурыце	*дурыце	дурите	2
джэка	*джэка	джеком	2
заклей	*заклей	заклей	2
львове	*львове	львове	2
праносіць	*праносіць	проносить	2
іншапланецяне	*іншапланецяне	инопланетяне	2
злезлі	*злезлі	слезли	2
галандскай	*галандскай	голландского	2
срэбны	*срэбны	серебряную	2
шарля	*шарля	шарля	2
перо	*перо	перро	2
фарамп	*фарамп	фарамп	2
засыхалі	*засыхалі	засыхали	2
гма	*гма	гмо	2
вольны	*вольны	свободное	2
слухаць	*слухаць	слушать	2
разбіраецца	*разбіраецца	разбирается	2
туман	*туман	туман	2
туман	*туман	туман	2
туман	*туман	туман	2
туман	*туман	туман	2
думаеш	*думаеш	думаешь	2
рок	*рок	рок	2
рок	*рок	рок	2
лазанью	*лазанью	лазанью	2
адрэсу	*адрэсу	адрес	2
супадае	*супадае	совпадает	2
дакраніся	*дакраніся	дотронься	2
мандарыны	*мандарыны	мандарины	2
юэбін	*юэбін	юэбин	2
выразаў	*выразаў	вырезал	2
казахскай	*казахскай	казахском	2
найяскравейшая	*найяскравейшая	наиярчайшая	2
сакрэт	*сакрэт	секрет	2
сказаць	*сказаць	сказать	2
акторам	*акторам	актером	2
ісландскім	*ісландскім	исландским	2
шы	*шы	ши	2
майк	*майк	майк	2
дзверы	*дзверы	дверь	2
пераскаквае	*пераскаквае	перепрыгивает	2
развешвае	*развешвае	развешивает	2
прытворымся	*прытворымся	притворимся	2
татоэбе	*татоэбе	татоэбе	2
бегае	*бегае	бегает	2
пярсідская	*пярсідская	персидский	2
ненавідзела	*ненавідзела	ненавидела	2
адшукаем	*адшукаем	разыщем	2
замяняем	*замяняем	заменяем	2
інапланецянамі	*інапланецянамі	инопланетянами	2
гаворыць	*гаворыць	говорит	2
мандалай	*мандалай	мандалай	2
каптурко	*каптурко	шапочко	2
памыць	*памыць	помыть	2
рэакцыю	*рэакцыю	реакцию	2
прамільгнула	*прамільгнула	промелькнуло	2
пракампасціруйце	*пракампасціруйце	прокомпостируйте	2
індустрыялізацыя	*індустрыялізацыя	индустриализация	2
пазнаёміліся	*пазнаёміліся	познакомились	2
збіраюся	*збіраюся	собираюсь	2
браян	*браян	брайан	2
салмана	*салмана	салмана	2
пройдзе	*пройдзе	пройдёт	2
наставай	*наставай	настиной	2
праспрагаць	*праспрагаць	проспрягать	2
праплывалі	*праплывалі	проплывали	2
джэк	*джэк	джек	2
характэрных	*характэрных	характерных	2
московиц	*москови*ц	московиц	2
іслам	*іслам	ислам	2
пацалаваў	*пацалаваў	поцеловал	2
рушдзі	*рушдзі	рушди	2
ідэальны	*ідэальны	идеальный	2
акно	*акно	окно	2
мюрыэл	*мюрыэл	мюриэл	2
радактараў	*радактараў	редакторов	2
товада	*товада	товада	2
дасцін	*дасцін	дастин	2
лётае	*лётае	летает	2
фнорд	*фнорд	фнорд	2
годы	*годы	годах	2
нептуна	*нептуна	нептуна	2
прагноза	*прагноза	прогноза	2
аконца	*аконца	оконце	2
тэрэза	*тэрэза	тереза	2
асноўваецца	*асноўваецца	основывается	2
чытаў	*чытаў	читал	2
гаварыць	*гаварыць	говорить	2
расказаць	*расказаць	рассказать	2
загарэлася	*загарэлася	загорелась	2
пятнаццаць	*пятнаццаць	пятнадцать	1
напаўняла	*напаўняла	наполняло	1
сато	*сато	сато	1
іскрыць	*іскрыць	искрит	1
пытарен	*пытарен	выплакала	1
чалавеканенавісных	*чалавеканенавісных	человеконенавистнических	1
мухамад	*мухамад	мухаммед	1
парламентская	*парламентская	парламентская	1
пачытаць	*пачытаць	почитать	1
гатаваць	*гатаваць	готовить	1
дадаваць	*дадаваць	добавлять	1
серыйная	*серыйная	серийная	1
дырку	*дырку	дырку	1
водзіць	*водзіць	водит	1
перазваню	*перазваню	перезвоню	1
разлічваць	*разлічваць	рассчитывать	1
опцыя	*опцыя	опция	1
вэбмайстры	*вэбмайстры	вебмастеры	1
падабаўляць	*падабаўляць	подобавлять	1
ізраіль	*ізраіль	израиль	1
праблемаў	*праблемаў	проблем	1
пашуковая	*пашуковая	поисковая	1
сайтам	*сайтам	сайтом	1
прыдумаць	*прыдумаць	придумать	1
актор	*актор	актер	1
есць	*есць	есть	1
інапланецяне	*інапланецяне	инопланетяне	1
каран	*каран	коран	1
кашгары	*кашгары	кашгаре	1
коткі	*коткі	кошки	1
імперыялізму	*імперыялізму	империализма	1
перасунь	*перасунь	передвинь	1
вольны	*вольны	свободен	1
выправіш	*выправіш	исправишь	1
правым	*правым	правым	1
правым	*правым	правым	1
правым	*правым	правым	1
правым	*правым	правым	1
правым	*правым	правым	1
хуйні	*хуйні	хуйни	1
выбраць	*выбраць	выбрать	1
забыўся	*забыўся	забыл	1
адрэеску	*адрэеску	андрееску	1
марыць	*марыць	маша	1
пазнаў	*пазнаў	познал	1
творыць	*творыць	творит	1
косы	*косы	косы	1
косы	*косы	косы	1
узбекскую	*узбекскую	узбекскую	1
весці	*весці	вести	1
заблукаеш	*заблукаеш	заблудишься	1
інфекцыя	*інфекцыя	инфекция	1
выкалі	*выкалі	выколи	1
выкалі	*выкалі	выколи	1
рамашку	*рамашку	ромашку	1
орэст	*орэст	орест	1
яндекс	*яндекс	яндекс	1
паслужыць	*паслужыць	послужит	1
збіраць	*збіраць	собирать	1
плаваюць	*плаваюць	плавают	1
выйграць	*выйграць	выиграть	1
карпаты	*карпаты	карпаты	1
імперыялісты	*імперыялісты	империалисты	1
львоўскіх	*львоўскіх	львовских	1
страляючы	*страляючы	стреляя	1
душэ	*душэ	душе	1
тайландзе	*тайландзе	таиланде	1
шэкспіра	*шэкспіра	шекспира	1
буды	*буды	будды	1
алан	*алан	алан	1
горкая	*горкая	горький	1
талончык	*талончык	талончик	1
чаю	*чаю	чаю	1
чаю	*чаю	чаю	1
лонадана	*лонадана	лондона	1
суматра	*суматра	суматра	1
думаюць	*думаюць	думают	1
сайт	*сайт	сайт	1
сайт	*сайт	сайт	1
фаната	*фаната	фаната	1
паясніў	*паясніў	объяснил	1
пераносілі	*пераносілі	переносили	1
брусэль	*брусэль	брюссель	1
іначай	*іначай	иначе	1
чытаю	*чытаю	читаю	1
сандра	*сандра	сандра	1
прасты	*прасты	простой	1
цвятаева	*цвятаева	цветаева	1
ізалентай	*ізалентай	изолентой	1
раксалана	*раксалана	роксолана	1
алаха	*алаха	аллаха	1
львоўскай	*львоўскай	львовской	1
паспаць	*паспаць	поспать	1
есць	*есць	ест	1
парагвай	*парагвай	парагвай	1
зефір	*зефір	зефир	1
фэйсбуцы	*фэйсбуцы	фейсбуке	1
падараваў	*падараваў	подарил	1
паслухаць	*паслухаць	послушать	1
інтэрфейсу	*інтэрфейсу	интерфейса	1
цалаваў	*цалаваў	целовал	1
праэкт	*праэкт	проект	1
іра	*іра	ира	1
тучы	*тучы	тучи	1
патрык	*патрык	патрик	1
дзверы	*дзверы	двери	1
ўсталяваў	*ўсталяваў	установил	1
что	*что	что	1
прагаласаваў	*прагаласаваў	проголосовал	1
задумваюся	*задумваюся	задумываюсь	1
зарадзілася	*зарадзілася	зародилась	1
пераходзь	*пераходзь	переходи	1
хуана	*хуана	хуана	1
бардэлі	*бардэлі	борделе	1
некурцоў	*некурцоў	некурящих	1
неправы	*неправы	неправ	1
прысніся	*прысніся	приснись	1
забывай	*забывай	забывай	1
прыносяць	*прыносяць	приносят	1
пазнаёміць	*пазнаёміць	познакомить	1
карлас	*карлас	карлос	1
зсср	*зсср	ссср	1
праяўляліся	*праяўляліся	проявлялись	1
сэзон	*сэзон	сезон	1
заплятала	*заплятала	заплетала	1
эстонскай	*эстонскай	эстонском	1
прадбачыць	*прадбачыць	предсказать	1
маша	*маша	маша	1
сымпатычных	*сымпатычных	симпатичных	1
пробуй	*пробуй	пробуй	1
колю	*колю	колю	1
борам	*борам	бором	1
цёмныя	*цёмныя	тёмные	1
запрашаем	*запрашаем	приглашаем	1
любляць	*любляць	любят	1
маскаль	*маскаль	москаль	1
адпраўляецца	*адпраўляецца	отправляется	1
тэхас	*тэхас	техас	1
рамсэс	*рамсэс	рамсес	1
заматай	*заматай	замотай	1
губка	*губка	губка	1
замёрзнеш	*замёрзнеш	замёрзнешь	1
інтэрнэце	*інтэрнэце	интернете	1
татоэба	*татоэба	татоэба	1
выставу	*выставу	выставку	1
збалансованага	*збалансованага	сбалансированного	1
штаны	*штаны	штаны	1
амфітрыты	*амфітрыты	амфитриты	1
саэб	*саэб	саэб	1
вянуць	*вянуць	вянут	1
гольф	*гольф	гольф	1
гольф	*гольф	гольф	1
прайшоў	*прайшоў	прошла	1
мёртвы	*мёртвы	мёртвая	1
прыводзіць	*прыводзіць	приводит	1
пачынаецца	*пачынаецца	начинается	1
зарабляў	*зарабляў	зарабатывал	1
згодны	*згодны	согласен	1
знае	*знае	знает	1
пераўсталёўваць	*пераўсталёўваць	переустанавливать	1
падыходзіць	*падыходзіць	подходит	1
булачку	*булачку	булочку	1
сам	*рабіў	сам	1
срэбнымі	*срэбнымі	серебряными	1
яўляліся	*яўляліся	появлялись	1
галандыя	*галандыя	голландия	1
мёртвы	*мёртвы	мёртв	1
выпісваюць	*выпісваюць	выписывают	1
твой	*твой	твоя	1
твой	*твой	твоя	1
іен	*іен	иен	1
страляйце	*страляйце	стреляйте	1
куй	*куй	куй	1
куй	*куй	куй	1
французкай	*французкай	французском	1
ўдвох	*ўдвох	вдвоём	1
бегай	*бегай	бегай	1
ліпнуць	*ліпнуць	липнут	1
сайту	*сайту	сайта	1
ўстанавілі	*ўстанавілі	установили	1
сайтаў	*сайтаў	сайтов	1
спорта	*спорта	спорта	1
развіваецца	*развіваецца	развивающемся	1
высланае	*высланае	выстлан	1
любое	*любое	любое	1
любое	*любое	любое	1
застаўляе	*застаўляе	заставляет	1
сайтаў	*сайтаў	сайтам	1
ну	*ну	ну	1
абралі	*абралі	выбрали	1
кузэн	*кузэн	кузен	1
безнадзейныя	*безнадзейныя	безнадёжны	1
шахматы	*шахматы	шахматы	1
нефертары	*нефертары	нефертари	1
азначалі	*азначалі	означали	1
арктыцы	*арктыцы	арктике	1
максымальным	*максымальным	максимальном	1
прыдумваў	*прыдумваў	придумывал	1
шы	*шы	цзыю	1
лукашэнка	*лукашэнка	лукашенко	1
навелы	*навелы	новеллы	1
цытаваць	*цытаваць	цитировать	1
бабруйск	*бабруйск	бобруйска	1
плавае	*плавае	плавает	1
