KEY
элегантная	элегантная	элегантна	
такая ж элегантная	такая ж элегантная	хуана же элегантна	
ж элегантная ,	ж элегантная ,	же элегантна ,	



KEY
матэматыку	математике	математики	
матэматыку сустракаюцца яшчэ	математике *сустракаюцца ещё	математики встречаются ещё	



KEY
замка́	замка́	замка	
гэтага замка́ .	этого замка́ .	этого замка .	



KEY
нашае	нашей	наша	
было б нашае	бывше бы нашей	была б наша	
б нашае жыццё	бы нашей жизнь	б наша жизнь	



KEY
прыйдзе	придёт	придет	
яна прыйдзе .	она придёт .	она придет .	



KEY
ветраных	ветреных	ветряных	
перазвон ветраных званочкаў	перезвон ветреных колокольчиков	перезвон ветряных колокольчиков	



KEY
песню	пёсню	песню	
заспяваем песню .	*заспяваем пёсню .	споём песню .	
заспяваем песню на	*заспяваем пёсню на	давайте песню на	
спявала песню на	пела пёсню на	пела песню на	
заспявай песню .	*заспявай пёсню .	спой песню .	



KEY
ўрокам	уроком	урокам	
яго ўрокам .	его уроком .	его урокам .	



KEY
вывучыць	изучить	выучить	
хачу вывучыць іўрыт	хочу изучить *іўрыт	хочу выучить иврит	
вывучыць іўрыт .	изучить *іўрыт .	выучить иврит .	



KEY
«	нету	нет	
слова « «	слово « нету	слова `` нет	



KEY
скончыць	закончить	завершить	
мушу скончыць гэту	*мушу закончить эту	должен завершить эту	



KEY
золата	золото	золота	
пошукі золата .	поиски золото .	поиски золота .	



KEY
чарапіцы	укладки	кладке	
гатовы да чарапіцы	крыша готовый укладки	крыша к кладке	



KEY
правёў	провёл	провел	
я правёў ,	я провёл ,	я провел ,	



KEY
на	на	но	
манеры , на	но всегда на	манеры , но	
на заўсёды год	на пятьдесят год	но всегда на	



KEY
таму	поэтому	потому	
таму что ,	поэтому *что ,	потому что ,	
яму таму ,	яму поэтому ,	доверяю потому ,	



KEY
шчаслівы	счастливый	счастлив	
алег шчаслівы ,	олег счастливый ,	олег счастлив ,	
ты шчаслівы ,	ты счастливый ,	ты счастлив ,	



KEY
кодам	кодом	кодами	
адкрытым крынічным кодам	открытым *крынічным кодом	открытыми исходными кодами	
крынічным кодам	*крынічным кодом	исходными кодами	



KEY
папала	попала	покупал	
якія папала кнігі	которые попала книги	он покупал какие	



KEY
нашу	нашу	нашей	
на нашу	на нашу	с нашей	
на нашу прапанова	на нашу мысль	с нашей точки	



KEY
песенным	песенным	песенном	
на песенным конкурсе	на песенным конкурсе	на песенном конкурсе	



KEY
невялікім	небольшим	небольшом	
ў невялікім мястэчку	в небольшим местечке	в небольшом городке	



KEY
гэтым	этим	этому	
па гэтым пытанні	по этим вопросе	по этому вопросу	
гэтым пытанні .	этим вопросе .	этому вопросу .	



KEY
зброі	оружии	оружия	
экспарт зброі быў	экспорт оружии был	экспорт оружия был	



KEY
будучыні	будущем	будущего	
мова будучыні !	язык будущем !	язык будущего !	



KEY
мір	всем	всём	
і за мір	мир в всем	мир во всём	
за мір ва	в всем мире	во всём мире	



KEY
думаю	думой	думаю	
думаю ,	думой ,	думаю ,	



KEY
футболе	футболе	футболу	
па футболе пройдзе	по футболе *пройдзе	по футболу пройдёт	
футболе пройдзе ў	футболе *пройдзе в	футболу пройдёт в	



KEY
станоўчае	положительной	положительное	
зразумець станоўчае і	понять положительной и	понять положительное и	



KEY
носе	носе	носу	
на носе !	на носе !	на носу !	



KEY
прызначаная	назначенная	предназначена	
не прызначаная для	не назначенная для	не предназначена для	



KEY
праблемы	проблемы	проблем	
паліць праз праблемы	*паліць через проблемы	курить из-за проблем	
праз праблемы з	через проблемы со	из-за проблем со	



KEY
рэжым	отражения	изображения	
выбраць рэжым рэжым	режим отражения изображения	режим изображения .	



KEY
гетэр	гетер	геттер	
вялікі аматар гетэр	большой любитель гетер	большой поклонник геттер	
аматар гетэр яані	любитель гетер *яані	поклонник геттер яани	
гетэр яані .	гетер *яані .	геттер яани .	
вялікая аматарка гетэр	большая любительница гетер	большая поклонница геттер	
аматарка гетэр яані	любительница гетер *яані	поклонница геттер яани	
гетэр яані .	гетер *яані .	геттер яани .	
з гетэр яані	с гетер *яані	с геттер яани	
гетэр яані .	гетер *яані .	геттер яани .	
гетэр яані	гетер *яані	геттер яани	
гетэр яані —	гетер *яані —	геттер яани —	



KEY
сэрца	сердце	сердцу	
да сэрца .	к сердце .	к сердцу .	



KEY
нядзелі	воскресенье	воскресеньям	
у нядзелі	в воскресенье	по воскресеньям	
у нядзелі магазін	в воскресенье магазин	по воскресеньям магазин	
у нядзелі	в воскресенье	по воскресеньям	
у нядзелі крама	в воскресенье магазин	по воскресеньям магазин	



KEY
тым	тем	чем	
тым больш спазнаеш	тем более *спазнаеш	чем больше читаешь	



KEY
вымаўленні	произношении	произношения	
абодва вымаўленні правільныя	оба произношении правильные	оба произношения правильные	



KEY
возера	озеро	озера	
ля возера мой	у озеро мой	у озера мой	
гэтага возера поўна	этого озеро полно	этого озера полно	
гэта возера не	это озеро не	этого озера полно	



KEY
працягнула	продолжила	продолжала	
яна працягнула працаваць	яна продолжила *працаваць	она продолжала работать	
працягнула працаваць .	продолжила *працаваць .	продолжала работать .	



KEY
побыту	быта	быту	
і побыту арабаў	и быта арабов	и быту арабов	



KEY
мэры	мэры	мэри	
том пацалаваў мэры	том *пацалаваў мэры	том поцеловал мэри	
пацалаваў мэры ў	*пацалаваў мэры в	поцеловал мэри в	
мэры пакінула	мэры оставила	мэри оставила	
мэры думала	мэры *думала	мэри думала	
мэры думала ,	мэры *думала ,	мэри думала ,	



KEY
акружаная	окружённая	окружена	
царква акружаная лясамі	церковь окружённая лесами	церковь окружена лесами	



KEY
свой	свой	своё	
ў свой вольны	в свой *вольны	в своё свободное	



KEY
нам	зам	нам	
нам запрошваць	зам *запрошваць	нам приглашать	
нам запрошваць дантэ	зам *запрошваць *дантэ	нам приглашать данте	
нам ледзьве	зам едва	нам едва	
нам не	зам не	нам не	
рыхтуе нам будучыня	*рыхтуе зам будущее	готовит нам будущее	
дайце нам нейкія	дайте зам некоторые	приведите нам примеров	
часта апавядаў нам	часто *апавядаў зам	часто рассказывал нам	
апавядаў нам пра	*апавядаў зам о	рассказывал нам о	
нам патрэбныя	зам *патрэбныя	нам люди	
не пайсці нам	не пойти зам	уйти ли нам	
пайсці нам адсюль	пойти зам отсюда	ли нам отсюда	



KEY
ўваходзіць	входить	входит	
літва ўваходзіць у	литва входить в	литва входит в	



KEY
японскай	японской	японского	
з японскай на	с японской на	с японского на	



KEY
лацінская	латинская	латинский	
лацінская —	латинская —	латинский —	



KEY
апетыту	аппетита	аппетиту	
яго жудаснага апетыту	его ужасного аппетита	его ужасному аппетиту	
жудаснага апетыту .	ужасного аппетита .	ужасному аппетиту .	



KEY
здаровым	здоровым	здоровом	
у здаровым целе	в здоровым теле	в здоровом теле	



KEY
«	советского	советский	
« пашпарт »	советского союза »	советский паспорт :	



KEY
поўная	полный	полна	
бутэлька поўная вады	бутылка полный изъяна	бутылка полна воды	



KEY
карычневы	коричневый	коричневое	
пошты карычневы .	почты коричневый .	почты коричневое .	



KEY
вялікім	большим	большом	
у вялікім доме	в большим доме	в большом доме	



KEY
прапанову	предложение	предложении	
пра яе прапанову	о неё предложение	о её предложении	
яе прапанову ?	неё предложение ?	её предложении ?	



KEY
часу	времени	времён	
беларускіх часу часу	панов времени наполеона	панов времён наполеона	



KEY
электрамеханіку	электромеханике	электромеханику	
ён вывучаў электрамеханіку	он *вывучаў электромеханике	он изучал электромеханику	
вывучаў электрамеханіку і	*вывучаў электромеханике и	изучал электромеханику и	



KEY
вуліц	паутины	паутине	
вуліц львоўскіх вуліц	паутины *львоўскіх улиц	паутине львовских улиц	



KEY
адкрытым	открытым	открытыми	
з адкрытым крынічным	с открытым *крынічным	с открытыми исходными	
адкрытым крынічным кодам	открытым *крынічным кодом	открытыми исходными кодами	



KEY
сем	ней	ей	
люстра абяцала сем	люстра *абяцала ней	разбитое обещало ей	



KEY
белы	белы	белый	
ты любіш белы	ты *любіш белы	ты любишь белый	



KEY
ўласную	собственную	собственном	
пра ўласную .	о собственную .	о собственном .	



KEY
рускія	русские	французские	
 рускія французкія	 русские *французкія	копируют французские манеры	



KEY
гады	старший	старше	
два гады гады	два гады старший	два года старше	



KEY
заплюшчыце	закроете	закройте	
заплюшчыце вочы	закроете глаза	закройте глаза	



KEY
сябе	себя	себе	
ў сябе ;	в себя ;	в себе ;	



KEY
лепшых	лучших	улучшенных	
стварэнне лепшых праграм	создание лучших программ	создание улучшенных приложений	



KEY
.	порнографию	порнографии	
дзіцячую парнаграфію .	о детскую порнографию	о детской порнографии	
парнаграфію .	детскую порнографию	детской порнографии	



KEY
гады	гады	годы	
гады расце людзей	гады растёт людей	годы растет людей	



KEY
каментарыям	комментариям	комментарии	
рады любым каментарыям	ряды зазнобой комментариям	 любые комментарии	



KEY
рускай	русской	русском	
на рускай .	на русской .	на русском .	



KEY
лісця	листа	листьев	
коўдрай лісця ,	одеялом листа ,	одеялом листьев ,	
коўдрай лісця ,	одеялом листа ,	одеялом листьев ,	



KEY
розныя	разные	различных	
абсалютна розныя меркаванні	абсолютно разные мнении	абсолютно различных мнения	
розныя меркаванні .	разные мнении .	различных мнения .	



KEY
не	не	но	
не маем нічога	не маем ничего	но у нет	
не многія :	не *ведаюць :	но многие сейчас	



KEY
манга	манго	манга	
гэтая манга	это манго	эта манга	
гэтая манга даволі	это манго довольно	эта манга довольно	



KEY
найлепшая	наилучшая	наилучший	
— найлепшая з	— наилучшая с	— наилучший язык	



KEY
ён	что	кто	
ён ён ,	что он *чжуанцзы	кто же он	



KEY
хвіліну	минуту	минутку	
хвіліну !	минуту !	минутку !	



KEY
ўсім	всем	всём	
і ва ўсім	и в всем	и во всём	
ва ўсім .	в всем .	во всём .	



KEY
прысеў	присев	присел	
ён прысеў пачытаць	он присев *пачытаць	он присел почитать	
прысеў пачытаць раман	присев *пачытаць роман	присел почитать роман	



KEY
трэба	много	многое	
трэба шмат зрабіць	много что *зрабіць	многое сделать »	



KEY
,	звезды	звёзды	
на , ,	на звезды ,	на звёзды ,	
на , ,	на звезды ,	на звёзды ,	
на , ,	на звезды ,	на звёзды ,	
на , ,	на звезды ,	на звёзды ,	



KEY
маю	маю	мою	
і ліжы маю	и *ліжы маю	и лижи мою	



KEY
купляў	покупок	покупал	
купляў якія папала	покупок которые попала	покупал какие попало	



KEY
прыхільнікаў	силки	силы	
і дэзарганізаваць прыхільнікаў	и *дэзарганізаваць силки	и дезорганизовать силы	



KEY
песні	пёсне	песне	
у песні на	в пёсне на	в песне на	



KEY
беларусі	тем	этим	
беларусі ганаруся .	тем *ганаруся .	этим горжусь .	



KEY
бульбу	картофель	картофеле	
пра бульбу .	о картофель .	о картофеле .	



KEY
праліў	пролив	пролил	
я праліў праліў	я пролив кофе	я пролил кофе	



KEY
краіна	страна	страны	
кожная краіна мае	каждая страна мои	каждой страны есть	



KEY
нашым	нашим	нашем	
у нашым доме	в нашим доме	в нашем доме	



KEY
сваёй	своим	своего	
рэйтынг сваёй .	рейтинг своим .	рейтинг своего .	



KEY
дзіця	ребёнок	ребёнка	
уратаваў дзіця з	спас ребёнок с	спас ребёнка из	
дзіця з агню	ребёнок с огня	ребёнка из огня	



KEY
мая	мая	моя	
мая каханая .	мая любимая .	моя зазноба .	
мая кніга ?	мая книга ?	моя книжка ?	
мая цётка радавалася	мая тётка радовалась	моя тётя радовалась	



KEY
дамашняе	домашнего	домашнее	
рабі сваё дамашняе	*рабі своё домашнего	делай свое домашнее	
сваё дамашняе заданне	своё домашнего задание	свое домашнее задание	
рабіў дамашняе заданне	*рабіў домашнего задание	делал домашнее задание	



KEY
ўкраінскім	украинским	украинском	
ва ўкраінскім алфавіце	в украинским алфавите	в украинском алфавите	



KEY
была	была	было	
была была вельмі	утром была очень	утром было очень	



KEY
пра	о	об	
суд сведчанні пра	суд свидетельстве о	суд свидетельства об	
сведчанні пра згвалтаванне	свидетельстве о изнасилование	свидетельства об изнасиловании	
пра згвалтаванне дзіцяці	о изнасилование ребёнке	об изнасиловании ребёнка	



KEY
ўсё	всё	всю	
мусім вучыцца ўсё	*мусім *вучыцца всё	мы учиться всю	
вучыцца ўсё жыццё	*вучыцца всё жизнь	учиться всю жизнь	



KEY
мару	мечту	мечта	
маю мару .	маю мечту .	есть мечта .	



KEY
фестывалю	белоруской	белорусской	
першага фестывалю беларускай	фестиваля белоруской пёсне	фестиваля белорусской песни	
фестывалю беларускай песні	белоруской пёсне и	белорусской песни и	



KEY
бок	сторона	сторону	
на цёмны бок	на *цёмны сторона	на тёмную сторону	
цёмны бок .	*цёмны сторона .	тёмную сторону .	



KEY
беларускае	белорусской	белорусское	
купляйце беларускае	*купляйце белорусской	покупайте белорусское	
купляйце беларускае !	*купляйце белорусской !	покупайте белорусское !	



KEY
мой	мой	моя	
дзе мой ?	где мой ?	где моя ?	



KEY
том	том	тома	
зараз том не	сейчас том не	у тома нет	
том не мае	том не мои	тома нет домашних	



KEY
што	что	это	
што ты заўсёды	что ты всегда	это потому ,	



KEY
полымя	пламя	полымя	
ў полымя .	в пламя .	в полымя .	



KEY
вайну	войну	войне	
пра вайну .	о войну .	о войне .	



KEY
гарачая	горячая	горячий	
занадта гарачая .	слишком горячая .	слишком горячий .	
кава такая гарачая	кофе такая горячая	кофе такой горячий	
такая гарачая ,	такая горячая ,	такой горячий ,	



KEY
раману	роману	романа	
яго раману .	его роману .	его романа .	



KEY
дні	дне	дня	
тры дні .	три дне .	три дня .	



KEY
гарачы	горячий	горящий	
перастрыбнуў праз гарачы	*перастрыбнуў через горячий	прыгнул скрозь горящий	
праз гарачы абруч	через горячий обруч	скрозь горящий обруч	



KEY
гэта	этот	это	
еўропа — гэта	европа — этот	европа - это	
— гэта кантынент	— этот континент	- это континент	
— гэта выспа	— этот остров	— это остров	
— гэта паўвостраў	— этот полуостров	— это полуостров	
чый гэта парасон	чей этот зонтик	чей это зонтик	
індустрыялізацыя — гэта	*індустрыялізацыя — этот	индустриализация - это	
— гэта пытанне	— этот вопрос	- это вопрос	
дам гэта тому	дам этот тому	дам это тому	
— гэта матэматыка	— этот математика	— это математика	
гэта хлопчык	этот мальчик	это мальчик	
гэта аловак	этот карандаш	это карандаш	
гэта кот	этот кот	это кот	
— гэта клас	— этот класс	— это класс	
вайна — гэта	война — этот	война - это	
— гэта пекла	— этот ад	- это ад	



KEY
бліжняга	своего	самого	
бліжняга як як	своего как себя	самого себя »	



KEY
беларускую	белорусскую	белорусский	
не вывучае беларускую	не *вывучае белорусскую	не изучает белорусский	
вывучае беларускую .	*вывучае белорусскую .	изучает белорусский .	



KEY
праблема	тем	том	
ў праблема ,	в тем ,	в том ,	



KEY
навошта	зачем	почему	
навошта людзі	зачем люди	почему люди	



KEY
усё	живой	живое	
хутчэй знішчыць усё	уничтожить всё живой	уничтожить все живое	
знішчыць усё на	всё живой на	все живое на	



KEY
месца	место	места	
мала месца ,	мало место ,	мало места ,	



KEY
абдурыла	одурачила	обдурила	
яна абдурыла яго	яна одурачила его	она обдурила его	



KEY
мой	мой	моей	
за мой .	за мой .	больше моей .	



KEY
тое	то	это	
пра тое ,	о то ,	 это аниме	



KEY
бацька	отец	отца	
бацька мае	отец мои	отца есть	



KEY
разы	разы	раза	
разы большы за	разы больший за	раза больше моей	



KEY
японію	японию	японии	
за японію .	за японию .	больше японии .	



KEY
той	тот	той	
ў той дзень	в тот день	по той улице	



KEY
цётка	тётка	тётя	
мая цётка радавалася	мая тётка радовалась	моя тётя радовалась	



KEY
нямецкую	немецкую	немецкий	
каб вывучаць нямецкую	чтобы изучат немецкую	чтобы изучать немецкий	
вывучаць нямецкую .	изучат немецкую .	изучать немецкий .	



KEY
першым	первым	первом	
у маім першым	в моим первым	в моём первом	
маім першым кампутары	моим первым *кампутары	моём первом компьютере	
першым кампутары было	первым *кампутары бывше	первом компьютере было	



KEY
замежных	иностранных	иностранным	
замежных сайтаў для	иностранных *сайтаў для	иностранным сайтам для	



KEY
цікавую	интересную	интересую	
і купіў цікавую	и *купіў интересную	и купил интересую	
купіў цікавую кнігу	*купіў интересную книгу	купил интересую книгу	



KEY
такая	такая	такой	
кава такая гарачая	кофе такая горячая	кофе такой горячий	
такая гарачая ,	такая горячая ,	такой горячий ,	



KEY
кут	угол	уголок	
родны кут ,	родной угол ,	родной уголок ,	



KEY
гэта	эти	это	
— гэта мэры	— эти мэры	— это .	



KEY
выпадковыя	случайные	случайны	
не выпадковыя .	не случайные .	не случайны .	



KEY
звычку	привычку	привычка	
мае звычку чытаць	мои привычку *чытаць	есть привычка читать	
звычку чытаць газеты	привычку *чытаць газеты	привычка читать газеты	



KEY
пара	пара	пора	
мне пара ісці	мне пара идти	мне пора идти	
ўжо пара ісці	уже пара идти	уже пора идти	



KEY
апытаных	опрошенных	опрашиваемых	
% апытаных беларусаў	% опрошенных белорусов	% опрашиваемых белорусов	



KEY
значку	значке	значку	
па значку «	по значке «	по значку «	



KEY
ва	в	во	
і ва ўсім	и в всем	и во всём	
ва ўсім .	в всем .	во всём .	



KEY
партыі	тёсным	тесном	
камуністычнай партыі ў	в тёсным сотрудничестве	в тесном сотрудничестве	



KEY
краі	крайу	края	
цёплыя краі .	тёплые крайу .	тёплые края .	



KEY
яшчэ	ещё	еще	
ты яшчэ адкажаш	ты ещё ответишь	ты еще ответишь	
хто яшчэ нядаўна	кто ещё недавно	кто еще недавно	
усё яшчэ не	всё ещё не	всё еще не	
яго яшчэ не	его ещё не	его еще не	



KEY
маё	моё	моём	
пра маё дзяцінства	о моё детство	о моём детстве	
маё дзяцінства .	моё детство .	моём детстве .	



KEY
будзе	будет	пребудет	
няхай будзе з	пусть будет с	да пребудет с	



KEY
ўсход	восток	востоку	
размешчаны на ўсход	размещённый на восток	находится к востоку	
на ўсход ад	на восток от	к востоку от	



KEY
щто	щто	что	
щто « «	щто « история	что `` история	



KEY
што	которому	которой	
што ён ,	которому *наснілася ,	которой снилось ,	



KEY
правы	права	прав	
не правы ,	не права ,	не прав ,	
заўсёды правы .	всегда права .	всегда прав .	



KEY
іх	них	их	
я іх ведаю	я них *ведаю	я их знаю	
іх ведаю .	них *ведаю .	их знаю .	
мы іх адшукаем	мы них *адшукаем	мы их разыщем	
іх адшукаем .	них *адшукаем .	их разыщем .	
у іх іх	*заўважаем них в	замечаем их в	
каб заставіць іх	чтобы *заставіць них	чтобы заставить их	
заставіць іх іх	*заставіць них замолчать	заставить их замолчать	



KEY
аднаразовага	одноразового	многоразового	
аднаразовага выкарыстання ,	одноразового использования ,	многоразового пользования прокомпостируйте	



KEY
з	детство	детства	
здаёмыя з з	с детство слова	с детства слова	



KEY
аптымістычныя	оптимистические	оптимистичные	
вельмі аптымістычныя .	очень оптимистические .	очень оптимистичные .	



KEY
некаторыя	некоторые	некоторый	
некаторыя зоркі	некоторые звезды	некоторый звёзды	
некаторыя зоркі амаль	некоторые звезды почти	некоторый звёзды почти	



KEY
кветкі	цветка	цветы	
сарваныя кветкі	*сарваныя цветка	сорванные цветы	
сарваныя кветкі хутка	*сарваныя цветка быстро	сорванные цветы быстро	
кветкі засыхалі	цветка *засыхалі	цветы засыхали	
кветкі засыхалі без	цветка *засыхалі без	цветы засыхали без	
не чапай кветкі	не *чапай цветка	не трогай цветы	
чапай кветкі .	*чапай цветка .	трогай цветы .	



KEY
знішчыць	всё	все	
хутчэй знішчыць усё	уничтожить всё живой	уничтожить все живое	
знішчыць усё на	всё живой на	все живое на	



KEY
агні	огне	огни	
бачна праз агні	видно через огне	видно сквозь огни	
праз агні горада	через огне города	сквозь огни города	



KEY
песні	пёсне	песни	
падабаюцца яе песні	*падабаюцца неё пёсне	нравятся её песни	
яе песні ?	неё пёсне ?	её песни ?	



KEY
нямецкая	немецкая	немецкий	
нямецкая —	немецкая —	немецкий —	
нямецкая —	немецкая —	немецкий —	
ці нямецкая .	или немецкая .	или немецкий .	



KEY
кароткае	короткой	коротка	
надта кароткае ,	слишком короткой ,	слишком коротка ,	



KEY
пераможца	победитель	победителя	
на пераможца з	на победитель с	ждет победителя с	



KEY
багатая	богатая	богата	
краіна багатая на	страна богатая на	страна богата на	



KEY
за	в	во	
і за мір	мир в всем	мир во всём	
за мір ва	в всем мире	во всём мире	



KEY
нямецкай	немецким	немецкого	
акрамя нямецкай мовы	кроме немецким языка	кроме немецкого языка	



KEY
найлепшы	наилучший	лучший	
мой найлепшы сябра	мой наилучший член	мой лучший друг	
найлепшы сябра .	наилучший член .	лучший друг .	
быў найлепшы дзень	был наилучший день	был лучший день	



KEY
якой	которой	котором	
на якой машыністы	на которой машинисты	на котором машинисты	



KEY
свае	свои	своих	
пра свае школьныя	о свои школьные	о своих школьных	
свае школьныя годы	свои школьные *годы	своих школьных годах	



KEY
фартэпіяна	фортепьяно	фортепиано	
на фартэпіяна ?	на фортепьяно ?	на фортепиано ?	



KEY
горкі	горки	горькое	
застаўся горкі	остался горки	осталось горькое	
застаўся горкі паслясмак	остался горки *паслясмак	осталось горькое послевкусие	
горкі паслясмак .	горки *паслясмак .	горькое послевкусие .	



KEY
начальніка	начальника	начальником	
з свайго начальніка	со своего начальника	над своим начальником	
свайго начальніка на	своего начальника на	своим начальником на	



KEY
забаронены	запрещённый	запрещён	
францыі забаронены доступ	франции запрещённый доступ	франции запрещён доступ	



KEY
лепшая	лучшая	лучше	
мова лепшая за	язык лучшая за	язык лучше эсперанто	



KEY
пабудову	общество	общества	
за пабудову камуністычнага	коммунистического общество в	коммунистического общества в	



KEY
мой	мой	моём	
мой першы камп	мой первый компьютер	моём первом компьютере	



KEY
англійская	английская	английский	
што англійская —	что английская —	что английский —	



KEY
налева	налево	влево	
палец налева ці	палец налево или	палец влево или	



KEY
адзін	один	одна	
— гэта адзін	— эта один	- это одна	
гэта адзін з	эта один с	это одна из	
адзін з кітайскіх	один с китайских	одна из разновидностей	



KEY
навучыць	научить	обучить	
хацеў навучыць свайго	хотел научить своего	хотел обучить своего	



KEY
парасонам	зонтиком	зонтом	
адным парасонам ?	одним зонтиком ?	одним зонтом ?	



KEY
маці	мать	матери	
дзень маці .	день мать .	день матери .	



KEY
больш	более	больше	
я больш не	я более не	я больше не	
не больш за	не более за	не больше тысячи	
не больш за	не более за	не больше тысячи	
чым больш чытаеш	чем более *чытаеш	чем больше читаешь	
чым больш чытаеш	чем более *чытаеш	тем больше познаешь	
больш чытаеш ,	более *чытаеш ,	больше читаешь ,	
тым больш спазнаеш	тем более *спазнаеш	чем больше читаешь	
тым больш спазнаеш	тем более *спазнаеш	тем больше познаешь	
больш спазнаеш .	более *спазнаеш .	больше познаешь .	



KEY
марка	марка	марко	
машына марка называецца	машина марка *называецца	машина марко называется	
марка называецца «	марка *называецца «	марко называется «	



KEY
сказ	предложение	предложении	
пра яе сказ	о неё предложение	о её предложении	
яе сказ ?	неё предложение ?	её предложении ?	



KEY
дрэва	дерево	дерева	
выразаў з дрэва	*выразаў с дерево	вырезал из дерева	
з дрэва статую	с дерево истукане	из дерева статую	
дрэва статую буды	дерево истукане *буды	дерева статую будды	
зроблены з дрэва	*зроблены с дерево	сделан из дерева	
з дрэва .	с дерево .	из дерева .	
з дрэва .	с дерево .	с дерева .	



KEY
адмоўнае	отрицательной	отрицательное	
і адмоўнае ў	и отрицательной в	и отрицательное в	



KEY
удавы	удавы	вдовы	
адной удавы было	одной удавы бывше	одной вдовы было	
удавы было дзве	удавы бывше две	вдовы было две	



KEY
рэсурсы	ресурсы	ресурсами	
прыродныя рэсурсы .	природные ресурсы .	природными ресурсами .	



KEY
не	не	нет	
ці не .	или не .	или нет .	
слова « не	слово « не	слова `` нет	
я не	я не	меня нет	
я не маю	я не маю	меня нет времени	
не маю маю	не маю времени	нет времени на	
ці не .	или не .	или нет .	
ці не	или не	у нет	
ці не маеш	или не *маеш	у нет чего-нибудь	
не ,	не ,	нет ,	
ці не маеце	или не *маеце	вас нет комнат	
мая сястра не	мая сестра не	моей сестры нет	
сястра не мае	сестра не мои	сестры нет высшего	
! мы не	! мы не	у нас нет	
мы не маем	мы не маем	нас нет времени	
сёння не маю	сегодня не маю	меня нет желания	
я не маю	я не маю	меня нет водки	
мне не хапае	мне не *хапае	меня нет слов	
ці не ,	или не ,	или нет ,	
зараз том не	сейчас том не	у тома нет	
том не мае	том не мои	тома нет домашних	
але не маем	но не маем	у нет ничего	
не ,	не ,	нет ,	
 не ,	 не ,	раз нет !	
яшчэ раз не	ещё однажды не	ещё раз нет	
раз не !	однажды не !	 нет ,	
раз не !	однажды не !	раз нет !	



KEY
здароўя	эта	это	
бо гэта здароўя	так как эта	потому что это	
здароўя для для	эта плохо для	это вредно для	



KEY
беларускай	пёсне	песни	
першага фестывалю беларускай	фестиваля белоруской пёсне	фестиваля белорусской песни	
фестывалю беларускай песні	белоруской пёсне и	белорусской песни и	



KEY
расце	растёт	растет	
гады расце людзей	гады растёт людей	годы растет людей	



KEY
богу	боге	богу	
дзякуй богу .	*дзякуй боге .	слава богу .	



KEY
ўвагі	внимания	внимание	
прыняць да ўвагі	принять к внимания	принять во внимание	
да ўвагі асаблівыя	к внимания особые	во внимание особые	



KEY
эгаістычная	эгоистичная	эгоистична	
вельмі эгаістычная .	очень эгоистичная .	очень эгоистична .	



KEY
не	не	ни	
браўзер не браўзер	*браўзер не безопасный	 ни один	
браўзер не браўзер	*браўзер не безопасный	 ни один	
не ў .	не *вінаваты .	ни в чём	



KEY
сучасным	современным	современном	
ў сучасным свеце	в современным мире	в современном мире	



KEY
ранняй	ранним	раннем	
у ранняй творчасці	в ранним творчестве	в раннем творчестве	



KEY
халоднае	холодной	холодное	
выпіць штосьці халоднае	выпить *штосьці холодной	выпить что-нибудь холодное	



KEY
банку	банке	банку	
мне банку варэння	мне банке варенья	мне банку варенья	



KEY
гэтая	это	эта	
гэтая манга	это манго	эта манга	
гэтая манга даволі	это манго довольно	эта манга довольно	



KEY
свабоднымi	свободнымi	свободными	
нараджаюцца свабоднымi i	*нараджаюцца свободнымi i	рождаются свободными и	
свабоднымi i роўнымi	свободнымi i ровнымi	свободными и равными	



KEY
сваё	своё	свое	
рабі сваё дамашняе	*рабі своё домашнего	делай свое домашнее	
сваё дамашняе заданне	своё домашнего задание	свое домашнее задание	
люся ненавідзела сваё	*люся *ненавідзела своё	люся ненавидела свое	
ненавідзела сваё імя	*ненавідзела своё имя	ненавидела свое имя	



KEY
спявае	поёт	поет	
дачка спявае ў	дочь поёт в	дочь поет в	



KEY
шакаладнае	шоколадного	шоколадное	
маем шакаладнае пячэнне	маем шоколадного печенье	есть шоколадное печенье	



KEY
біла	било	билл	
за біла .	за било .	чем билл .	



KEY
блізарукі	близорукий	близорук	
чалавек блізарукі .	человек близорукий .	человек близорук .	



KEY
найлепшая	наилучшая	лучшая	
— найлепшая спявачка	— наилучшая певица	— лучшая певица	



KEY
роўнымi	ровнымi	равными	
свабоднымi i роўнымi	свободнымi i ровнымi	свободными и равными	
i роўнымi ў	i ровнымi в	и равными в	



KEY
ці	или	ли	
ці гэта добра	или эта хорошо	ли это .	
— ці існуе	— или *існуе	существует ли она	



KEY
зайцы	зайце	зайцы	
усе зайцы —	все зайце —	все зайцы —	



KEY
кроку	шаге	шага	
аднаго кроку .	одного шаге .	одного шага .	



KEY
дапамогуць	помогут	поможет	
лекі дапамогуць табе	леки помогут тебе	тебе поможет .	



KEY
захаду	запада	западу	
па захаду з	по запада с	по западу из	
захаду з горада	запада с города	западу из города	



KEY
гэта	это	этого	
гэта возера не	это озеро не	этого озера полно	



KEY
шаўкоўніцай	шелковицей	шелковницей	
яно завецца шаўкоўніцай	оно *завецца шелковицей	оно называется шелковницей	
завецца шаўкоўніцай блукання	*завецца шелковицей блуждания	называется шелковницей блуждания	



KEY
майму	моему	моим	
радавалася майму поспеху	радовалась моему успехе	радовалась моим успехам	
майму поспеху .	моему успехе .	моим успехам .	



KEY
прэзідэнта	президента	президенты	
балатавацца на прэзідэнта	*балатавацца на президента	баллотироваться в президенты	
на прэзідэнта ?	на президента ?	в президенты ?	



KEY
сучаснай	литературе	литературы	
шэдэўр сучаснай літаратуры	современной литературе .	современной литературы .	



KEY
ж	ж	же	
колькі ж казахаў	сколько ж казахов	сколько же казахов	
ты ж ведаў	ты ж *ведаў	ты же ,	
тыя ж тэмы	те ж темы	те же темы	
вядома ж месяц	конечно ж месяц	конечно же луна	
ж месяц ,	ж месяц ,	же луна ,	
які ж ты	яки ж ты	какой же ты	
такая ж элегантная	такая ж элегантная	хуана же элегантна	
ж элегантная ,	ж элегантная ,	же элегантна ,	



KEY
гісторыя	общество	общества	
гісторыя — —	общество — эта	общества - это	



KEY
фізкультуры	физкультуре	физкультуры	
урок фізкультуры .	урок физкультуре .	урок физкультуры .	



KEY
яе	неё	ней	
пра яе .	о неё .	о ней .	



KEY
адзін	один	одно	
напісаў адзін ліст	написал один лист	написал одно письмо	
адзін ліст .	один лист .	одно письмо .	



KEY
прачытаў	прочитал	прочёл	
я прачытаў удвая	я прочитал вдвое	я прочёл вдвое	



KEY
пялёнак	пелён	пелёнок	
вылез з пялёнак	*вылез с пелён	вылез из пелёнок	
з пялёнак .	с пелён .	из пелёнок .	



KEY
купляйце	белорусской	белорусское	
« купляйце купляйце	« *купляйце белорусской	« покупайте белорусское	
купляйце купляйце !	*купляйце белорусской !	покупайте белорусское !	



KEY
старадаўняй	старинной	старинном	
у старадаўняй гаворцы	в старинной речи	в старинном эти	



KEY
набыла	приобрела	обрела	
яна набыла новыя	она приобрела новые	она обрела новые	



KEY
жудаснага	ужасного	ужасному	
яго жудаснага апетыту	его ужасного аппетита	его ужасному аппетиту	
жудаснага апетыту .	ужасного аппетита .	ужасному аппетиту .	



KEY
працы	работе	работы	
і працы .	и работе .	и работы .	



KEY
нямецкай	немецкой	немецкого	
замест нямецкай .	вместо немецкой .	вместо немецкого .	



KEY
без	без	безъ	
ужываюцца без артыкля	*ужываюцца без артикля	употребляются безъ члена	



KEY
офісу	офису	офиса	
вярнуўся з офісу	вернулся с офису	вернулся из офиса	
з офісу .	с офису .	из офиса .	



KEY
фінскія	финские	французские	
што фінскія ці	что финские или	что французские или	



KEY
зялёнай	зелёной	зеленого	
выпіла зялёнай гарбаты	выпила зелёной горбатый	выпила зеленого чаю	



KEY
школьныя	школьные	школьных	
пра свае школьныя	о свои школьные	о своих школьных	
свае школьныя годы	свои школьные *годы	своих школьных годах	
школьныя годы .	школьные *годы .	школьных годах .	



KEY
якой	которой	которому	
па якой было	по которой бывше	по которому было	
якой было лёгка	которой бывше легко	которому было легко	



KEY
што	что	то	
пра што я	о что я	раз то ,	



KEY
ўмее	них	их	
не ўмее ўмее	не *ўмее них	не умеет их	
ўмее ўмее бачыць	*ўмее них *бачыць	умеет их видеть	
ўмее бачыць бачыць	них *бачыць .	их видеть .	



KEY
танная	дешёвая	дешёвый	
вельмі танная .	очень дешёвая .	очень дешёвый .	



KEY
у	в	во	
у сусвеце	в вселенной	во вселенной	
зараз у львове	сейчас в *львове	сейчас во львове	
у львове !	в *львове !	во львове !	
размаўляюць у францыі	*размаўляюць в франции	говорят во франции	
у сусвеце	в вселенной	во вселенной	
размаўляць у львове	*размаўляць в *львове	разговаривать во львове	
у львове па-руску	в *львове по-русски	во львове по-русски	
водпуск у францыі	отпуск в франции	отпуск во франции	
у многіх	в *многіх	во многих	
у многіх краінах	в *многіх странах	во многих странах	



KEY
добрая	хорошая	хороша	
жыццё добрая ,	жизнь хорошая ,	и хороша ,	



KEY
французская	французская	французский	
: французская ці	: французская или	: французский или	



KEY
кітай	китай	китае	
пра кітай .	о китай .	о китае .	



KEY
небяспечныя	опасные	опасными	
гма небяспечныя для	*гма опасные для	являются опасными для	



KEY
пайсці	пойти	уйти	
не пайсці нам	не пойти зам	не уйти ли	



KEY
мясцовым	местным	местном	
у мясцовым універсітэце	в местным университете	в местном университете	



KEY
казахстане	казахстане	разработана	
у казахстане распрацаваная	в казахстане *распрацаваная	казахстане разработана концепция	



KEY
дзіцяці	ребёнке	ребёнку	
дзіцяці патрэбна	ребёнке должно	ребёнку нужна	



KEY
саміх	них	их	
іх саміх саміх	как них самих	как их осудят	



KEY
старшыні	председателе	председателю	
да старшыні !	к председателе !	к председателю !	



KEY
варожага	вражеского	вражеский	
адкрытыя для варожага	открытые для вражеского	попали под вражеский	
для варожага агню	для вражеского огня	под вражеский обстрел	
варожага агню .	вражеского огня .	вражеский обстрел .	



KEY
вуліцах	улицах	улицам	
па вуліцах ,	по улицах ,	по улицам ,	



KEY
няма	нету	нет	
няма такога	нету такого	нет такого	
сёння няма заняткаў	сегодня нету занятий	сегодня нет занятий	
няма нічога	нету ничего	нет ничего	
слоўніку няма слова	словаре нету слово	словаре нет слова	
няма слова «	нету слово «	нет слова «	
заняткаў няма .	занятий нету .	занятий нет .	
няма нічога	нету ничего	нет ничего	
мовы няма ў	языка нету в	языка нет в	
няма бога	нету бога	нет бога	
пінгвінаў няма .	пингвинов нету .	пингвинов нет .	
амаль няма такіх	почти нету таких	почти нет таких	



KEY
гатовае	готовой	готов	
снеданне гатовае ?	завтрак готовой ?	завтрак готов ?	



KEY
эзатэрычных	эзотерических	экзотерических	
ўзроўні эзатэрычных абрадаў	уровне эзотерических обрядов	уровне экзотерических обрядов	



KEY
забаронены	запрещённый	запрещен	
быў забаронены .	был запрещённый .	был запрещен .	



KEY
табе	тебе	тебя	
табе калісьці	тебе когда-то	тебя когда-то	



KEY
за	за	да	
ні за што	ни за что	? да ни	



KEY
таксама	также	тоже	
ён таксама не	он также не	он тоже не	
я таксама .	я также .	я тоже .	



KEY
кошыку	корзинке	корзине	
у кошыку было	в корзинке бывше	в корзине было	
кошыку было даволі	корзинке бывше довольно	корзине было довольно	



KEY
новыя	новые	новых	
за новыя .	за новые .	ценнее новых .	



KEY
калекцыю	коллекцию	коллекция	
мае добрую калекцыю	мои хорошую коллекцию	есть хорошая коллекция	
добрую калекцыю сучасных	хорошую коллекцию современных	хорошая коллекция современных	



KEY
першы	первый	первом	
мой першы камп	мой первый компьютер	моём первом компьютере	
першы камп меў	первый компьютер *меў	первом компьютере было	



KEY
пра	смерть	смерти	
навуку пра ,	о смерть ,	о смерти ,	



KEY
знішчаны	уничтоженный	уничтожен	
сябра рон знішчаны	член *рон уничтоженный	друг рон уничтожен	
рон знішчаны .	*рон уничтоженный .	рон уничтожен .	



KEY
хоць	хотя	хоть	
можаш хоць раз	можешь хотя однажды	можешь хоть раз	
хоць раз прыйсці	хотя однажды прийти	хоть раз прийти	



KEY
папулярная	популярная	популярна	
даволі папулярная ў	довольно популярная в	довольно популярна в	



KEY
нашы	наши	знали	
 нашы продкі	 наши предки	предки знали астрологию	



KEY
жыццё	электричестве	электричества	
без жыццё ?	без электричестве ?	без электричества ?	



KEY
агародніна	овощ	овощи	
і агародніна важная	и овощ важная	и овощи важны	
агародніна важная для	овощ важная для	овощи важны для	



KEY
гарах	гарях	горах	
ў гарах .	в гарях .	в горах .	



KEY
не	падежах	падежахъ	
іншых склонах не	в других падежах	въ остальныхъ падежахъ	



KEY
пытанні	вопросе	вопросу	
па гэтым пытанні	по этим вопросе	по этому вопросу	
гэтым пытанні .	этим вопросе .	этому вопросу .	



KEY
прыродныя	природные	природными	
прыродныя рэсурсы .	природные ресурсы .	природными ресурсами .	



KEY
ў	в	во	
хачу ў львоў	хочу в *львоў	хочу во львов	
ў львоў ...	в *львоў ...	во львов ...	



KEY
у	в	въ	
у р. .	в *р .	въ род .	



KEY
што	что	кто	
што ён матылёк	что он бабочка	кто же он	



KEY
белае	белого	белое	
вам белае віно	вам белого вино	вам белое вино	



KEY
чалавека	человека	человеку	
чалавека застаўляе тысячы	человека *застаўляе тысяче	человеку заставляет бесчисленные	



KEY
камп	компьютер	компьютере	
мой першы камп	мой первый компьютер	моём первом компьютере	
першы камп меў	первый компьютер *меў	первом компьютере было	



KEY
гэтым	этим	этом	
у гэтым класе	в этим классе	в этом классе	
у гэтым тэсце	в этим тесте	в этом тесте	
у гэтым гуцы	в этим *гуцы	в этом лишь	
у гэтым парку	в этим парк	в этом парке	
гэтым парку шмат	этим парк много	этом парке много	
ў гэтым лесе	в этим лесу	в этом лесу	
ў гэтым свеце	в этим мире	в этом мире	



KEY
змяніўся	изменился	поменялся	
не змяніўся звонку	не изменился снаружи	не поменялся снаружи	



KEY
пытанні	вопросе	вопросы	
ёсць пытанні ?	будем вопросе ?	 вопросы есть	



KEY
перакладзіце	переложите	переведите	
перакладзіце наступныя	переложите следующие	переведите следующие	



KEY
ў	невинного	невинное	
люсіна ў	*люсіна невинного	люсино невинное	



KEY
жыхарства	жительство	жительства	
месцу жыхарства і	месту жительство и	месту жительства и	



KEY
афарызмы	который	которой	
афарызмы , ці	который иногда *піша	которой снится ,	



KEY
цягніку	часы	часов	
12 цягніку правёў	12 часы провёл	двенадцать часов .	



KEY
расплюшчыце	откроете	откройте	
расплюшчыце вочы	откроете глаза	откройте глаза	



KEY
значэнні	значении	значения	
два значэнні .	два значении .	два значения .	



KEY
вялікі	большой	большое	
вялікі дзякуй	большой *дзякуй	большое спасибо	
вялікі дзякуй !	большой *дзякуй !	большое спасибо !	



KEY
гультай	лентяй	ленивый	
ты гультай !	ты лентяй !	ты ленивый !	



KEY
мой	моё	мой	
вось мой сцяг	вот моё знамя	вот мой флаг	
мой сцяг для	моё знамя для	мой флаг для	



KEY
.	свет	светло	
сонца толькі .	солнце *свеціць свет	светит только светло	



KEY
шкада	жалко	жаль	
шкада ,	жалко ,	жаль ,	
шкада ,	жалко ,	жаль ,	



KEY
беларускай	белоруской	белорусской	
велічыня беларускай паэзіі	величина белоруской поэзии	величина белорусской поэзии	



KEY
адно	одно	один	
на адно пытанне	на одно вопрос	на один вопрос	
мне адно пытанне	мне одно вопрос	мне один вопрос	



KEY
настаўніку	учителе	учителю	
свайму настаўніку .	своему учителе .	своему учителю вопрос	



KEY
цябе	тебя	тебе	
да цябе .	к тебя .	к тебе .	
пра цябе ведаю	о тебя *ведаю	о тебе знаю	
цябе ведаю .	тебя *ведаю .	тебе знаю .	



KEY
кітайскай	китайским	китайского	
дыялектах кітайскай мовы	диалектах китайским языка	диалектах китайского языка	



KEY
дзяржаўны	государственное	государственный	
мае дзяржаўны сцяг	мои государственное знамя	есть государственный флаг	
дзяржаўны сцяг .	государственное знамя .	государственный флаг .	



KEY
месцы	месте	места	
месцы для	месте для	места для	



KEY
наша	наша	наше	
ў наша аконца	в наша *аконца	в наше .	



KEY
направа	направо	вправо	
ці направа ,	или направо ,	или вправо ,	



KEY
усё	всё	все	
клава любіць усё	*клава *любіць всё	клава любит все	
любіць усё усё	*любіць всё *ірацыянальнае	любит все иррациональное	
усё гэта	всё эта	все это	
усё гэта толькі	всё эта только	все это только	



KEY
мінулым	прошлым	прошлом	
аб мінулым !	о прошлым !	о прошлом .	
мінулым !	прошлым !	прошлом .	



KEY
пачакайце	подождите	погодите	
пачакайце ,	подождите ,	погодите ,	



KEY
выклічце	вызывайте	вызовите	
тэрмінова выклічце хуткую	срочно вызывайте быструю	срочно вызовите скорую	
выклічце хуткую дапамогу	вызывайте быструю помощь	вызовите скорую !	



KEY
поспеху	успехе	успехам	
радавалася майму поспеху	радовалась моему успехе	радовалась моим успехам	
майму поспеху .	моему успехе .	моим успехам .	



KEY
англійскай	английским	английском	
на англійскай мове	на английским языке	на английском .	
на англійскай мове	на английским языке	на английском языке	



KEY
лепшы	лучший	лучше	
веласіпед лепшы за	велосипед лучший за	велосипед лучше моего	



KEY
пачаўся	начался	началось	
сход пачаўся позна	собрание начался поздно	собрание началось поздно	



KEY
прыпынак	остановка	остановку	
на прыпынак праз	на остановка через	на остановку через	



KEY
паказаў	показов	показал	
ён паказаў мне	он показов мне	он показал мне	



KEY
шматразовага	многократного	многоразового	
білета шматразовага выкарыстання	билета многократного использования	билета многоразового пользования	
шматразовага выкарыстання пракампасціруйце	многократного использования *пракампасціруйце	многоразового пользования прокомпостируйте	



KEY
прыгоннае	крепостного	крепостное	
увёў прыгоннае права	ввёл крепостного право	ввёл крепостное право	



KEY
зачынены	закрытый	закрыт	
магазін зачынены .	магазин закрытый .	магазин закрыт .	



KEY
ўзвышэнне	возвышение	возвышении	
пра ўзвышэнне і	о возвышение и	о возвышении и	



KEY
манеры	манере	манеры	
французкія манеры ,	*французкія манере ,	французские манеры ,	



KEY
высновы	вывода	выводу	
да высновы ,	к вывода ,	к выводу ,	



KEY
напісаны	написанный	написана	
артыкул напісаны	артикул написанный	статья написана	
артыкул напісаны звязнай	артикул написанный связной	статья написана связным	
напісаны звязнай сучаснай	написанный связной современным	написана связным современным	



KEY
ты	бы	ты	
гэта б ты	эта когда бы	как бы ты	
б ты ты	когда бы ты	 ты хотел	
б ты ты	когда бы ты	бы ты продавал	



KEY
маім	моим	моём	
ў маім класе	в моим классе	в моём классе	
у маім першым	в моим первым	в моём первом	
маім першым кампутары	моим первым *кампутары	моём первом компьютере	



KEY
выгляду	вида	виду	
з выгляду падобнае	с вида *падобнае	с виду похожее	
выгляду падобнае на	вида *падобнае на	виду похожее на	
яго выгляду ,	его вида ,	его виду ,	



KEY
ружы	розе	розы	
садзіць ружы .	*садзіць розе .	сажает розы .	



KEY
)	чужим	чужом	
) ) чужой	) чужим языке	) чужом языке	



KEY
розных	разных	различных	
прадстаўнікі розных рэлігій	представители разных религий	представители различных религий	



KEY
тоні	тоне	тони	
тоні —	тоне —	тони -	
тоні — выхаваны	тоне — воспитанный	тони - воспитанный	



KEY
папала	попала	попало	
купляў якія папала	покупок которые попала	покупал какие попало	
якія папала кнігі	которые попала книги	какие попало книги	



KEY
лета	лето	лета	
японскага лета ,	японского лето ,	японского лета ,	



KEY
павярнулася	повернулась	вернулась	
няўжо дарэнда павярнулася	*няўжо *дарэнда повернулась	неужели доренда вернулась	
дарэнда павярнулася ?	*дарэнда повернулась ?	доренда вернулась ?	



KEY
птушка	птица	птичка	
прыгожая птушка !	красивая птица !	красивая птичка !	



KEY
грым	грим	гримм	
братоў грым чырвонае	братьев грим красной	братьев гримм красное	
грым чырвонае каптурко	грим красной *каптурко	гримм красное шапочко	



KEY
нават	создал	сделал	
нават нават на	даже создал на	даже сделал на	



KEY
яму	яму	ему	
дала яму гадзіннік	дала яму часы	дала ему часы	
яму падабаецца	яму *падабаецца	ему нравится	
яму пашанцавала	яму *пашанцавала	ему посчастливилось	
яму пашанцавала знайсці	яму *пашанцавала *знайсці	ему посчастливилось найти	
не дурыце яму	не *дурыце яму	не дурите ему	
дурыце яму галаву	*дурыце яму голову	дурите ему голову	
але яму пашанцавала	но яму *пашанцавала	но ему повезло	



KEY
дзіцяці	ребёнке	ребёнка	
пра згвалтаванне дзіцяці	о изнасилование ребёнке	об изнасиловании ребёнка	
згвалтаванне дзіцяці ,	изнасилование ребёнке ,	изнасиловании ребёнка ,	



KEY
рацыю	рацию	рация	
меў рацыю .	*меў рацию .	была рация .	



KEY
тую	тую	ту	
тую самую ноч	тую саму ночь	ту самую ночь	



KEY
сваім	своим	своём	
на сваім сайце	на своим *сайце	на своём сайте	
сваім сайце кнопки	своим *сайце *кнопки	своём сайте кнопки	



KEY
вядомы	известный	известен	
мандалай вядомы	*мандалай известный	мандалай известен	
мандалай вядомы сваімі	*мандалай известный своими	мандалай известен своими	



KEY
вядомае	известной	известно	
возера товада вядомае	озеро *товада известной	озеро товада известно	
товада вядомае сваёй	*товада известной своей	товада известно своей	



KEY
ён	он	она	
што ён матылёк	что он бабочка	что она чжуан-цзы	
ён ён ,	что он *чжуанцзы	что она чжуан-цзы	



KEY
яе	неё	не	
яе не бачыў	неё не *бачыў	не видел ...	



KEY
французскую	французскую	французский	
на французскую .	на французскую .	на французский .	
я вучыў французскую	я *вучыў французскую	я учил французский	
вучыў французскую замест	*вучыў французскую вместо	учил французский вместо	



KEY
чым	чем	тем	
чым больш чытаеш	чем более *чытаеш	тем больше познаешь	



KEY
вяла	вяло	вела	
яна вяла дзённік	она вяло дневник	она вела дневник	



KEY
«	они	она	
— « »	почему они красные	почему она ?	



KEY
паляпшэнне	улучшение	улучшении	
пра паляпшэнне работы	о улучшение работы	о улучшении работы	



KEY
кітайскай	китайской	китайском	
на кітайскай	на китайской	на китайском	



KEY
дзяцінства	детство	детстве	
пра маё дзяцінства	о моё детство	о моём детстве	
маё дзяцінства .	моё детство .	моём детстве .	



KEY
вывучыць	изучить	научиться	
немагчыма вывучыць у	невозможно изучить в	нельзя научиться в	



KEY
апошнім	последним	последнее	
апошнім часам	последним иногда	последнее время	



KEY
гэты	этот	это	
на гэты высокі	на этот высокое	на это высокое	
гэты свет —	этот мир —	это ад для	



KEY
але	но	не	
але яму не	но яму не	не вышло .	
але нават і	но даже и	не работает ,	



KEY
большы	больший	больше	
удвая большы за	вдвое больший за	вдвое больше японии	
разы большы за	разы больший за	раза больше моей	



KEY
мне	мне	меня	
здрадзіў мне .	*здрадзіў мне .	ты меня предал	
мне не хапае	мне не *хапае	меня нет слов	



KEY
іх	них	ним	
па іх сумуем	по них *сумуем	по ним скучаем	
іх сумуем ,	них *сумуем ,	ним скучаем ,	



KEY
спадару	господине	господину	
патэлефанаваць спадару форду	*патэлефанаваць господине форду	позвонить господину форду	



KEY
слізкае	скользкой	скользкое	
і слізкае дакранулася	и скользкой *дакранулася	и скользкое дотронулось	
слізкае дакранулася да	скользкой *дакранулася к	скользкое дотронулось до	



KEY
гатовы	готовый	готов	
ўжо гатовы .	уже готовый .	уже готов .	



KEY
над	над	надо	
над мной	над мной	надо мной	



KEY
што	эта	это	
а што за	что эта за	что это за	



KEY
выкарыстання	использования	пользования	
білета шматразовага выкарыстання	билета многократного использования	билета многоразового пользования	
шматразовага выкарыстання пракампасціруйце	многократного использования *пракампасціруйце	многоразового пользования прокомпостируйте	
шматразовага выкарыстання пракампасціруйце	многократного использования *пракампасціруйце	одноразового пользования ,	
выкарыстання пракампасціруйце білет	использования *пракампасціруйце билет	пользования прокомпостируйте билет	
аднаразовага выкарыстання ,	одноразового использования ,	многоразового пользования прокомпостируйте	
аднаразовага выкарыстання ,	одноразового использования ,	одноразового пользования ,	



KEY
7up	7up	7up'ом	
гваздзікі 7up ’	*гваздзікі 7up ’	"поливать 7up'ом вместо"	



KEY
тысячы	тысяче	тысячи	
дзве тысячы йен	две тысяче *йен	больше тысячи иен	
тысячы йен .	тысяче *йен .	тысячи иен .	
ёсць тысячы фільмаў	будем тысяче фильмов	есть тысячи фильмов	
дзве тысячы йен	две тысяче *йен	больше тысячи иен	
тысячы йен .	тысяче *йен .	тысячи иен .	
тысячы разоў	тысяче разов	тысячи раз	



KEY
браты	братья	браться	
усе браты імкнуліся	все братья *імкнуліся	все браться стремились	
браты імкнуліся быць	братья *імкнуліся быть	браться стремились быть	



KEY
вядомы	известный	известным	
такі вядомы ,	токи известный ,	таким известным ,	



KEY
глыбокае	глубокой	глубокое	
вельмі глыбокае .	очень глубокой .	очень глубокое .	



KEY
пераклала	переложила	перевела	
яна пераклала ліст	яна переложила лист	она перевела письмо	
пераклала ліст з	переложила лист с	перевела письмо с	



KEY
азёрамі	озёрами	озерами	
і азёрамі .	и озёрами .	и озерами .	



KEY
наша	наш	наша	
наша яда	наш як	наша еда	
наша яда танная	наш як дешёвая	наша еда дешёвая	



KEY
іншых	в	въ	
іншых склонах не	в других падежах	въ остальныхъ падежахъ	



KEY
ўсё	всё	все	
я люблю ўсё	я *люблю всё	я люблю все	
люблю ўсё на	*люблю всё на	люблю все на	
клава ўсё	*клава всё	клава все	
клава ўсё спрошчвае	*клава всё *спрошчвае	клава все упрощает	
ўсё спрошчвае .	всё *спрошчвае .	все упрощает .	



KEY
нядобры	нехороший	хороший	
ён нядобры чалавек	он нехороший человек	не хороший человек	



KEY
сястра	сестра	сестры	
мая сястра не	мая сестра не	моей сестры нет	
сястра не мае	сестра не мои	сестры нет высшего	



KEY
цягам	них	их	
часу цягам часу	времени них значение	времени их значение	



KEY
ездзіць	ездить	ездит	
штогод ездзіць у	ежегодно ездить в	год ездит в	



KEY
свайго	своей	свою	
пахаваў свайго сабаку	похоронил своей собаку	похоронил свою собаку	



KEY
відэа	видео	видел	
бачыў відэа ,	*бачыў видео ,	ты видел видео	



KEY
добрую	хорошую	хорошая	
мае добрую калекцыю	мои хорошую коллекцию	есть хорошая коллекция	
добрую калекцыю сучасных	хорошую коллекцию современных	хорошая коллекция современных	



KEY
госці	гостье	гости	
госці заўсёды	гостье всегда	гости всегда	



KEY
раніцы	утре	утро	
добрай раніцы	хорошим утре	доброе утро	
добрай раніцы .	хорошим утре .	доброе утро !	
раніцы .	утре .	утро !	



KEY
тата	тата	папа	
тата ,	тата ,	папа ,	



KEY
май	май	имей	
не май сто	не май сто	не имей сто	
не май сто	не май сто	а имей сто	
а май сто	а май сто	не имей сто	
а май сто	а май сто	а имей сто	



KEY
самую	саму	самую	
тую самую ноч	тую саму ночь	ту самую ночь	



KEY
палічцы	полочке	полке	
кніжнай палічцы толькі	книжной полочке только	книжной полке только	



KEY
сваім	своим	своей	
— сваім ,	— своим ,	жил своей жизнью	



KEY
сапраўднае	настоящей	настоящая	
не сапраўднае каханне	не настоящей любовь	была настоящая любовь	



KEY
багатая	богатая	богат	
мова багатая на	язык богатая на	язык богат на	



KEY
застаўся	остался	осталось	
застаўся горкі	остался горки	осталось горькое	
застаўся горкі паслясмак	остался горки *паслясмак	осталось горькое послевкусие	



KEY
магу	маге	могу	
не магу ціма	не маге *ціма	не могу тима	
магу ціма знайсці	маге *ціма *знайсці	могу тима найти	
не магу з	не маге с	не могу с	
магу пазычыць вам	маге *пазычыць вам	могу одолжить вам	



KEY
чырвонае	красной	красное	
братоў грым чырвонае	братьев грим красной	братьев гримм красное	
грым чырвонае каптурко	грим красной *каптурко	гримм красное шапочко	
чырвонае каптурко ніякага	красной *каптурко никакого	красное шапочко рода	



KEY
дзень	ночью	ночь	
з дзень .	с ночью .	сменяет ночь .	



KEY
адчыненымі	открытыми	открытой	
пакінуў дзверы адчыненымі	оставил *дзверы открытыми	оставил дверь открытой	
дзверы адчыненымі ?	*дзверы открытыми ?	дверь открытой ?	



KEY
японскую	японскую	японский	
на японскую .	на японскую .	на японский .	



KEY
ваш	ваш	ваше	
за ваш ліст	за ваш лист	за ваше письмо	
ваш ліст .	ваш лист .	ваше письмо .	



KEY
пакой	комната	комнату	
у пакой .	в комната .	в комнату .	



KEY
вадзіцы	водице	водицы	
цяпер гэткай вадзіцы	сейчас *гэткай водице	теперь этакой водицы	
гэткай вадзіцы ,	*гэткай водице ,	этакой водицы ,	



KEY
а.	а	а.	
а. .	а .	а. лукашенко	



KEY
буракі	свёклы	свеклу	
не люблю буракі	не *люблю свёклы	не люблю свеклу	
люблю буракі .	*люблю свёклы .	люблю свеклу .	



KEY
звязнай	связной	связным	
артыкул напісаны звязнай	артикул написанный связной	статья написана связным	
напісаны звязнай сучаснай	написанный связной современным	написана связным современным	



KEY
гэта	эта	это	
ўсё гэта .	всё эта .	уничтожь это всё	
гэта што	эта что	это что	
— гэта рэалізацыя	— эта реализация	— это реализация	
гэта маё	эта моя	это моя	
ведаеш гэта ?	*ведаеш эта ?	ты это знаешь	
чый гэта ровар	чей эта *ровар	чей это велосипед	
ўсё гэта пераклаў	всё эта переложил	всё это перевёл	
гэта пераклаў ,	эта переложил ,	это перевёл ,	
гэта ўсё	эта всё	это всё	
гэта было	эта бывше	это было	
гэта было яшчэ	эта бывше ещё	это было ещё	
словамі гэта апісаць	словами эта описать	словами это описать	
гэта таму	эта потому	это потому	
гэта гэта .	бы эта *зрабіў	бы это .	
гэта .	эта *зрабіў	это .	
— гэта музычны	— эта музыкальный	— это музыкальный	
гэта два	эта два	это два	
то гэта не	то эта не	то это не	
гэта пошта	эта почта	это почта	
гэта не	эта не	это не	
гэта не	эта не	это не	
гэта цікава	эта интересно	это интересно	
. гэта невялічкая	. эта *невялічкая	. это небольшая	
гэта невялічкая праграма	эта *невялічкая программа	это небольшая программа	
гэта царква	эта церковь	это церковь	
гэта нічога	эта ничего	это ничего	
гэта хітрасць	эта хитрость	это хитрость	
гэта дакладна што	эта точно то	это в точности	
гэта не	эта не	это не	
 гэта не	 эта не	вот это -	
вось гэта —	вот эта —	 это не	
вось гэта —	вот эта —	вот это -	
гэта — нож	эта — нож	это - нож	
ці гэта добра	или эта хорошо	ли это .	
за гэта ,	за эта ,	за это ,	
гэта не	эта не	это не	
— гэта выдуманая	— эта вымышленная	— это вымышленное	
гэта выдуманая істота	эта вымышленная *істота	это вымышленное существо	
гэта не	эта не	это не	
 гэта не	 эта не	. это свёкла	
. гэта кроў	. эта свёкла	 это не	
. гэта кроў	. эта свёкла	. это свёкла	
— гэта выдуманая	— эта вымышленная	— это выдуманное	
гэта выдуманая істота	эта вымышленная *істота	это выдуманное существо	
гэта было	эта бывше	это не	
гэта залежыць	эта зависит	это зависит	
зрабіць гэта сам	*зрабіць эта сам	сделать это сам	
гэта толькі	эта только	это только	
гэта не	эта не	это не	
мяне гэта не	меня эта не	меня это не	
— гэта свабода	— эта свобода	— это свобода	
— гэта свабода	— эта свобода	. это есть	
. гэта ёсць	. эта давай	— это свобода	
. гэта ёсць	. эта давай	. это есть	
гэта самая	эта самая	это самая	
гэта браян	эта *браян	это брайан	
гэта браян рок	эта *браян *рок	это брайан рок	
яны гэта робяць	они эта *робяць	они это и	
— гэта няцотныя	— эта нечётные	— это нечётные	
я купіў гэта	я *купіў эта	я купил это	
купіў гэта на	*купіў эта на	купил это на	
— гэта дзяржаўная	— эта государственная	— это государственная	
гэта гісторыя	эта история	это история	
гэта вёска	эта деревня	это деревня	
гэта канадскія гэта	эта *канадскія гроше	это канадские деньги	
мне гэта вытрымаць	мне эта выдержать	мне это выдержать	
абмеркаваць гэта з	*абмеркаваць эта с	обсудить это с	
гэта ежа	эта еда	это еда	
мне гэта сказаць	мне эта *сказаць	мне это сказать	
гэта сказаць	эта *сказаць	это сказать	
усё гэта	всё эта	все это	
усё гэта толькі	всё эта только	все это только	
гэта цікавая	эта интересная	это интересная	
гэта зроблена	эта *зроблена	это сделано	
гэта зроблена ў	эта *зроблена в	это сделано в	
бяры гэта блізка	бери эта близко	бери это близко	
. гэта б	. эта когда	. это как	
гэта вельмі	эта очень	это очень	
гэта не	эта не	это не	
гэта таму	эта потому	это потому	
як гэта ты	как эта ты	как это ты	
гэта быў	эта был	это был	
гэта таму	эта потому	это потому	
што гэта .	что эта .	что это .	
была гэта субота	была эта суббота	была это суббота	
 гэта анімэ	 эта *анімэ	. это япония	
гэта анімэ пра	эта *анімэ о	это аниме про	
. гэта гэта	. эта япония	. это япония	
адкуль гэта прыйшло	откуда эта пришло	откуда это пришло	
гэта мае	эта мои	это мои	
гэта сіні	эта синий	это синий	
што гэта за	что эта за	что это за	
гадоў — гэта	годов — эта	лет - это	
— гэта доўгі	— эта длинный	- это долгий	
гэта доўгі тэрмін	эта длинный термин	это долгий срок	
юэбін — гэта	*юэбін — эта	юэбин - это	
— гэта адзін	— эта один	- это одна	
гэта адзін з	эта один с	это одна из	



KEY
гэтае	этой	этот	
і любляць гэтае	и *любляць этой	и любят этот	
любляць гэтае свята	*любляць этой свято	любят этот праздник	



KEY
бадзёры	бодрый	бодрящий	
бадзёры перазвон	бодрый перезвон	бодрящий перезвон	



KEY
парнаграфію	детскую	детской	
дзіцячую парнаграфію .	о детскую порнографию	о детской порнографии	
парнаграфію .	детскую порнографию	детской порнографии	



KEY
турэцкай	турецкой	турецком	
на турэцкай і	на турецкой и	на турецком и	



KEY
народа	народа	народу	
бліжэй народа .	к народа .	к народу .	



KEY
надзеі	надежде	надежды	
свае надзеі беларускі	свои надежде белорусский	свои надежды белорусский	



KEY
вывучаць	изучат	изучать	
каб вывучаць нямецкую	чтобы изучат немецкую	чтобы изучать немецкий	
вывучаць нямецкую .	изучат немецкую .	изучать немецкий .	



KEY
песнямі	пёснями	песнями	
абмену песнямі ?	обмена пёснями ?	обмена песнями ?	



KEY
паклёп	клевета	клевещет	
мяне паклёп	меня клевета	меня клевещет	



KEY
мой	мой	мою	
хочаш ведаць мой	хочешь *ведаць мой	хочешь знать мою	
ведаць мой сакрэт	*ведаць мой *сакрэт	знать мою тайну	



KEY
ёй	ней	ей	
вырашыў расказаць ёй	*вырашыў *расказаць ней	я рассказать ей	
расказаць ёй ,	*расказаць ней ,	рассказать ей ,	
я купіла ёй	я *купіла ней	я купила ей	
купіла ёй ёй	*купіла ней хороший	купила ей хороший	
падараваў ёй ляльку	*падараваў ней *ляльку	подарил ей куклу	
ёй ляльку .	ней *ляльку .	ей куклу .	
але ёй рана	но ней рано	но ей рано	



KEY
кніга	книга	книжка	
мая кніга ?	мая книга ?	моя книжка ?	



KEY
кожная	каждая	каждой	
кожная краіна мае	каждая страна мои	каждой страны есть	



KEY
такі	токи	таким	
такі вядомы ,	токи известный ,	таким известным ,	



KEY
заняпад	упадок	упадке	
і заняпад дзяржаў	и упадок государств	и упадке .	



KEY
рускай	русской	русского	
з рускай на	с русской на	с русского на	



KEY
раней	ранее	раньше	
ніколі раней не	никогда ранее не	никогда раньше не	
як раней .	как ранее .	как раньше .	
раней я	ранее я	раньше я	
яго раней .	его ранее .	его раньше .	
але раней ён	но ранее он	но раньше он	



KEY
сотні	сотне	сотни	
выкрадаюць сотні людзей	*выкрадаюць сотне людей	похищают сотни людей	



KEY
згвалтаванне	изнасилование	изнасиловании	
сведчанні пра згвалтаванне	свидетельстве о изнасилование	свидетельства об изнасиловании	
пра згвалтаванне дзіцяці	о изнасилование ребёнке	об изнасиловании ребёнка	
згвалтаванне дзіцяці ,	изнасилование ребёнке ,	изнасиловании ребёнка ,	



KEY
зачыніце	закроете	закройте	
зачыніце акно	закроете *акно	закройте окно	
зачыніце акно .	закроете *акно .	закройте окно .	



KEY
важныя	важные	важны	
вельмі важныя для	очень важные для	очень важны для	



KEY
гэты	эта	эту	
цярпець гэты боль	терпеть эта боль	терпеть эту боль	



KEY
гэтыя	эти	это	
гэтыя лекі	эти леки	это лекарство	
гэтыя лекі дапамогуць	эти леки помогут	это лекарство тебе	



KEY
яе	неё	её	
пра яе сказ	о неё предложение	о её предложении	
яе сказ ?	неё предложение ?	её предложении ?	
пра яе прапанову	о неё предложение	о её предложении	
яе прапанову ?	неё предложение ?	её предложении ?	
на яе дапамогу	на неё помощь	на её помощь	
падабаюцца яе песні	*падабаюцца неё пёсне	нравятся её песни	
яе песні ?	неё пёсне ?	её песни ?	
у яе перакладзе	в неё переводе	в её переводе	
бэці яе забіла	*бэці неё убила	убила её .	
я яе куплю	я неё покупку	я её куплю	
яе куплю ?	неё покупку ?	её куплю ?	
я ведаю яе	я *ведаю неё	я знаю её	
ведаю яе адрэсу	*ведаю неё *адрэсу	знаю её адрес	
яе адрэсу .	неё *адрэсу .	её адрес .	
мог яе зразумець	мог неё понять	мог её понять	
што яе дачка	что неё дочь	что её дочь	
ўсе яе аднакласнікі	все неё одноклассники	все её одноклассники	



KEY
светла-карычневыя	светло-коричневые	светло-каштановые	
і светла-карычневыя валасы	и светло-коричневые волосы	и светло-каштановые волосы	



KEY
вялікі	большой	большая	
вельмі вялікі .	очень большой .	очень большая .	



KEY
важная	важная	важны	
і агародніна важная	и овощ важная	и овощи важны	
агародніна важная для	овощ важная для	овощи важны для	



KEY
гады	гады	года	
два гады гады	два гады старший	два года старше	



KEY
паляцеў	улетел	полетел	
б паляцеў да	бы улетел к	бы полетел к	



KEY
зоркі	звезды	звёзды	
зоркі раскіданыя	звезды *раскіданыя	звёзды разбросаны	
зоркі раскіданыя па	звезды *раскіданыя по	звёзды разбросаны по	
зоркі зоркі	звезды плохо	звёзды плохо	
некаторыя зоркі	некоторые звезды	некоторый звёзды	
некаторыя зоркі амаль	некоторые звезды почти	некоторый звёзды почти	



KEY
адмерай	отмерь	отрежь	
сем раз адмерай	семь однажды отмерь	один раз отрежь	



KEY
яго	его	него	
у яго	в его	у него	
у яго	в его	у него	
у яго	в его	у него	



KEY
сведчанні	свидетельстве	свидетельства	
суд сведчанні пра	суд свидетельстве о	суд свидетельства об	
сведчанні пра згвалтаванне	свидетельстве о изнасилование	свидетельства об изнасиловании	



KEY
яна	яна	она	
яна размаўляе з	яна *размаўляе с	она разговаривает с	
яна часта	яна часто	она часто	
яна аблізвала лыжку	яна *аблізвала ложку	она облизывала ложку	
яна вучыцца	яна *вучыцца	она учится	
яна вучыцца плаваць	яна *вучыцца *плаваць	она учится плавать	
яна пераклала ліст	яна переложила лист	она перевела письмо	
? яна яна	? яна в	? она у	
яна працягнула працаваць	яна продолжила *працаваць	она продолжала работать	
яна абдурыла яго	яна одурачила его	она обдурила его	
яна заплятала	яна *заплятала	она заплетала	
яна заплятала свае	яна *заплятала свои	она заплетала свои	
яна адрэдагавала артыкул	яна *адрэдагавала артикул	она отредактировала статью	



KEY
польшчы	польше	польши	
сталіцай польшчы .	столицей польше .	столицей польши .	



KEY
роўна	ровно	равно	
ўсё роўна ,	всё ровно ,	всё равно ,	



KEY
верыць	верить	верит	
не верыць у	не верить в	не верит в	



KEY
парку	парк	парке	
у парку .	в парк .	в парке .	
у гэтым парку	в этим парк	в этом парке	
гэтым парку шмат	этим парк много	этом парке много	



KEY
перакладуць	переложат	переведут	
сказ перакладуць .	предложение переложат .	предложение переведут .	



KEY
блакітнае	голубой	голубое	
неба блакітнае !	небо голубой !	небо голубое !	



KEY
люстэрка	зеркало	зеркальце	
разбіўшы люстэрка ,	разбив зеркало ,	разбив зеркальце ,	



KEY
рака	рака	река	
найдаўжэйшая рака ў	*найдаўжэйшая рака в	длинная река в	



KEY
новая	новая	нова	
не новая ,	не новая ,	не нова ,	



KEY
.	.	а.	
. лукашэнка ,	. *лукашэнка предложений	а. лукашенко сказал	
( ( .	( а .	. ( а.	



KEY
нашым	нашими	нашим	
заўсёды адпавядае нашым	всегда *адпавядае нашими	всегда соответствует нашим	
адпавядае нашым чаканням	*адпавядае нашими ожиданиям	соответствует нашим ожиданиям	



KEY
садзе	саде	саду	
ў садзе .	в саде .	в саду .	
ў садзе ,	в саде ,	в саду ,	



KEY
—	эта	это	
гісторыя — —	общество — эта	общества - это	
— — гэта	— эта цитата	— это цитата	



KEY
я	едет	ездит	
’ я штогод	ежегодно едет в	год ездит в	



KEY
слова	слово	слова	
такога слова ў	такого слово в	такого слова в	
частка слова «	часть слово «	часть слова ``	
слова « не	слово « не	слова `` нет	
слоўніку няма слова	словаре нету слово	словаре нет слова	
няма слова «	нету слово «	нет слова «	
прапусціце ані слова	*прапусціце ничуть слово	пропустите ни слова	
ані слова ,	ничуть слово ,	ни слова ,	
частка слова «	часть слово «	часть слова ``	
слова « «	слово « нету	слова `` нет	



KEY
ўсе	все	всем	
ў эўропе ўсе	западной *эўропе все	западной европе всем	
эўропе ўсе ўсе	*эўропе все абсолютно	европе всем совершенно	



KEY
рускай	русским	русском	
ў рускай мове	в русским языке	в русском языке	



KEY
неба	небо	неба	
у неба	в небо	у неба	
у неба ёсць	в небо давай	у неба есть	
аж да неба	*аж к небо	аж до неба	
да неба !	к небо !	до неба !	



KEY
гэта	эта	этот	
гэта гарбата	эта горбато	этот чай	



KEY
.	несчастья	несчастий	
год год .	семь год несчастья	семь лет несчастий	



KEY
тэрміновая	срочная	срочное	
справа тэрміновая .	справа срочная .	дело срочное .	



KEY
як	как	каково	
як гэта—быць .	как эта—быть .	каково это —	



KEY
непрымальныя	неприемлемые	неприемлемы	
нас непрымальныя знявага	нас неприемлемые *знявага	нас неприемлемы ``	



KEY
меркаванні	мнении	мнения	
абсалютна розныя меркаванні	абсолютно разные мнении	абсолютно различных мнения	
розныя меркаванні .	разные мнении .	различных мнения .	



KEY
мужу	муже	мужу	
свайму мужу выканаць	своему муже выполнить	своему мужу выполнить	



KEY
пакоі	комнате	комнаты	
два вольныя пакоі	два *вольныя комнате	две свободные комнаты	
вольныя пакоі .	*вольныя комнате .	свободные комнаты .	



KEY
два	два	две	
доме два вольныя	доме два *вольныя	доме две свободные	
два вольныя пакоі	два *вольныя комнате	две свободные комнаты	
папрасіў два кубкі	попросил два кубки	попросил две чашки	
два кубкі гарбаты	два кубки горбатый	две чашки и	



KEY
татарскай	татарским	татарском	
на татарскай мове	на татарским языке	на татарском языке	



KEY
метра	метра	метро	
у метра чамусьці	в метра почему-то	в метро почему-то	



KEY
чацвёртым	четвёртым	четвёртом	
на чацвёртым паверсе	на четвёртым этаже	на четвёртом этаже	



KEY
хлусіць	врать	врёт	
ён хлусіць ,	он врать ,	он врёт ,	



KEY
заняты	занятый	занят	
яўген заняты перакладам	евгений занятый переводом	евгений занят переводом	



KEY
выдуманая	вымышленная	вымышленное	
— гэта выдуманая	— эта вымышленная	— это вымышленное	
гэта выдуманая істота	эта вымышленная *істота	это вымышленное существо	
выдуманая істота .	вымышленная *істота .	вымышленное существо .	



KEY
гэтае	этого	этот	
гэтае дзіця	этого ребёнок	этот ребёнок	



KEY
ні	ни	не	
 я ні	 я ни	в чём не	



KEY
песня	пёсня	песня	
гэта песня заўжды	эта пёсня всегда	эта песня всегда	



KEY
найлепшага	наилучшего	лучшего	
складальнік найлепшага руска-чэскага	составитель наилучшего русско-*чэскага	составитель лучшего русско-чешского	
найлепшага руска-чэскага слоўніка	наилучшего русско-*чэскага словаря	лучшего русско-чешского словаря	



KEY
сваёй	своей	своими	
вядомая сваёй садавінай	известная своей *садавінай	славится своими фруктами	



