,	*чжуанцзы	,	28
ведаю	*ведаю	знаю	20
люблю	*люблю	люблю	14
,	*піша	,	13
люся	*люся	люся	12
клава	*клава	клава	10
ведае	*ведае	знает	10
мушу	*мушу	должен	9
бачыў	*бачыў	видел	7
знайсці	*знайсці	найти	7
твой	*твой	твой	7
су	*су	су	6
,	*кансервы	,	6
львоў	*львоў	львов	6
«	*замасціць	«	6
яані	*яані	яани	6
падабаецца	*падабаецца	нравится	6
чуў	*чуў	слышал	6
цао	*цао	цао	6
зрабіць	*зрабіць	сделать	5
,	*зярно	,	5
працуе	*працуе	работает	5
педафілы	*педафілы	педофилы	5
дзякуй	*дзякуй	спасибо	5
нюнорска	*нюнорска	нюнорска	5
ўмееш	*ўмееш	умеешь	5
і	*празрэнні	и	5
і	*дэзарганізаваць	и	5
працаваць	*працаваць	работать	5
бачыць	*бачыць	видеть	5
бэці	*бэці	бетти	5
вырашыць	*вырашыць	решить	5
заспяваем	*заспяваем	споём	4
спаць	*спаць	спать	4
люсі	*люсі	люси	4
,	*чжуанцзы	бабочка	4
роджэр	*роджэр	роджер	4
народ	*абраны	народ	4
есці	*есці	есть	4
йен	*йен	иен	4
пісаць	*пісаць	писать	4
твая	*твая	твоя	4
істота	*істота	существо	4
ці	*чжуанцзы	,	4
з	*засноўнікаў	из	3
купляйце	*купляйце	покупайте	3
бегаць	*бегаць	бегать	3
вучыцца	*вучыцца	учится	3
ало	*ало	алло	3
задаваць	*задаваць	задавать	3
адрозніваецца	*адрозніваецца	отличается	3
згадваць	*згадваць	вспоминать	3
абама	*абама	обама	3
«	*ну	«	3
чытаць	*чытаць	читать	3
адмаўляецца	*адмаўляецца	угостить	3
вывучаў	*вывучаў	изучал	3
і	*грэю	и	3
вольныя	*вольныя	свободные	3
цзыю	*цзыю	цзыю	3
запрошваць	*запрошваць	приглашать	3
чжуанцзы	*чжуанцзы	чжуан-цзы	3
саромейся	*саромейся	стесняйся	3
ці	*чжуанцзы	что	3
казаў	*казаў	говорил	3
крынічным	*крынічным	исходными	3
есці	*есці	завтрак	3
здарылася	*здарылася	случилось	3
плаваць	*плаваць	плавать	3
смяяліся	*смяяліся	смеялись	3
клясе	*клясе	классе	3
пагаварыць	*пагаварыць	поговорить	3
мова	*фарсі	язык	3
прысніў	*прысніў	,	3
зайздросціла	*зайздросціла	завидовала	3
рон	*рон	рон	3
дазваляе	*дазваляе	выбрать	3
звуць	*звуць	зовут	3
выкарыстоўваецца	*выкарыстоўваецца	используется	3
хаця	*хаця	хотя	3
дагэтуль	*дагэтуль	всё	3
паміраць	*паміраць	умирать	3
бэна	*бэна	бена	3
еў	*еў	дракон	3
дарэнда	*дарэнда	доренда	3
кенам	*кенам	кен	3
ведалі	*ведалі	знали	3
існуе	*існуе	существует	3
сакрэт	*сакрэт	знать	3
дакранулася	*дакранулася	дотронулось	3
выйгралі	*выйгралі	выиграли	3
пашанцавала	*пашанцавала	посчастливилось	3
выкарыстоўвалі	*выкарыстоўвалі	языка	3
свеціць	*свеціць	светит	3
вокны	*вокны	окна	3
сустрэў	*сустрэў	встретил	3
вырашыў	*вырашыў	решил	3
чакаў	*чакаў	ждал	3
ці	*чжуанцзы	которому	3
ведаеш	*ведаеш	знаешь	3
абмеркаваць	*абмеркаваць	обсудить	3
паабяцалі	*паабяцалі	пообещали	3
падабаюцца	*падабаюцца	нравятся	3
вывучае	*вывучае	изучает	3
размаўляюць	*размаўляюць	говорят	2
яўляецца	*яўляецца	воскресенье	2
маркс	*маркс	маркс	2
іўрыт	*іўрыт	иврит	2
разумнейшы	*разумнейшы	умнее	2
гуляць	*гуляць	играть	2
нла	*нла	нло	2
без	*клавы	без	2
чытаеш	*чытаеш	читаешь	2
сустрэць	*сустрэць	встретить	2
«	*замасціць	»	2
люсе	*люсе	люсе	2
іграць	*іграць	играть	2
папера	*папера	бумага	2
мілер	*мілер	миллер	2
зроблена	*зроблена	сделано	2
называецца	*называецца	называется	2
прэзыдэнт	*прэзыдэнт	президент	2
абажаю	*абажаю	обожаю	2
выкарыстоўваць	*дазваляе	позволяет	2
забіваюць	*забіваюць	кончают	2
«	*замасціць	области	2
ціма	*ціма	тима	2
ці	*чжуанцзы	он	2
выкарыстоўваць	*выкарыстоўваць	использовать	2
разумею	*разумею	понимаю	2
вашыя	*вашыя	ваши	2
ў	*хмяльніцкі	в	2
шукала	*шукала	искала	2
дантэ	*дантэ	данте	2
кнопки	*кнопки	кнопки	2
дурыце	*дурыце	дурите	2
выкрадалі	*выкрадалі	похищали	2
,	*чжуанцзы	приснилось	2
жоднага	*жоднага	одного	2
сцвярджае	*сцвярджае	утверждает	2
джэка	*джэка	джеком	2
заклей	*заклей	заклей	2
пярсідская	*пярсідская	язык	2
апавядаў	*апавядаў	рассказывал	2
львове	*львове	львове	2
праносіць	*праносіць	проносить	2
нюнорска	*нюнорска	поскольку	2
і	*найноўшыя	демократии	2
вучыў	*вучыў	учил	2
мусім	*мусім	должны	2
сайце	*сайце	сайте	2
іншапланецяне	*іншапланецяне	инопланетяне	2
злезлі	*злезлі	слезли	2
патчам	*патчам	для	2
рыхтуе	*рыхтуе	готовит	2
галандскай	*галандскай	голландского	2
зроблены	*зроблены	сделан	2
срэбны	*срэбны	серебряную	2
шарля	*шарля	шарля	2
прашчае	*прашчае	прощает	2
прашчаецца	*прашчаецца	прощается	2
перо	*перо	перро	2
фарамп	*фарамп	фарамп	2
яўляецца	*яўляецца	является	2
падобнае	*падобнае	похожее	2
ведае	*ведае	собственном	2
валодае	*валодае	обладает	2
вучышся	*вучышся	.	2
засыхалі	*засыхалі	засыхали	2
гма	*гма	гмо	2
сродкі	*блытаюць	средства	2
вольны	*вольны	свободное	2
і	*найноўшыя	но	2
,	*піша	бабочка	2
ён	*наснілася	снилось	2
сумуем	*сумуем	скучаем	2
слухаць	*слухаць	слушать	2
знайшоў	*знайшоў	нашёл	2
прысніў	*прысніў	он	2
кашалёк	*згубіў	кошелёк	2
разбіраецца	*разбіраецца	разбирается	2
туман	*туман	туман	2
думаеш	*думаеш	думаешь	2
ісці	*баіцца	идти	2
жадаю	*жадаю	желаю	2
рок	*рок	рок	2
новы	*купіў	для	2
лазанью	*лазанью	лазанью	2
адрэсу	*адрэсу	адрес	2
кашалёк	*згубi*ла	кошелёк	2
цямнее	*цямнее	темнеет	2
ніводнага	*ніводнага	одного	2
супадае	*супадае	совпадает	2
дакраніся	*дакраніся	дотронься	2
мандарыны	*мандарыны	мандарины	2
купляйце	*купляйце	белорусское	2
зрабіў	*зрабіў	сделал	2
юэбін	*юэбін	юэбин	2
выразаў	*выразаў	вырезал	2
давядзецца	*давядзецца	придётся	2
казахскай	*казахскай	казахском	2
мачыць	*мачыць	в	2
цёмны	*цёмны	тёмную	2
найяскравейшая	*найяскравейшая	наиярчайшая	2
любіць	*любіць	любит	2
знаходзіцца	*знаходзіцца	находится	2
сакрэт	*сакрэт	секрет	2
адрэж	*адрэж	отрежь	2
сказаць	*сказаць	сказать	2
думае	*думае	,	2
акторам	*акторам	актером	2
выбраць	*выбраць	режим	2
патэлефанаваць	*патэлефанаваць	позвонить	2
мроя	*мроя	мечта	2
ісландскім	*ісландскім	исландским	2
пашанцавала	*пашанцавала	повезло	2
шы	*шы	ши	2
майк	*майк	майк	2
—	*о	—	2
чытаў	*чытаў	ни	2
дзверы	*дзверы	дверь	2
—	*блог	—	2
звальняцца	*звальняцца	работникам	2
пераскаквае	*пераскаквае	перепрыгивает	2
развешвае	*развешвае	развешивает	2
прытворымся	*прытворымся	притворимся	2
ускладае	*ускладае	надежды	2
татоэбе	*татоэбе	татоэбе	2
меў	*меў	была	2
адрэдагавала	*адрэдагавала	отредактировала	2
застаецца	*застаецца	ещё	2
абажае	*абажае	обожает	2
жырафаў	*жырафаў	жирафов	2
сарваныя	*сарваныя	сорванные	2
з	*імперыялістамі	с	2
бегае	*бегае	бегает	2
сніць	*сніць	он	2
пярсідская	*пярсідская	персидский	2
выкрадаюць	*выкрадаюць	похищают	2
здымалі	*здымалі	снимали	2
даводзілі	*даводзілі	доказывали	2
ненавідзела	*ненавідзела	ненавидела	2
адшукаем	*адшукаем	разыщем	2
асвойваецца	*асвойваецца	осваивается	2
лічыць	*лічыць	считает	2
замяняем	*замяняем	заменяем	2
перастрыбнуў	*перастрыбнуў	прыгнул	2
інапланецянамі	*інапланецянамі	инопланетянами	2
півам	*чарапічным	пивом	2
спрошчвае	*спрошчвае	упрощает	2
што	*наснілася	он	2
гаворыць	*гаворыць	говорит	2
спакушаюць	*спакушаюць	совращают	2
мандалай	*мандалай	мандалай	2
патрэбны	*патрэбны	нужен	2
каптурко	*каптурко	шапочко	2
любіў	*любіў	любил	2
памыць	*памыць	помыть	2
сайту	*сайту	основателей	2
еш	*еш	ещё	2
рэакцыю	*рэакцыю	реакцию	2
перакладаю	*перакладаю	перевожу	2
прамільгнула	*прамільгнула	промелькнуло	2
пракампасціруйце	*пракампасціруйце	прокомпостируйте	2
ўнадзілася	*ўнадзілася	повадилась	2
цэліцеся	*цэліцеся	целитесь	2
здавалася	*здавалася	бы	2
з	*вылез	из	2
індустрыялізацыя	*індустрыялізацыя	индустриализация	2
кракаў	*кракаў	был	2
паўнаэкранных	*паўнаэкранных	полноэкранных	2
пазнаёміліся	*пазнаёміліся	познакомились	2
збіраюся	*збіраюся	собираюсь	2
кахаю	*кахаю	люблю	2
павiнны	*павi*нны	в	2
дырэктарам	*тэт-а-*тэт	директором	2
гавары	*гавары	говори	2
бракуе	*бракуе	нас	2
браян	*браян	брайан	2
салмана	*салмана	салмана	2
найдаўжэйшае	*найдаўжэйшае	самое	2
пройдзе	*пройдзе	пройдёт	2
чапай	*чапай	трогай	2
дагэтуль	*дагэтуль	до	2
нарадзілася	*нарадзілася	родилась	2
.	*зрабіў	.	2
таксама	*чжуанцзы	он	2
наставай	*наставай	настиной	2
праспрагаць	*праспрагаць	проспрягать	2
праплывалі	*праплывалі	проплывали	2
завецца	*завецца	называется	2
джэк	*джэк	джек	2
характэрных	*характэрных	характерных	2
дваццаць	*дваццаць	десять	2
московиц	*москови*ц	московиц	2
іслам	*іслам	ислам	2
спрабаваў	*спрабаваў	пытался	2
нюнорска	*нюнорска	для	2
забівае	*забівае	убивает	2
пацалаваў	*пацалаваў	поцеловал	2
ежы	*прыгатаваннем	пищи	2
рушдзі	*рушдзі	рушди	2
аперацыйная	*выкарыстоўваемая	всего	2
ідэальны	*ідэальны	идеальный	2
здраджваў	*здраджваў	предавал	2
маеце	*маеце	имеете	2
«	*ведаю	«	2
адпавядае	*адпавядае	соответствует	2
акно	*акно	окно	2
мюрыэл	*мюрыэл	мюриэл	2
радактараў	*радактараў	редакторов	2
товада	*товада	товада	2
трасці	*трасці	трясти	2
размаўляе	*размаўляе	разговаривает	2
акна	*акна	окно	2
дасцін	*дасцін	дастин	2
лётае	*лётае	летает	2
бачыш	*бачыш	видишь	2
нагадвае	*нагадвае	напоминает	2
ўзяў	*ўзяў	взял	2
фнорд	*фнорд	фнорд	2
прадаюцца	*прадаюцца	продаются	2
чакаў	*чакаў	ожидал	2
годы	*годы	годах	2
нептуна	*нептуна	нептуна	2
пакуль	*высушу	пока	2
прагноза	*прагноза	прогноза	2
ён	*наснілася	он	2
бацька	*любіць	отец	2
ці	*чжуанцзы	кто	2
і	*выйграйце	и	2
аконца	*аконца	оконце	2
адчыняй	*адчыняй	открывай	2
тэрэза	*тэрэза	тереза	2
выпей	*выпей	чаю	2
здаецца	*здаецца	кажется	2
вырашыць	*вырашыць	эту	2
афарыст	*афарыст	он	2
суседзі	*казалі	с	2
пачаставаць	*пачаставаць	работников	2
асноўваецца	*асноўваецца	основывается	2
няўжо	*няўжо	неужели	2
вандраваў	*вандраваў	путешествовал	2
чжуанцзы	*чжуанцзы	он	2
адрамантаваць	*адрамантаваць	починить	2
чытаў	*чытаў	читал	2
кнігу	*купіў	книгу	2
гаварыць	*гаварыць	говорить	2
расказаць	*расказаць	рассказать	2
падобны	*падобны	похоже	2
найчасцей	*найчасцей	чаще	2
спазнаеш	*спазнаеш	познаешь	2
прыгажэй	*прыгажэй	красивее	2
загарэлася	*загарэлася	загорелась	2
гучней	*гучней	громче	2
рэкламавалі	*рэкламавалі	с	2
маеце	*маеце	вас	2
вучышся	*вучышся	день	2
адлюстроўваўся	*адлюстроўваўся	отражалась	2
гуцы	*гуцы	лишь	2
называецца	*называецца	функция	2
пятнаццаць	*пятнаццаць	пятнадцать	1
слухаеце	*слухаеце	слушаете	1
нарадзіўся	*нарадзіўся	родился	1
наводзіць	*наводзіць	клевещет	1
размаўляю	*размаўляю	говорю	1
марнаваць	*марнаваць	можно	1
патрапілі	*патрапілі	попали	1
смяяліся	*смяяліся	девочкой	1
здрадзіў	*здрадзіў	ты	1
,	*чжуанцзы	он	1
наняты	*наняты	мерин	1
напаўняла	*напаўняла	наполняло	1
распрацаваная	*распрацаваная	разработана	1
сато	*сато	сато	1
невялічкая	*невялічкая	.	1
дагэтуль	*дагэтуль	по-прежнему	1
натхніць	*натхніць	на	1
шыпоў	*шыпоў	шипов	1
штосьці	*штосьці	что-то	1
доўга	*праснуўшыся	проснувшись	1
і	*найноўшыя	гнилые	1
твая	*твая	твоё	1
садзіць	*садзіць	сажает	1
ззяюць	*ззяюць	сияют	1
слухайце	*слухайце	слушайте	1
згубіў	*згубіў	потерял	1
хапае	*хапае	нет	1
іскрыць	*іскрыць	искрит	1
размаўляю	*размаўляю	разговариваю	1
пытарен	*пытарен	выплакала	1
найпрыгажэйшыя	*найпрыгажэйшыя	самые	1
чалавеканенавісных	*чалавеканенавісных	человеконенавистнических	1
люблю	*люблю		1
выставу	*выставу	«	1
раскіданыя	*раскіданыя	звёзды	1
мухамад	*мухамад	мухаммед	1
распаўсюджвайце	*распаўсюджвайце	распространяйте	1
ці	*чжуанцзы	долго	1
пазнаёміліся	*пазнаёміліся	мои	1
прагноза	*прагноза		1
чытаць	*чытаць	есть	1
хаця	*хаця	не	1
таннейшых	*таннейшых	нет	1
сніць	*сніць	которому	1
сцерці	*сцерці	быть	1
парламентская	*парламентская	парламентская	1
прыдзе	*прыдзе	придёт	1
ён	*наснілася	же	1
пачытаць	*пачытаць	почитать	1
спяць	*спяць	вместе	1
пабачыць	*пабачыць	увидеть	1
гледжання	*гледжання	зрения	1
выкарыстоўваць	*дазваляе	использовать	1
кенам	*кенам	-	1
патрэбныя	*патрэбныя	нужны	1
можа	*зрабіць	хуже	1
моё	*моё	мой	1
,	*здаецца	кажется	1
здарыўся	*здарыўся	произошёл	1
па	*засудзяць	по	1
цзыю	*цзыю	ши	1
ці	*чжуанцзы	который	1
горкая	*горкая	невкусный	1
арганізаваць	*арганізаваць	устроить	1
ня	*ня	в	1
немагчымы	*немагчымы	невозможен	1
траціў	*траціў	тратил	1
таксама	*чжуанцзы	которому	1
адчуваў	*адчуваў	чувствовал	1
чакае	*чакае	ждет	1
гатаваць	*гатаваць	готовить	1
выкарыстоўвалі	*выкарыстоўвалі	создатели	1
леў	*леў	лев	1
дадаваць	*дадаваць	добавлять	1
размаўляе	*размаўляе	говорит	1
даведаецца	*даведаецца	узнает	1
адзна	*адзна	из	1
серыйная	*серыйная	серийная	1
казалі	*казалі	же	1
на	*паглядзеў	на	1
дырку	*дырку	дырку	1
патэлефанаваць	*патэлефанаваць	господину	1
ці	*чжуанцзы	пишет	1
меў	*меў	меня	1
хапае	*хапае	хватает	1
паглядзі	*паглядзі	посмотри	1
мова	*фарсі	фарси	1
ускладае	*ускладае	возлагает	1
жоднага	*жоднага	ни	1
водзіць	*водзіць	водит	1
твае	*твае	овцы	1
нараджаюцца	*нараджаюцца	разумом	1
тваю	*тваю	твою	1
загойваюцца	*загойваюцца	.	1
прасты	*прасты	...	1
перазваню	*перазваню	перезвоню	1
ведалі	*ведалі	в	1
разлічваць	*разлічваць	рассчитывать	1
метро	*грушаўка	новые	1
дадаваць	*дадаваць	на	1
чакайце	*чакайце	ждите	1
опцыя	*опцыя	опция	1
па	*засудзяць	их	1
вэбмайстры	*вэбмайстры	вебмастеры	1
зрабіў	*зрабіў	ошибся	1
сустракаюцца	*сустракаюцца	встречаются	1
люблю	*люблю	свеклу	1
маршалізаваных	*маршалізаваных	маршаллизованных	1
асноўваецца	*асноўваецца	идеология	1
заплятала	*заплятала	свои	1
лі	*лі	начинается	1
пагуляць	*пагуляць	поиграть	1
хадзем	*хадзем	идём	1
сурокі	*сурокі	порчу	1
марыць	*марыць	устроить	1
падабаўляць	*падабаўляць	подобавлять	1
нараджаюцца	*нараджаюцца	и	1
чуеш	*чуеш	ты	1
гма	*гма	являются	1
асноўваецца	*асноўваецца	.	1
ізраіль	*ізраіль	израиль	1
праблемаў	*праблемаў	проблем	1
гарбаткі	*гарбаткі	выпей	1
жарэ	*жарэ	жрёт	1
шупшалмаш	*шупшалмаш	"никогда	1
пашуковая	*пашуковая	поисковая	1
ровар	*ровар	велосипед	1
размаўлялі	*размаўлялі	разговаривали	1
кнігарню	*купіў	в	1
»	*папсавалі	»	1
сайтам	*сайтам	сайтом	1
бракуе	*бракуе	у	1
«	*замасціць	,	1
анімэ	*анімэ	мне	1
ёй	*абяцала	ей	1
прыдумаць	*прыдумаць	придумать	1
знайшлі	*знайшлі	нашли	1
актор	*актор	актер	1
.	*нязгодных	банят	1
тый	*тый	ты	1
есць	*есць	есть	1
абяцаў	*абяцаў	обещал	1
снедае	*снедае	она	1
балела	*балела	болело	1
інапланецяне	*інапланецяне	инопланетяне	1
лічу	*лічу	думаю	1
моё	*моё	отец	1
прэзерватываў	*купіў	презервативов	1
міхалова	*міхалова	михалово	1
з	*спаму	спама	1
дабранач	*дабранач	доброй	1
павiнны	*павi*нны	равными	1
,	*дзякуй	,	1
сакрэт	*сакрэт	тайну	1
твайго	*твайго	всё	1
салоная	*салоная	солёная	1
раблю	*раблю	делаю	1
працоўныя	*працоўныя	трудящиеся	1
ўдзячны	*ўдзячны	благодарен	1
цікавіць	*цікавіць	интересует	1
званым	*званым	называемым	1
.	*досвед	.	1
гэта	*адсвяткаваць	отпраздновать	1
сталася	*сталася	произошло	1
вольны	*вольны	в	1
ядуць	*ядуць	едят	1
яўляюцца	*яўляюцца	прямоугольниками	1
аперацыйная	*выкарыстоўваемая	чаще	1
чытаеш	*чытаеш	познаешь	1
яўляюцца	*яўляюцца	а	1
водзіць	*водзіць	плохо	1
анімэ	*анімэ	,	1
каран	*каран	коран	1
зайздросціць	*зайздросціць		1
і	*дэзарганізаваць	дезорганизовать	1
пабачымся	*пабачымся		1
кашгары	*кашгары	кашгаре	1
коткі	*коткі	кошки	1
дні	*еў	не	1
падтрымліваць	*падтрымліваць	.	1
чжуанцзы	*чжуанцзы	которому	1
найпрыгажэйшыя	*найпрыгажэйшыя	красивые	1
будавалася	*будавалася	строилась	1
чытаючы	*чытаючы	читая	1
імперыялізму	*імперыялізму	империализма	1
афарыст	*афарыст	которому	1
падымецца	*аж	поднимется	1
марнаваць	*марнаваць	терять	1
уш	*уш	не	1
перасунь	*перасунь	передвинь	1
спакушае	*спакушае	совращает	1
яўляліся	*яўляліся	звёздочки	1
ня	*ня	.	1
перамагаем	*перамагаем	побеждаем	1
давялося	*давялося	пришлось	1
вольны	*вольны	свободен	1
гарбату	*гарбату	чай	1
сустракаюцца	*сустракаюцца	ещё	1
дажджыстым	*дажджыстым	.	1
яўляюцца	*яўляюцца	все	1
меркую	*меркую	,	1
выправіш	*выправіш	исправишь	1
тваёй	*тваёй	твоей	1
правым	*правым	правым	1
і	*найноўшыя	установили	1
хуйні	*хуйні	хуйни	1
вядзе	*вядзе	ведёт	1
пазычыць	*пазычыць	одолжить	1
дажджыстым	*дажджыстым	вечером	1
працую	*працую	работаю	1
выбраць	*выбраць	выбрать	1
анімэ	*анімэ		1
забыўся	*забыўся	забыл	1
павiнны	*павi*нны	правах	1
адрэеску	*адрэеску	андрееску	1
закахаўся	*закахаўся	влюбился	1
размаўляюць	*размаўляюць	языке	1
таму	*заразіў	заразил	1
ён	*наснілася	она	1
павольней	*павольней	медленнее	1
я	*насіць	я	1
зсср	*зсср	здравствует	1
па	*засудзяць	самих	1
нигунамат	*ни*гунамат	не	1
марыць	*марыць	маша	1
шукаў	*шукаў	искал	1
галаснейшы	*галаснейшы	.	1
пазнаў	*пазнаў	познал	1
ўмее	*ўмее	умеет	1
творыць	*творыць	творит	1
косы	*косы	косы	1
здарылася	*здарылася	стряслось	1
састарэлых	*састарэлых	людей	1
французкай	*французкай	языке	1
узбекскую	*узбекскую	узбекскую	1
хтосьці	*хтосьці	кто-то	1
свойго	*свойго	.	1
весці	*весці	вести	1
яўляецца	*яўляецца		1
заблукаеш	*заблукаеш	заблудишься	1
адчуў	*адчуў	чувствовал	1
інфекцыя	*інфекцыя	инфекция	1
выкалі	*выкалі	выколи	1
рамашку	*рамашку	ромашку	1
працаваў	*працаваў	работал	1
дазваляе	*дазваляе	»	1
тут	*ляплю	тут	1
казалі	*казалі	говорили	1
уш	*уш	сердечный	1
заданне	*рабі	задание	1
орэст	*орэст	орест	1
патрэбная	*патрэбная	нужна	1
спадарыне	*спадарыне	госпоже	1
яндекс	*яндекс	яндекс	1
паслужыць	*паслужыць	послужит	1
ўмею	*ўмею	умею	1
ставiцца	*ставi*цца	в	1
карысны	*карысны	полезный	1
з	*імперыялістамі	империалистами	1
анімэ	*анімэ	стал	1
накрытая	*накрытая	была	1
фантастыка	*болей	фантастика	1
выпей	*выпей	выпей	1
датычыцца	*датычыцца	касается	1
суседзі	*казалі	говорили	1
сядайце	*сядайце	садитесь	1
сняданак	*сняданак	на	1
мыю	*мыю	стираю	1
выпей	*выпей	,	1
збіраць	*збіраць	собирать	1
паважаюць	*паважаюць	уважают	1
плаваюць	*плаваюць	плавают	1
тый	*тый	откуда	1
памыляецца	*памыляецца	ошибается	1
здаёмыя	*здаёмыя	с	1
складаюць	*складаюць	составляют	1
что	*что	большинства	1
выйграць	*выйграць	выиграть	1
карпаты	*карпаты	карпаты	1
твая	*твая	дело	1
ўзнікла	*ўзнікла	возникла	1
імперыялісты	*імперыялісты	империалисты	1
.	*аватары	аватаре	1
львоўскіх	*львоўскіх	львовских	1
дзякуй	*дзякуй	не"	1
дагэтуль	*дагэтуль	никогда	1
страляючы	*страляючы	стреляя	1
бізнэсмэн	*бізнэсмэн	бизнесмен	1
крывёў	*крывёў	кровей	1
й	*й	и	1
з	*спаму	помощью	1
ён	*стуліў	до	1
здольны	*здольны	способен	1
даведацца	*даведацца	узнать	1
дагэтуль	*дагэтуль	еще	1
душэ	*душэ	душе	1
расказаць	*расказаць	,	1
міхалова	*міхалова	и	1
дацкай	*дацкай	не	1
метро	*грушаўка	метро	1
тайландзе	*тайландзе	таиланде	1
маеце	*маеце	друзей	1
адмаўляць	*адмаўляць	отрицать	1
вучуся	*вучуся	учусь	1
шэкспіра	*шэкспіра	шекспира	1
і	*найноўшыя	куда	1
станавілася	*станавілася	не	1
ніхто	*насамрэч	деле	1
львоўскіх	*львоўскіх	.	1
дык	*дык	так	1
вучуся	*вучуся	занимаюсь	1
«	*ну	похоронили	1
буды	*буды	будды	1
я	*сказала	из	1
адлюстроўвае	*адлюстроўвае	отражает	1
павiнны	*павi*нны	совестью	1
ісландскім	*ісландскім	не	1
давяраю	*давяраю	доверяю	1
алан	*алан	алан	1
кажуць	*кажуць	говорят	1
афіцыйная	*тайская	официальный	1
вучыць	*вучыць	учит	1
горкая	*горкая	горький	1
стамляе	*стамляе	устал	1
дагэтуль	*дагэтуль	старый	1
яблык	*ем	яблоко	1
спакушаюць	*спакушаюць	малолетних	1
гаворыць	*гаворыць	.	1
талончык	*талончык	талончик	1
адрамантуй	*адрамантуй	почини	1
бывай	*бывай	утром	1
чакае	*чакае	победителя	1
чую	*чую	слышу	1
мова	*фарсі	персидский	1
шортын	*шортын	она	1
хтосьці	*ўвогуле	вообще	1
сайтаў	*сайтаў	.	1
чакала	*чакала	ждала	1
ня	*ня	не	1
забіваюць	*забіваюць	с	1
твой	*твой	на	1
чаю	*чаю	чаю	1
доўга	*праснуўшыся	который	1
лічыць	*лічыць	что	1
невялічкая	*невялічкая	для	1
лонадана	*лонадана	лондона	1
маеце	*маеце	подешевле	1
суматра	*суматра	суматра	1
суседзі	*казалі	:	1
«	*замасціць	расположение	1
адрамантаваць	*адрамантаваць	я	1
прагаласаваў	*прагаласаваў	предложение	1
згубіўшы	*згубіўшы	потеряв	1
любляць	*любляць	этот	1
патрэбны	*патрэбны	нужно	1
чакаючы	*чакаючы	дожидаясь	1
тужыць	*тужыць	роптать	1
сустрэну	*сустрэну	встречу	1
моваў	*моваў	мире	1
сайтаў	*сайтаў	взрослых	1
цао	*цао	хитрость	1
кава	*камвозынам	свалился	1
думаюць	*думаюць	думают	1
робяць	*робяць	делают	1
твайго	*твайго	от	1
сайт	*сайт	сайт	1
маляваць	*маляваць	рисовать	1
тут	*ляплю	леплю	1
бойся	*бойся	бойся	1
піша	*піша	пишет	1
застаўляе	*застаўляе	бесчисленные	1
фаната	*фаната	фаната	1
паясніў	*паясніў	объяснил	1
пераносілі	*пераносілі	переносили	1
узводзіць	*узводзіць	клевещет	1
брусэль	*брусэль	брюссель	1
іначай	*іначай	иначе	1
зрабіла	*зрабіла	сделала	1
іўрыце	*іўрыце	иврите	1
звяртаць	*звяртаць	обращать	1
чытаю	*чытаю	читаю	1
прысудзіў	*прысудзіў	приговорил	1
вучыцца	*вучыцца	учиться	1
сандра	*сандра	сандра	1
на	*паглядзеў	посмотрел	1
яўляецца	*яўляецца	первым	1
зайздросціць	*зайздросціць	завидует	1
яўляліся	*яўляліся	застенчивые	1
прасты	*прасты	простой	1
цвятаева	*цвятаева	цветаева	1
павяртайся	*павяртайся	возвращайся	1
і	*грэю	людских	1
ізалентай	*ізалентай	изолентой	1
бялізну	*бялізну	белье	1
раксалана	*раксалана	роксолана	1
браян	*браян	.	1
спакушаюць	*спакушаюць	,	1
опцыя	*опцыя	«	1
і	*найноўшыя	вооружение	1
алаха	*алаха	аллаха	1
заспявай	*заспявай	спой	1
львоўскай	*львоўскай	львовской	1
павiнны	*павi*нны	и	1
паспаць	*паспаць	поспать	1
найдаўжэйшае	*найдаўжэйшае	какое	1
па	*засудзяць	осудят	1
паслясмак	*паслясмак	послевкусие	1
ганаруся	*ганаруся	горжусь	1
есць	*есць	ест	1
каву	*болей	кофе	1
прысніў	*прысніў	которому	1
фартэпіяна	*грае	фортепиано	1
парагвай	*парагвай	парагвай	1
«	*ведаю	знаю	1
ведаю	*ведаю		1
опцыя	*опцыя	с	1
паслясмак	*паслясмак	.	1
зефір	*зефір	зефир	1
зрабіць	*зрабіць	не	1
фэйсбуцы	*фэйсбуцы	фейсбуке	1
здымаем	*здымаем	снимаем	1
падараваў	*падараваў	подарил	1
паслухаць	*паслухаць	послушать	1
дажджыстым	*дажджыстым	друге	1
выдзяўбе	*выдзяўбе	выклюет	1
інтэрфейсу	*інтэрфейсу	интерфейса	1
састарэлых	*састарэлых	пожилых	1
пакажы	*пакажы	покажи	1
скапіюйце	*скапіюйце	эту	1
цалаваў	*цалаваў	целовал	1
узвесці	*узвесці	оклеветать	1
.	*наступстваў	.	1
аперацыйная	*выкарыстоўваемая	используемая	1
кнігу	*купіў	купил	1
праэкт	*праэкт	проект	1
новы	*купіў	стол	1
памятаеш	*памятаеш	помнишь	1
іра	*іра	ира	1
тучы	*тучы	тучи	1
буды	*буды	.	1
невялічкая	*невялічкая	небольшая	1
патрык	*патрык	патрик	1
давядзецца	*давядзецца	придется	1
адрэж	*адрэж	отмерь	1
новы	*купіў	новый	1
дзверы	*дзверы	двери	1
лічыць	*лічыць	он	1
бачылі	*бачылі	эту	1
тэлевізар	*купіў	телевизор	1
галаснейшы	*галаснейшы	и	1
ўсталяваў	*ўсталяваў	установил	1
закохвалася	*закохвалася	влюблялась	1
люблю	*люблю	предпочитаю	1
что	*что	что	1
выкідвай	*выкідвай	выбрасывай	1
гэта	*ведаў	это	1
разумееш	*разумееш	понимаешь	1
гаворыць	*гаворыць	уже	1
газету	*купіце	газету	1
прагаласаваў	*прагаласаваў	проголосовал	1
задумваюся	*задумваюся	задумываюсь	1
наце	*наце	.	1
соцрэалістычныя	*соцрэалістычныя	романы	1
новы	*купіў	купил	1
мяняецца	*мяняецца	меняется	1
каву	*болей	я	1
чытаю	*чытаю	эту	1
смяяліся	*смяяліся	над	1
зарадзілася	*зарадзілася	зародилась	1
пераходзь	*пераходзь	переходи	1
опцыя	*опцыя	области	1
падтрымліваць	*падтрымліваць	и	1
хуана	*хуана	хуана	1
дні	*еў	дня	1
суджана	*суджана	миновать	1
спазнаеш	*спазнаеш	читаешь	1
схавалася	*схавалася	спряталось	1
жадаў	*жадаў	хотел	1
бардэлі	*бардэлі	борделе	1
давялося	*давялося	dmenu	1
ўдалося	*ўдалося	вышло	1
ён	*стуліў	он	1
толькі	*свеціць	светло	1
звяжуся	*звяжуся	свяжусь	1
і	*найноўшыя	стремясь	1
праглядзець	*праглядзець	посмотреть	1
прапіў	*прапіў	пропил	1
ібрагім	*ібрагім	ибрагим	1
о	*о	о	1
некурцоў	*некурцоў	некурящих	1
неправы	*неправы	неправ	1
мова	*фарсі	!	1
ён	*марыў	мечтал	1
прысніся	*прысніся	приснись	1
забывай	*забывай	забывай	1
ведаеце	*ведаеце	знаете	1
патраціла	*болей	потратила	1
чуў	*чуў	львове	1
прыносяць	*прыносяць	приносят	1
вучыцца	*вучыцца	будешь	1
ліпнуць	*ліпнуць	львовских	1
карысней	*карысней	полезнее	1
пафарбаваць	*пафарбаваць	стены	1
.	*ўжываць	стал	1
збольшваецца	*збольшваецца	как	1
паказвае	*паказвае	означает	1
безнадзейныя	*безнадзейныя	они	1
пазнаёміць	*пазнаёміць	познакомить	1
знявага	*знявага	слабого	1
карлас	*карлас	карлос	1
зсср	*зсср	ссср	1
праяўляліся	*праяўляліся	проявлялись	1
сэзон	*сэзон	сезон	1
знайсці	*знайсці	ручку	1
водзіць	*водзіць	моя	1
рака	*лёгкіх	от	1
гэй	*гэй	эй	1
пазычыце	*пазычыце	одолжите	1
заплятала	*заплятала	заплетала	1
чытаў	*чытаў	весь	1
яго	*ведалі	знали	1
параджае	*параджае	,	1
барысаўдрэва	*барысаўдрэва	запретив	1
сварыць	*сварыць	ругает	1
двузначная	*двузначная	?	1
эстонскай	*эстонскай	эстонском	1
бачыла	*бачыла	видела	1
маршалізаваных	*маршалізаваных	империалистами	1
маеце	*маеце	есть	1
прадбачыць	*прадбачыць	предсказать	1
ало	*ало	это	1
ненавідзела	*ненавідзела	свое	1
цікавіць	*цікавіць		1
хварэю	*хварэю	.	1
маша	*маша	маша	1
сымпатычных	*сымпатычных	симпатичных	1
пробуй	*пробуй	пробуй	1
паспяшайся	*паспяшайся	опоздаешь	1
уклад	*ўношу	вклад	1
гуляць	*гуляць	сегодня	1
вырашыў	*вырашыў	ей	1
заняволіць	*заняволіць	поработить	1
колю	*колю	колю	1
борам	*борам	бором	1
выкарыстоўваць	*выкарыстоўваць	библиотеки	1
змірыцца	*змірыцца	смириться	1
гаворыць	*гаворыць	быстро	1
ведаем	*ведаем	знаем	1
цёмныя	*цёмныя	тёмные	1
выкарыстоўваць	*выкарыстоўваць	позволяет	1
спяшайся	*спяшайся	торопись	1
запрашаем	*запрашаем	приглашаем	1
лі	*лі	ли	1
расчыняецца	*расчыняецца	растворяется	1
любляць	*любляць	любят	1
маскаль	*маскаль	москаль	1
рака	*лёгкіх	рака	1
лётае	*лётае	всё	1
адпраўляецца	*адпраўляецца	отправляется	1
чалавеканенавісных	*чалавеканенавісных	теорий	1
сродкі	*блытаюць	так	1
«	*ведаю	кто	1
сталых	*сталых	зрелых	1
адхілілася	*адхілілася	отпрянула	1
паснедаў	*паснедаў	позавтракал	1
рака	*лёгкіх	году	1
тэхас	*тэхас	техас	1
«	*ну	сегодня	1
каштоўнейшыя	*каштоўнейшыя	.	1
і	*найноўшыя	раздробить	1
разнознівае	*разнознівае	различает	1
гэта	*адсвяткаваць	флаг	1
небачная	*небачная	.	1
выпісваюць	*выпісваюць	на	1
расеі	*расеі	много	1
еш	*еш	этих	1
бачылі	*бачылі	видели	1
снедаў	*снедаў	завтракал	1
можа	*зрабіць	людям	1
занепакоілася	*занепакоілася	встревожилась	1
на	*паглядзеў	что	1
прайшло	*прайшло	прошёл	1
горкая	*горкая	чай	1
маеце	*маеце	нет	1
зруйнаваў	*зруйнаваў	разрушил	1
забівай	*забівай	убивай	1
павiнны	*адзi*н	отношении	1
меў	*меў	него	1
пракампасціруйце	*пракампасціруйце	,	1
будаўнікоў	*частуе	строителей	1
лянуецца	*лянуецца	ленится	1
невялічкая	*невялічкая	с	1
судзячы	*судзячы	судя	1
вырашылі	*вырашылі	решили	1
здарылася	*здарылася	произошло	1
нараджаюцца	*нараджаюцца	совестью	1
падабаецца	*падабаецца	,	1
рамсэс	*рамсэс	рамсес	1
заматай	*заматай	замотай	1
найчасцей	*найчасцей	всего	1
здарылася	*здарылася	стало	1
новы	*купіў	компьютера	1
дзень	*наліваю	день	1
сварыць	*сварыць		1
дагэтуль	*дагэтуль	жил	1
знявага	*знявага	неприемлемы	1
рэлігіёзны	*рэлігіёзны	религиозный	1
твой	*твой	блог	1
забыўся	*забыўся	позвонить	1
«	*ну	уже	1
захутка	*захутка	слишком	1
зрабіць	*зрабіць	из	1
губка	*губка	губка	1
гыч	*гыч	никогда	1
замёрзнеш	*замёрзнеш	замёрзнешь	1
інтэрнэце	*інтэрнэце	интернете	1
пачытаць	*пачытаць	роман	1
сняданкам	*сняданкам	завтраком	1
жывёш	*жывёш	живёшь	1
—	*блог	блог	1
татоэба	*татоэба	татоэба	1
вучацца	*вучацца	учатся	1
вучышся	*вучышся	учишься	1
ляльку	*ляльку	куклу	1
ствараеце	*ствараеце	создаёте	1
ён	*наснілася	которому	1
турбуй	*турбуй	беспокой	1
мяжуюць	*мяжуюць	граничат	1
кушеч	*кушеч	ты	1
наняты	*наняты	сивый	1
ровар	*ровар	?	1
маеш	*маеш	есть	1
нараджаюцца	*нараджаюцца	своем	1
выставу	*выставу	выставку	1
збалансованага	*збалансованага	сбалансированного	1
азначалі	*азначалі	консультаций	1
штосьці	*штосьці	ли	1
памятаеце	*памятаеце	помните	1
павялічылася	*павялічылася	увеличилось	1
дажыву	*дажыву	дожить	1
штаны	*штаны	штаны	1
«	*замасціць	показа	1
сварыць	*сварыць	?	1
хаця	*хаця	данная	1
амфітрыты	*амфітрыты	амфитриты	1
павiнны	*адзi*н	и	1
мушу	*мушу	мою	1
нараджаюцца	*нараджаюцца	рождаются	1
садавінай	*садавінай	.	1
саэб	*саэб	саэб	1
кушеч	*кушеч	взялся	1
вянуць	*вянуць	вянут	1
выкарыстоўваць	*дазваляе	которая	1
сцерці	*сцерці	стёрт	1
удзельнічаць	*удзельнічаць	участвовать	1
гольф	*гольф	гольф	1
прайшоў	*прайшоў	прошла	1
ставіцца	*ставіцца	флаг	1
падманулі	*падманулі	обманули	1
мёртвы	*мёртвы	мёртвая	1
.	*аватары	фотографию	1
расчыняецца	*расчыняецца	.	1
паслужыць	*паслужыць	моя	1
ўдзячны	*ўдзячны	твой	1
,	*чжуанцзы	чжуан-цзы	1
прыводзіць	*прыводзіць	приводит	1
гаварыў	*гаварыў	говорил	1
змяняе	*змяняе	меняет	1
«	*замасціць	размерами	1
пачынаецца	*пачынаецца	начинается	1
зарабляў	*зарабляў	зарабатывал	1
паспяшайся	*паспяшайся	поспеши	1
маеш	*маеш	ты	1
адзна	*адзна	-	1
,	*дзякуй	спасибо	1
дзякуй	*дзякуй	слава	1
парламентская	*парламентская		1
хапае	*хапае	недостаточно	1
фэйсбуцы	*фэйсбуцы	вас	1
ня	*ня	верю	1
снедае	*снедае	завтракает	1
згодны	*згодны	согласен	1
лётае	*лётае	него	1
шэі	*шэі	шеи	1
дзякуй	*дзякуй		1
разражаджаная	*разражаджаная	разряжена	1
ці	*чжуанцзы	снится	1
невялічкая	*невялічкая	базовой	1
знае	*знае	знает	1
выбрукавана	*выбрукавана	намерениями	1
меў	*меў	был	1
ад	*сустракаю	встречаю	1
талончык	*талончык	врачу	1
маеце	*маеце	у	1
казалі	*казалі	соседи	1
паглядзела	*паглядзела	посмотрела	1
размаўляйце	*размаўляйце	говорите	1
пераўсталёўваць	*пераўсталёўваць	переустанавливать	1
падыходзіць	*падыходзіць	подходит	1
булачку	*булачку	булочку	1
цао	*цао	.	1
купляючы	*купляючы	покупая	1
сняданак	*сняданак	?	1
сам	*рабіў	сам	1
мяняецца	*мяняецца		1
і	*найноўшыя	консервы	1
срэбнымі	*срэбнымі	серебряными	1
міліцыянтам	*міліцыянтам	милиционером	1
яўляліся	*яўляліся	появлялись	1
галандыя	*галандыя	голландия	1
мёртвы	*мёртвы	мёртв	1
хапае	*хапае	у	1
выпісваюць	*выпісваюць	выписывают	1
цэліцеся	*цэліцеся	слишком	1
наводзіць	*наводзіць	на	1
люблю	*люблю	.	1
твой	*твой	твоя	1
іен	*іен	иен	1
рушдзі	*рушдзі	—	1
казахскай	*казахскай	на	1
ажаніцца	*ажаніцца	.	1
праглядзець	*праглядзець	которые	1
ютарныя	*ютарныя	вдохновить	1
страляйце	*страляйце	стреляйте	1
здрадзіў	*здрадзіў	предал	1
мюрыэл	*мюрыэл	меня	1
баюся	*баюся	боюсь	1
ганаруся	*ганаруся	и	1
,	*чжуанцзы	—	1
з	*спаму	.	1
дырэктарам	*тэт-а-*тэт	тет-а-тет	1
куй	*куй	куй	1
мяняецца	*мяняецца	быстрее	1
гуляць	*гуляць	идём	1
свойго	*свойго	покрасить	1
інтэрнэце	*інтэрнэце	на	1
французкай	*французкай	французском	1
найяскравейшая	*найяскравейшая	самая	1
ўдвох	*ўдвох	вдвоём	1
што	*наснілася	которому	1
сэрвісаў	*сэрвісаў	сервисов	1
дзякуй	*дзякуй	за	1
толькі	*свеціць	только	1
гарбаткі	*гарбаткі	.	1
давядзецца	*давядзецца	смириться	1
бегай	*бегай	бегай	1
саромеецца	*саромеецца	стесняется	1
падобны	*падобны	птиц	1
гыч	*гыч	''"	1
ці	*чжуанцзы	которой	1
гарбату	*гарбату	зелёный	1
пафарбаваць	*пафарбаваць	покрасить	1
ведаюць	*ведаюць	знают	1
,	*здаецца	,	1
ліпнуць	*ліпнуць	липнут	1
сайту	*сайту	сайта	1
я	*насіць	носить	1
ўстанавілі	*ўстанавілі	установили	1
сустрэла	*сустрэла	встретила	1
сайтаў	*сайтаў	сайтов	1
спорта	*спорта	спорта	1
сумую	*сумую	скучаю	1
развіваецца	*развіваецца	развивающемся	1
памятаеце	*памятаеце	эту	1
высланае	*высланае	выстлан	1
дажыву	*дажыву	мне	1
тваю	*тваю	твой	1
прасцейшая	*прасцейшая	,	1
скажа	*скажа	тебе	1
любое	*любое	любое	1
застаўляе	*застаўляе	заставляет	1
улучыць	*улучыць	попасть	1
заданне	*рабі	домашнее	1
сайтаў	*сайтаў	сайтам	1
дацкі	*дацкі	,	1
ну	*ну	ну	1
адляцелі	*адляцелі	улетели	1
нарадзіўся	*нарадзіўся	и	1
абралі	*абралі	выбрали	1
кузэн	*кузэн	кузен	1
зранку	*зранку	пока	1
многіх	*многіх	странах	1
згубіла	*згубіла	потеряла	1
казалі	*казалі	,	1
безнадзейныя	*безнадзейныя	безнадёжны	1
шахматы	*шахматы	шахматы	1
ведаюць	*ведаюць	любят	1
дажджыстым	*дажджыстым	каждым	1
званым	*званым	«	1
афіцыйная	*тайская	тайский	1
суседзі	*казалі	соседи	1
гарбаткі	*гарбаткі	чайку	1
ведаць	*ведаць	тайну	1
хадзем	*хадзем	что	1
нефертары	*нефертары	нефертари	1
юпітэра	*юпітэра	.	1
азначалі	*азначалі	означали	1
ніхто	*насамрэч	что	1
—	*о	уже	1
чуеш	*чуеш	слышишь	1
размаўляе	*размаўляе	говорят	1
—	*о	похоронили	1
дазваляе	*дазваляе	.	1
падымецца	*аж	аж	1
жадаеце	*жадаеце	хотите	1
арктыцы	*арктыцы	арктике	1
максымальным	*максымальным	максимальном	1
садавінай	*садавінай	фруктами	1
прыдумваў	*прыдумваў	придумывал	1
гуляем	*гуляем	играем	1
дагэтуль	*дагэтуль	ещё	1
піша	*піша	от	1
падараваў	*падараваў	ей	1
шы	*шы	цзыю	1
лукашэнка	*лукашэнка	лукашенко	1
пацалуй	*пацалуй	поцелуй	1
навелы	*навелы	новеллы	1
працуюць	*працуюць	работают	1
адвучыўся	*адвучыўся	отучился	1
,	*піша	приснилось	1
гатуеце	*гатуеце	готовите	1
цытаваць	*цытаваць	цитировать	1
з	*засноўнікаў	основателей	1
бабруйск	*бабруйск	бобруйска	1
носе	*зарубі	носу	1
плавае	*плавае	плавает	1
вырашаць	*вырашаць	решать	1
сам	*рабіў	делал	1
