ведаю	*ведаю	знаю	24
люся	*люся	люся	20
люблю	*люблю	люблю	16
клава	*клава	клава	12
твой	*твой	твой	8
знайсці	*знайсці	найти	8
яані	*яані	яани	8
львоў	*львоў	львов	6
нюнорска	*нюнорска	нюнорска	6
цао	*цао	цао	6
педафілы	*педафілы	педофилы	5
дазваляе	*дазваляе	позволяет	5
працаваць	*працаваць	работать	5
бэці	*бэці	бетти	5
ведаць	*ведаць	знать	4
твая	*твая	твоя	4
роджэр	*роджэр	роджер	4
працуе	*працуе	работает	4
купляйце	*купляйце	покупайте	4
збіраюся	*збіраюся	собираюсь	4
чытаць	*чытаць	читать	4
пісаць	*пісаць	писать	4
сказала	*сказала	сказала	4
люсі	*люсі	люси	4
львове	*львове	львове	4
плаваць	*плаваць	плавать	4
піша	*піша	пишет	4
ўмееш	*ўмееш	умеешь	4
спаць	*спаць	спать	4
сказаць	*сказаць	сказать	4
ведаеш	*ведаеш	знаешь	4
йен	*йен	иен	4
бэна	*бэна	бена	4
гаворыць	*гаворыць	говорит	4
выйгралі	*выйгралі	выиграли	3
кампутары	*кампутары	компьютере	3
гаварыць	*гаварыць	говорить	3
характэрных	*характэрных	характерных	3
паабяцалі	*паабяцалі	пообещали	3
здарылася	*здарылася	случилось	3
клясе	*клясе	классе	3
смяяліся	*смяяліся	смеялись	3
маркс	*маркс	маркс	3
саромейся	*саромейся	стесняйся	3
дарэнда	*дарэнда	доренда	3
аж	*аж	аж	3
вывучае	*вывучае	изучает	3
цзыю	*цзыю	цзыю	3
вокны	*вокны	окна	3
анжаліка	*анжаліка	анжелика	3
звяртае	*звяртае	обращает	3
ведае	*ведае	знает	3
мюрыэл	*мюрыэл	мюриэл	3
звуць	*звуць	зовут	3
рон	*рон	рон	3
абама	*абама	обама	3
дакранулася	*дакранулася	дотронулось	3
ало	*ало	алло	3
бегаць	*бегаць	бегать	3
ўмее	*ўмее	умеет	3
ціма	*ціма	тима	3
вывалілася	*вывалілася	вывалилась	3
сайце	*сайце	сайте	3
браян	*браян	брайан	3
кнопки	*кнопки	кнопки	3
слухаць	*слухаць	слушать	3
існуе	*існуе	существует	3
кенам	*кенам	кен	3
разумею	*разумею	понимаю	3
выбраць	*выбраць	выбрать	3
блог	*блог	блог	3
песьня	*песьня	песня	3
вывучаў	*вывучаў	изучал	3
ненавідзела	*ненавідзела	ненавидела	3
гэткай	*гэткай	этакой	3
абажае	*абажае	обожает	3
пашанцавала	*пашанцавала	посчастливилось	3
анімэ	*анімэ	аниме	3
зайздросціла	*зайздросціла	завидовала	3
вольныя	*вольныя	свободные	3
спазнаеш	*спазнаеш	познаешь	2
думаеш	*думаеш	думаешь	2
інфармацію	*інфармацію	информацию	2
шэптам	*шэптам	шёпотом	2
сэрвісаў	*сэрвісаў	сервисов	2
евангеліна	*евангеліна	евангелина	2
сцерці	*сцерці	стёрт	2
кракаў	*кракаў	краков	2
разнознівае	*разнознівае	различает	2
рок	*рок	рок	2
замяняем	*замяняем	заменяем	2
наставай	*наставай	настиной	2
здымалі	*здымалі	снимали	2
пракампасціруйце	*пракампасціруйце	прокомпостируйте	2
згубіла	*згубіла	потеряла	2
прапусціце	*прапусціце	пропустите	2
папіць	*папіць	попить	2
азначалі	*азначалі	означали	2
імперыялістамі	*імперыялістамі	империалистами	2
заклей	*заклей	заклей	2
пацалаваў	*пацалаваў	поцеловал	2
юэбін	*юэбін	юэбин	2
падобнае	*падобнае	похожее	2
пачытаць	*пачытаць	почитать	2
хазрэт	*хазрэт	хазрет	2
застаўляе	*застаўляе	бесчисленные	2
лазанью	*лазанью	лазанью	2
нептуна	*нептуна	нептуна	2
сарваныя	*сарваныя	сорванные	2
выразаў	*выразаў	вырезал	2
няўжо	*няўжо	неужели	2
срэбны	*срэбны	серебряную	2
прадаюцца	*прадаюцца	продаются	2
акна	*акна	окна	2
стае	*стае	становится	2
называлі	*называлі	называли	2
гартман	*гартман	гартман	2
фнорд	*фнорд	фнорд	2
юмі	*юмі	юми	2
злезлі	*злезлі	слезли	2
дасцін	*дасцін	дастин	2
люсе	*люсе	люсе	2
штаны	*штаны	штаны	2
ісландскім	*ісландскім	исландским	2
праплывалі	*праплывалі	проплывали	2
забівае	*забівае	убивает	2
пераказваю	*пераказваю	пересказываю	2
здраджваў	*здраджваў	предавал	2
супадае	*супадае	совпадает	2
анлайн-слоўнікаў	*анлайн-словарей	онлайн-словарей	2
валодае	*валодае	обладает	2
рэакцыю	*рэакцыю	реакцию	2
акна	*акна	окно	2
душэ	*душэ	душе	2
эксплорэр	*эксплорэр	эксплорер	2
трасці	*трасці	трясти	2
пагаварыць	*пагаварыць	поговорить	2
дзверы	*дзверы	дверь	2
туман	*туман	туман	2
нагадвае	*нагадвае	напоминает	2
праносіць	*праносіць	проносить	2
спустошаны	*спустошаны	опустошён	2
дакраніся	*дакраніся	дотронься	2
руска-чэскага	русско-*чэскага	русско-чешского	2
твая	*твая	твоё	2
называецца	*называецца	называется	2
султан	*султан	султан	2
памыць	*памыць	помыть	2
галандскай	*галандскай	голландского	2
асноўваецца	*асноўваецца	основывается	2
вылез	*вылез	вылез	2
загарэлася	*загарэлася	загорелась	2
перо	*перо	перро	2
мандарыны	*мандарыны	мандарины	2
здымаюць	*здымаюць	снимают	2
майк	*майк	майк	2
эўропе	*эўропе	европе	2
па-французку	по-*французку	по-французски	2
балатавацца	*балатавацца	баллотироваться	2
задаваць	*задаваць	задавать	2
паслясмак	*паслясмак	послевкусие	2
знайшоў	*знайшоў	нашёл	2
мілер	*мілер	миллер	2
трымаўся	*трымаўся	держался	2
паяснілі	*паяснілі	объяснили	2
жадаю	*жадаю	желаю	2
высунулі	*высунулі	высунули	2
шы	*шы	ши	2
чапай	*чапай	трогай	2
каптурко	*каптурко	шапочко	2
пачынаецца	*пачынаецца	начинается	2
размаўляе	*размаўляе	разговаривает	2
асвойваецца	*асвойваецца	осваивается	2
адчыняй	*адчыняй	открывай	2
кэці	*кэці	кэти	2
барысаўдрэва	*барысаўдрэва	борисовдрева	2
разумееш	*разумееш	понимаешь	2
цёмны	*цёмны	тёмную	2
кахаю	*кахаю	люблю	2
пераскаквае	*пераскаквае	перепрыгивает	2
буды	*буды	будды	2
адрэдагавала	*адрэдагавала	отредактировала	2
маеце	*маеце	имеете	2
абажаю	*абажаю	обожаю	2
сакрэт	*сакрэт	секрет	2
акно	*акно	окно	2
засыхалі	*засыхалі	засыхали	2
лілі	*лілі	лилли	2
любляць	*любляць	любят	2
заплятала	*заплятала	заплетала	2
найяскравейшая	*найяскравейшая	наиярчайшая	2
ўнадзілася	*ўнадзілася	повадилась	2
бліжняга	*бліжняга	ближнего	2
чытаў	*чытаў	читал	2
разбіраецца	*разбіраецца	разбирается	2
ізраіль	*ізраіль	израиль	2
дантэ	*дантэ	данте	2
твой	*твой	твоя	2
мандалай	*мандалай	мандалай	2
цёмныя	*цёмныя	тёмные	2
вучыў	*вучыў	учил	2
іслам	*іслам	ислам	2
індустрыялізацыя	*індустрыялізацыя	индустриализация	2
рушдзі	*рушдзі	рушди	2
завецца	*завецца	называется	2
адрэж	*адрэж	отрежь	2
звальняцца	*звальняцца	увольняться	2
лётае	*лётае	летает	2
соцрэалістычныя	*соцрэалістычныя	соцреалистические	2
тэрэза	*тэрэза	тереза	2
іграць	*іграць	играть	2
падобнымі	*падобнымі	похожими	2
прамільгнула	*прамільгнула	промелькнуло	2
нарадзілася	*нарадзілася	родилась	2
сцвярджае	*сцвярджае	утверждает	2
пройдзе	*пройдзе	пройдёт	2
годы	*годы	годах	2
шарля	*шарля	шарля	2
гавары	*гавары	говори	2
прашчае	*прашчае	прощает	2
прытворымся	*прытворымся	притворимся	2
казахскай	*казахскай	казахском	2
палюбі	*палюбі	возлюби	2
спіць	*спіць	спит	2
адрэсу	*адрэсу	адрес	2
прашчаецца	*прашчаецца	прощается	2
многіх	*многіх	многих	2
прыймаюць	*прыймаюць	принимаютъ	2
заставіць	*заставіць	заставить	2
прэзыдэнт	*прэзыдэнт	президент	2
прагноза	*прагноза	прогноза	2
раскіданыя	*раскіданыя	разбросаны	2
московиц	*москови*ц	московиц	2
каран	*каран	коран	2
тваёй	*тваёй	твоей	2
сумуем	*сумуем	скучаем	2
спакушаюць	*спакушаюць	совращают	2
шукала	*шукала	искала	2
тваю	*тваю	твой	2
фарамп	*фарамп	фарамп	2
сайту	*сайту	сайта	2
татоэбе	*татоэбе	татоэбе	2
ідэалогія	*ідэалогія	идеология	2
хрыстовым	*хрыстовым	христовым	2
піклз	*піклз	пиклз	2
джэк	*джэк	джек	2
дурыце	*дурыце	дурите	2
апавядаў	*апавядаў	рассказывал	2
думала	*думала	думала	2
чытаеш	*чытаеш	читаешь	2
расказаць	*расказаць	рассказать	2
інапланецянамі	*інапланецянамі	инопланетянами	2
салмана	*салмана	салмана	2
іншапланецяне	*іншапланецяне	инопланетяне	2
джэка	*джэка	джеком	2
тучы	*тучы	тучи	2
спрошчвае	*спрошчвае	упрощает	2
львоўскі	*львоўскі	львовский	2
товада	*товада	товада	2
цямнее	*цямнее	темнеет	2
збольшваецца	*збольшваецца	увеличивается	2
развешвае	*развешвае	развешивает	2
ідэальны	*ідэальны	идеальный	2
лукашэнка	*лукашэнка	лукашенко	2
тадэвуш	*тадэвуш	тадеуш	1
разлічваць	*разлічваць	рассчитывать	1
памяці	*памяці	памяти	1
пытарен	*пытарен	выплакала	1
інфекцыя	*інфекцыя	инфекция	1
паснедаў	*паснедаў	позавтракал	1
рамсэс	*рамсэс	рамсес	1
інтэрнэт	*інтэрнэт	интернет	1
выкідвай	*выкідвай	выбрасывай	1
лонадана	*лонадана	лондона	1
абароненасць	*абароненасць	защищённость	1
плавае	*плавае	плавает	1
ўмею	*ўмею	умею	1
сумую	*сумую	скучаю	1
роўтэр	*роўтэр	роутер	1
творыць	*творыць	творит	1
губка	*губка	губка	1
алан	*алан	алан	1
прыносіць	*прыносіць	приносит	1
пераходзь	*пераходзь	переходи	1
выбраць	*выбраць	показать	1
бойся	*бойся	бойся	1
разражаджаная	*разражаджаная	разряжена	1
здарылася	*здарылася	стряслось	1
галандыя	*галандыя	голландия	1
еў	*еў	съел	1
кадаванне	*кадаванне	кодировка	1
слухайце	*слухайце	слушайте	1
ззяюць	*ззяюць	сияют	1
дадаваць	*дадаваць	добавлять	1
цалаваў	*цалаваў	целовал	1
зліць	*зліць	злить	1
маскаль	*маскаль	москаль	1
бегай	*бегай	бегай	1
паслужыць	*паслужыць	послужит	1
здымаем	*здымаем	снимаем	1
маеце	*маеце	подешевле	1
сустракаю	*сустракаю	встречаю	1
гма	*гма	гмо	1
інапланецяне	*інапланецяне	инопланетяне	1
срэбнымі	*срэбнымі	серебряными	1
вучуся	*вучуся	учусь	1
сымпатычных	*сымпатычных	симпатичных	1
цвятаева	*цвятаева	цветаева	1
яндекс	*яндекс	яндекс	1
выйграць	*выйграць	выиграть	1
зсср	*зсср	ссср	1
есці	*есці	съесть	1
пераўсталёўваць	*пераўсталёўваць	переустанавливать	1
ліжы	*ліжы	лижи	1
павяртайся	*павяртайся	возвращайся	1
схавалася	*схавалася	спряталось	1
зрабіла	*зрабіла	сделала	1
пазнаў	*пазнаў	познал	1
міцкевіча	*міцкевіча	мицкевича	1
знае	*знае	знает	1
сядайце	*сядайце	садитесь	1
прагаласаваў	*прагаласаваў	проголосовал	1
чытаючы	*чытаючы	читая	1
мінесоце	*мінесоце	миннесоте	1
тэхас	*тэхас	техас	1
свеціць	*свеціць	светит	1
загойваюцца	*загойваюцца	заживают	1
падтрымліваць	*падтрымліваць	поддерживать	1
паўнаэкранных	*паўнаэкранных	полноэкранных	1
львоўскіх	*львоўскіх	львовских	1
карпаты	*карпаты	карпаты	1
звяжуся	*звяжуся	свяжусь	1
імперыялісты	*імперыялісты	империалисты	1
пярсідская	*пярсідская	персидский	1
грэю	*грэю	грею	1
зарубі	*зарубі	заруби	1
прысніся	*прысніся	приснись	1
спаму	*спаму	спама	1
амфітрыты	*амфітрыты	амфитриты	1
хуйні	*хуйні	хуйни	1
пашуковая	*пашуковая	поисковая	1
па-японску	по-*японску	по-японски	1
інтэрнэт-старонак	*інтэрнэт-страниц	интернет-страниц	1
штаны	*штаны	нужны	1
размаўлялі	*размаўлялі	разговаривали	1
списаў	*спи*саў	исписал	1
задумваюся	*задумваюся	задумываюсь	1
мяняецца	*мяняецца	меняется	1
брусэль	*брусэль	брюссель	1
працую	*працую	работаю	1
талончык	*талончык	талончик	1
паспаць	*паспаць	поспать	1
сато	*сато	сато	1
шахматы	*шахматы	шахматы	1
платон	*платон	платон	1
чытаюць	*чытаюць	читают	1
рэкламавалі	*рэкламавалі	рекламировали	1
нла	*нла	нло	1
заблукаеш	*заблукаеш	заблудишься	1
куй	*куй	куй	1
перазваню	*перазваню	перезвоню	1
моё	*моё	мой	1
кузэн	*кузэн	кузен	1
твае	*твае	твои	1
пераносілі	*пераносілі	переносили	1
працаваў	*працаваў	работал	1
парламентская	*парламентская	парламентская	1
застаўляе	*застаўляе	заставляет	1
высланае	*высланае	выстлан	1
шукаў	*шукаў	искал	1
канадскія	*канадскія	канадские	1
сандра	*сандра	сандра	1
слухаеце	*слухаеце	слушаете	1
безнадзейныя	*безнадзейныя	безнадёжны	1
давялося	*давялося	пришлось	1
некурцоў	*некурцоў	некурящих	1
ўстанавілі	*ўстанавілі	установили	1
еўрабачанне	*еўрабачанне	евровидение	1
твайго	*твайго	твоего	1
здавалася	*здавалася	казалось	1
бегае	*бегае	бегает	1
патрык	*патрык	патрик	1
чытаю	*чытаю	читаю	1
маляваць	*маляваць	рисовать	1
шэкспіра	*шэкспіра	шекспира	1
абяцала	*абяцала	обещало	1
кампакт-дыск	*кампакт-диск	компакт-диск	1
фаната	*фаната	фаната	1
хуана	*хуана	хуана	1
пакажы	*пакажы	покажи	1
кашгары	*кашгары	кашгаре	1
пробуй	*пробуй	пробуй	1
нефертары	*нефертары	нефертари	1
падлічваюць	*падлічваюць	подсчитывают	1
алаха	*алаха	аллаха	1
неправы	*неправы	неправ	1
хадановіч	*хадановіч	хаданович	1
прапіў	*прапіў	пропил	1
дораэмон	*дораэмон	дораэмон	1
распаўсюджвайце	*распаўсюджвайце	распространяйте	1
баюся	*баюся	боюсь	1
наліваю	*наліваю	наливаю	1
прыдумаць	*прыдумаць	придумать	1
звяртаць	*звяртаць	обращать	1
карысны	*карысны	полезный	1
запрашаем	*запрашаем	приглашаем	1
актор	*актор	актер	1
траціў	*траціў	тратил	1
вырашаць	*вырашаць	решать	1
збіраць	*збіраць	собирать	1
что	*что	что	1
суседі	*суседі	соседи	1
выпісваюць	*выпісваюць	выписывают	1
прыдумваў	*прыдумваў	придумывал	1
будавалася	*будавалася	строилась	1
паслухаць	*паслухаць	послушать	1
перасунь	*перасунь	передвинь	1
ведалі	*ведалі	знали	1
дацкай	*дацкай	датским	1
забыўся	*забыўся	забыл	1
змяняе	*змяняе	меняет	1
сустракаюцца	*сустракаюцца	встречаются	1
страляючы	*страляючы	стреляя	1
выкалі	*выкалі	выколи	1
вытрываў	*вытрываў	вытерпел	1
эстонскай	*эстонскай	эстонском	1
забівай	*забівай	убивай	1
хапае	*хапае	хватает	1
гольф-клуба	*гольф-клуба	гольф-клуба	1
радактараў	*радактараў	редакторов	1
зарабляў	*зарабляў	зарабатывал	1
збіраецца	*збіраецца	собирается	1
суматра	*суматра	суматра	1
сэзон	*сэзон	сезон	1
траян	*траян	троян	1
весці	*весці	вести	1
рамашку	*рамашку	ромашку	1
ізалентай	*ізалентай	изолентой	1
борам	*борам	бором	1
званым	*званым	называемым	1
падабаўляю	*падабаўляю	подобавляю	1
цытаваць	*цытаваць	цитировать	1
славацкай	*славацкай	словацком	1
тайская	*тайская	тайский	1
гатаваць	*гатаваць	готовить	1
ведаем	*ведаем	знаем	1
максымальным	*максымальным	максимальном	1
натхніць	*натхніць	вдохновить	1
замасціць	*замасціць	замостить	1
думаў	*думаў	думал	1
львоў	*львоў	львове	1
скажа	*скажа	скажет	1
пятнаццаць	*пятнаццаць	пятнадцать	1
ганаруся	*ганаруся	горжусь	1
аватары	*аватары	аватаре	1
чаю	*чаю	чаю	1
пазнаёміць	*пазнаёміць	познакомить	1
французкай	*французкай	французском	1
ўсталяваў	*ўсталяваў	установил	1
ствараеце	*ствараеце	создаёте	1
выставу	*выставу	выставку	1
эліс	*эліс	элис	1
тайландзе	*тайландзе	таиланде	1
булачку	*булачку	булочку	1
паглядзеў	*паглядзеў	посмотрел	1
дэзарганізаваць	*дэзарганізаваць	дезорганизовать	1
пацалуй	*пацалуй	поцелуй	1
шнайдарам	*шнайдарам	шнайдером	1
карысней	*карысней	полезнее	1
прыводзіць	*прыводзіць	приводит	1
сайт	*сайт	сайт	1
дабудзь	*дабудзь	добудь	1
прасты	*прасты	простой	1
ем	*ем	ем	1
тваім	*тваім	твоём	1
камфортнасці	*камфортнасці	комфортности	1
ускладае	*ускладае	возлагает	1
маша	*маша	маша	1
па-кітайску	по-*кітайску	по-китайски	1
пазнаёміліся	*пазнаёміліся	познакомились	1
высахлі	*высахлі	высохли	1
гуляем	*гуляем	играем	1
есць	*есць	ест	1
праблемаў	*праблемаў	проблем	1
абралі	*абралі	выбрали	1
траціць	*траціць	тратит	1
пафарбаваць	*пафарбаваць	покрасить	1
саэб	*саэб	саэб	1
пятроўшчына	*пятроўшчына	петровщина	1
шы	*шы	цзыю	1
жарэ	*жарэ	жрёт	1
імперыялізму	*імперыялізму	империализма	1
бачыла	*бачыла	видела	1
падыходзіць	*падыходзіць	подходит	1
настаўніцы-інапланецянцы	учительнице-*інапланецянцы	учительнице-инопланетянке	1
настаўніцы-інапланецянцы	учительнице-*інапланецянцы	учительнице-инопланетянке	1
працаваць	*працаваць	разговаривать	1
ліпнуць	*ліпнуць	липнут	1
вядзе	*вядзе	ведёт	1
ведаеце	*ведаеце	знаете	1
змніць	*змніць	единицы	1
функцыянальнасцю	*функцыянальнасцю	функциональностью	1
выправіш	*выправіш	исправишь	1
вянуць	*вянуць	вянут	1
львоўскай	*львоўскай	львовской	1
някляева	*някляева	некляева	1
мёртвы	*мёртвы	мёртв	1
чакала	*чакала	ждала	1
заматай	*заматай	замотай	1
прайшло	*прайшло	прошёл	1
замужам	*замужам	замужем	1
спяць	*спяць	спят	1
падабаўляць	*падабаўляць	подобавлять	1
грае	*грае	играет	1
мёртвы	*мёртвы	мёртвая	1
гольф	*гольф	гольф	1
прыпыніце	*прыпыніце	прекратите	1
пагуляць	*пагуляць	поиграть	1
цэліцеся	*цэліцеся	целитесь	1
забывай	*забывай	забывай	1
хочацца	*хочацца	хочется	1
праяўляліся	*праяўляліся	проявлялись	1
зарабляю	*зарабляю	зарабатываю	1
высушу	*высушу	высушу	1
дырку	*дырку	дырку	1
чалавеканенавісных	*чалавеканенавісных	человеконенавистнических	1
дажыву	*дажыву	дожить	1
фарсі	*фарсі	фарси	1
опцыя	*опцыя	опция	1
гатуеце	*гатуеце	готовите	1
тараторыць	*тараторыць	тараторит	1
каўтае	*каўтае	глотает	1
навіс	*навіс	нависла	1
знайшлі	*знайшлі	нашли	1
ну	*ну	ну	1
эх	*эх	ну	1
інтэрфейсу	*інтэрфейсу	интерфейса	1
спорта	*спорта	спорта	1
орэст	*орэст	орест	1
прыносяць	*прыносяць	приносят	1
парагвай	*парагвай	парагвай	1
міхалова	*міхалова	михалово	1
празвінеў	*празвінеў	прозвенел	1
размаўляю	*размаўляю	разговариваю	1
абміналі	*абміналі	обходили	1
дзверы	*дзверы	двери	1
лёка	*лёка	лёко	1
ным	*ным	ном	1
навелы	*навелы	новеллы	1
плаваюць	*плаваюць	плавают	1
зефір	*зефір	зефир	1
марыць	*марыць	устроить	1
справіўся	*справіўся	справился	1
паважаюць	*паважаюць	уважают	1
спакушае	*спакушае	совращает	1
зложана	*зложана	сложено	1
іўрыце	*іўрыце	иврите	1
абяцаў	*абяцаў	обещал	1
праэкт	*праэкт	проект	1
расчыняецца	*расчыняецца	растворяется	1
ўдвох	*ўдвох	вдвоём	1
еш	*еш	съешь	1
косы	*косы	косы	1
еўра	*еўра	евро	1
словіа	*словіа	словио	1
шнобелеўскую	*шнобелеўскую	шнобелевскую	1
балела	*балела	болело	1
сан-францыска	сан-*францыска	сан-франциско	1
сан-францыска	сан-*францыска	сан-франциско	1
кансервы	*кансервы	консервы	1
паглядзела	*паглядзела	посмотрела	1
порнасайт	*порнасайт	порносайт	1
сайтам	*сайтам	сайтом	1
любое	*любое	любое	1
вольным	*вольным	свободным	1
горкая	*горкая	горький	1
знайдзе	*знайдзе	найдёт	1
судзячы	*судзячы	судя	1
адпраўляецца	*адпраўляецца	отправляется	1
хэлен	*хэлен	хелен	1
гэй	*гэй	эй	1
збаўце	*збаўце	убавьте	1
перамагаем	*перамагаем	побеждаем	1
гаварыў	*гаварыў	говорил	1
еў	*еў	ел	1
лжывую	*лжывую	ложную	1
яўляліся	*яўляліся	появлялись	1
тваю	*тваю	твою	1
квінтэсенцыя	*квінтэсенцыя	квинтэссенция	1
бабруйск	*бабруйск	бобруйска	1
ўзнікла	*ўзнікла	возникла	1
адвучыўся	*адвучыўся	отучился	1
іра	*іра	ира	1
інтэрнэце	*інтэрнэце	интернете	1
зарадзілася	*зарадзілася	зародилась	1
замёрзнеш	*замёрзнеш	замёрзнешь	1
ушым	*ушым	острым	1
падлі…	*падлі…	подлей…	1
бардэлі	*бардэлі	борделе	1
французкія	*французкія	французские	1
вучышся	*вучышся	учишься	1
карлас	*карлас	карлос	1
арктыцы	*арктыцы	арктике	1
мачыць	*мачыць	мочить	1
застаецца	*застаецца	остаётся	1
давяраю	*давяраю	доверяю	1
іен	*іен	иен	1
іскрыць	*іскрыць	искрит	1
развіваецца	*развіваецца	развивающемся	1
серыйная	*серыйная	серийная	1
размаўляць	*размаўляць	разговаривать	1
правым	*правым	правым	1
коткі	*коткі	кошки	1
хансю	*хансю	хонсю	1
чытаеш	*чытаеш	познаешь	1
сайтаў	*сайтаў	сайтам	1
вэбмайстры	*вэбмайстры	вебмастеры	1
татоэба	*татоэба	татоэба	1
праспрагаць	*праспрагаць	проспрягать	1
напаўняла	*напаўняла	наполняло	1
страляйце	*страляйце	стреляйте	1
іерогліфа	*іерогліфа	иероглифа	1
ютарныя	*ютарныя	компьютерные	1
адрэеску	*адрэеску	андрееску	1
узбекскую	*узбекскую	узбекскую	1
вольны	*вольны	свободное	1
думаюць	*думаюць	думают	1
сайтаў	*сайтаў	сайтов	1
колю	*колю	колю	1
фэйсбуцы	*фэйсбуцы	фейсбуке	1
прадбачыць	*прадбачыць	предсказать	1
хоч	*хоч	хоть	1
паясніў	*паясніў	объяснил	1
водзіць	*водзіць	водит	1
змірыцца	*змірыцца	смириться	1
збалансованага	*збалансованага	сбалансированного	1
мухамад	*мухамад	мухаммед	1
агурбаш	*агурбаш	агурбаш	1
