,	*чжуанцзы	,	31
ведаю	*ведаю	знаю	20
люся	*люся	люся	17
люблю	*люблю	люблю	16
ведае	*ведае	знает	10
клава	*клава	клава	10
купіў	*купіў	купил	9
бачыў	*бачыў	видел	9
знайсці	*знайсці	найти	8
твой	*твой	твой	8
народ	*абраны	народ	8
,	*адмаўляецца	,	7
,	*зярно	,	6
дзякуй	*дзякуй	спасибо	6
«	*замасціць	«	6
цао	*цао	цао	6
су	*су	су	6
падабаецца	*падабаецца	нравится	6
львоў	*львоў	львов	6
мушу	*мушу	должен	5
бэці	*бэці	бетти	5
педафілы	*педафілы	педофилы	5
зрабіць	*зрабіць	сделать	5
працуе	*працуе	работает	5
нюнорска	*нюнорска	нюнорска	5
бачыць	*бачыць	видеть	5
і	*раздрабіць	и	5
есці	*есці	есть	4
сказаць	*сказаць	сказать	4
люсі	*люсі	люси	4
ўмееш	*ўмееш	умеешь	4
роджэр	*роджэр	роджер	4
спаць	*спаць	спать	4
маркс	*маркс	маркс	4
працаваць	*працаваць	работать	4
піша	*піша	пишет	4
пісаць	*пісаць	писать	4
болей	*болей	больше	4
твая	*твая	твоя	4
ці	*піша	,	4
яані	*яані	яани	4
чуў	*чуў	слышал	4
ці	*чжуанцзы	,	4
,	*чжуанцзы	бабочка	4
ведаць	*ведаць	знать	4
заспяваем	*заспяваем	споём	4
i	*павi*нны	и	4
хаця	*хаця	хотя	4
йен	*йен	иен	4
вырашыць	*вырашыць	решить	4
выкарыстоўваючы	*выкарыстоўваючы	используя	4
вывалілася	*вывалілася	вывалилась	3
ведаеш	*ведаеш	знаешь	3
ціма	*ціма	тима	3
маеце	*маеце	вас	3
чытаць	*чытаць	читать	3
істота	*істота	существо	3
мюрыэл	*мюрыэл	мюриэл	3
дарэнда	*дарэнда	доренда	3
вольныя	*вольныя	свободные	3
пашанцавала	*пашанцавала	посчастливилось	3
абама	*абама	обама	3
гэткай	*гэткай	этакой	3
блог	*блог	блог	3
слухаць	*слухаць	слушать	3
звяртае	*звяртае	обращает	3
дазваляе	*дазваляе	позволяет	3
ці	*піша	что	3
рон	*рон	рон	3
»	*міхалова	»	3
і	*выйграйце	и	3
цзыю	*цзыю	цзыю	3
ці	*чжуанцзы	что	3
лічыць	*лічыць	считает	3
вокны	*вокны	окна	3
згадваць	*згадваць	вспоминать	3
паабяцалі	*паабяцалі	пообещали	3
расказаць	*расказаць	рассказать	3
браян	*браян	брайан	3
пӱртӱс	*пӱ*ртӱ*с	природа	3
эше	*эше	что	3
львове	*львове	львове	3
кнопки	*кнопки	кнопки	3
плаваць	*плаваць	плавать	3
кенам	*кенам	кен	3
дагэтуль	*дагэтуль	всё	3
бегаць	*бегаць	бегать	3
яані	*яані	геттер	3
абажае	*абажае	обожает	3
часам	*афарыст	,	3
ведалі	*ведалі	знали	3
выкарыстоўваецца	*выкарыстоўваецца	используется	3
існуе	*існуе	существует	3
марыць	*марыць	мечтает	3
вучыцца	*вучыцца	учиться	3
здарылася	*здарылася	случилось	3
з	*засноўнікаў	из	3
сустрэў	*сустрэў	встретил	3
чакаў	*чакаў	ждал	3
песьня	*песьня	песня	3
запрошваць	*запрошваць	приглашать	3
казаў	*казаў	говорил	3
размаўляць	*размаўляць	запретить	3
вывучаў	*вывучаў	изучал	3
дакранулася	*дакранулася	дотронулось	3
крынічным	*крынічным	исходными	3
прысніў	*прысніў	,	3
ці	*чжуанцзы	которой	3
еў	*еў	дракон	3
вырашыў	*вырашыў	решил	3
саромейся	*саромейся	стесняйся	3
патэлефанаваць	*патэлефанаваць	позвонить	3
стамляе	*стамляе	устал	3
выйгралі	*выйгралі	выиграли	3
сайце	*сайце	сайте	3
зайздросціла	*зайздросціла	завидовала	3
вучыцца	*вучыцца	учится	3
вывучае	*вывучае	изучает	3
ці	*чжуанцзы	которому	3
выкрадаюць	*выкрадаюць	похищают	3
адрозніваецца	*адрозніваецца	отличается	3
клясе	*клясе	классе	3
смяяліся	*смяяліся	смеялись	3
падабаюцца	*падабаюцца	нравятся	3
падабацца	*падабацца	нравится	3
анжаліка	*анжаліка	анжелика	3
звуць	*звуць	зовут	3
здаецца	*здаецца	кажется	3
характэрных	*характэрных	характерных	3
«	*ну	«	3
есці	*есці	завтрак	3
ненавідзела	*ненавідзела	ненавидела	3
найчасцей	*найчасцей	всего	3
свеціць	*свеціць	светит	3
адлюстроўваўся	*адлюстроўваўся	отражалась	2
рабі	*рабі	делай	2
разбіраецца	*разбіраецца	разбирается	2
таксама	*чжуанцзы	он	2
спрошчвае	*спрошчвае	упрощает	2
фарсі	*фарсі	да	2
забыўся	*забыўся	забыл	2
цямнее	*цямнее	темнеет	2
гаварыць	*гаварыць	говорить	2
анімэ	*анімэ	аниме	2
размаўляюць	*размаўляюць	говорят	2
пракампасціруйце	*пракампасціруйце	прокомпостируйте	2
пярсідская	*пярсідская	здравствует	2
разумею	*разумею	понимаю	2
сустрэць	*сустрэць	встретить	2
іх	*бачыць	видеть	2
«	*замасціць	»	2
даводзілі	*даводзілі	доказывали	2
выразаў	*выразаў	вырезал	2
йӧра	*йӧ*ра	хорошо	2
галандскай	*галандскай	голландского	2
заклей	*заклей	заклей	2
адшукаем	*адшукаем	разыщем	2
адрамантаваць	*адрамантаваць	починить	2
толькі	*свеціць	только	2
штаны	*штаны	штаны	2
ідэалогія	*ідэалогія	нюнорска	2
гыч	*гыч	никогда	2
московиц	*москови*ц	московиц	2
прашчае	*прашчае	прощает	2
тучы	*тучы	тучи	2
маеце	*маеце	имеете	2
мандалай	*мандалай	мандалай	2
акна	*акна	окно	2
нептуна	*нептуна	нептуна	2
інфармацію	*інфармацію	информацию	2
любіць	*любіць	любит	2
сцвярджае	*сцвярджае	утверждает	2
застаўляе	*застаўляе	бесчисленные	2
што	*наснілася	он	2
сцерці	*сцерці	стёрт	2
кахаю	*кахаю	люблю	2
сумуем	*сумуем	скучаем	2
патрэбныя	*патрэбныя	нужны	2
размаўляе	*размаўляе	разговаривает	2
тут	*ляплю	тут	2
фарамп	*фарамп	фарамп	2
мандарыны	*мандарыны	мандарины	2
прысніў	*прысніў	он	2
.	*ўжываць	.	2
папера	*папера	бумага	2
прапусціце	*прапусціце	пропустите	2
ці	*чжуанцзы	который	2
набліжаліся	*набліжаліся	близилось	2
акна	*акна	окна	2
«	*званым	«	2
адпавядае	*адпавядае	соответствует	2
не	*ўмее	умеет	2
іграць	*іграць	играть	2
выкарыстоўваемая	*выкарыстоўваемая	используемая	2
вандраваў	*вандраваў	путешествовал	2
каптурко	*каптурко	шапочко	2
пагаварыць	*пагаварыць	поговорить	2
загарэлася	*загарэлася	загорелась	2
абмеркаваць	*абмеркаваць	обсудить	2
дасцін	*дасцін	дастин	2
нюнорска	*нюнорска	для	2
для	*выкарыстоўвалі	для	2
сакрэт	*сакрэт	секрет	2
еш	*еш	ещё	2
годы	*годы	годах	2
індустрыялізацыя	*індустрыялізацыя	индустриализация	2
«	*дзякуй	-	2
татоэбе	*татоэбе	татоэбе	2
нюнорска	*нюнорска	флаг	2
любіць	*любіць	.	2
,	*чжуанцзы	снится	2
вашыя	*вашыя	ваши	2
маршалізаваных	*маршалізаваных	маршаллизованных	2
чытаеш	*чытаеш	читаешь	2
наставай	*наставай	настиной	2
ўнадзілася	*ўнадзілася	повадилась	2
называецца	*называецца	называется	2
спакушаюць	*спакушаюць	совращают	2
многіх	*многіх	многих	2
хтосьці	*хтосьці	кто-то	2
лётае	*лётае	летает	2
праплывалі	*праплывалі	проплывали	2
прашчаецца	*прашчаецца	прощается	2
нла	*нла	нло	2
гавары	*гавары	говори	2
шукала	*шукала	искала	2
салмана	*салмана	»	2
чакаў	*чакаў	ожидал	2
чжуанцзы	*чжуанцзы	чжуан-цзы	2
вучышся	*вучышся	.	2
ізраіль	*ізраіль	израиль	2
іслам	*іслам	ислам	2
ведаеце	*ведаеце	знаете	2
зрабіў	*зрабіў	сделал	2
для	*выкарыстоўвалі	исландский	2
сайту	*сайту	сайта	2
піклз	*піклз	пиклз	2
туман	*туман	туман	2
памыць	*памыць	помыть	2
опцыя	*опцыя	«	2
гма	*гма	являются	2
любіць	*любіць	отец	2
,	*чжуанцзы	пишет	2
ўвогуле	*ўвогуле	вообще	2
інапланецяне	*інапланецяне	инопланетяне	2
пярсідская	*пярсідская	да	2
душэ	*душэ	душе	2
люсе	*люсе	люсе	2
рыхтуе	*рыхтуе	готовит	2
меў	*меў	была	2
павiнны	*ставi*цца	поступать	2
ідэалогія	*ідэалогія	идеология	2
гучней	*гучней	громче	2
бэна	*бэна	бена	2
ляльку	*ляльку	куклу	2
здраджваў	*здраджваў	предавал	2
рэакцыю	*рэакцыю	реакцию	2
насіць	*насіць	носить	2
збольшваецца	*збольшваецца	увеличивается	2
дантэ	*дантэ	данте	2
адчыняй	*адчыняй	открывай	2
ў	*хмяльніцкі	в	2
задаваць	*задаваць	задавать	2
ці	*піша	который	2
нюнорска	*нюнорска	основывается	2
прытворымся	*прытворымся	притворимся	2
згубіў	*згубіў	потерял	2
пятроўшчына	*пятроўшчына	«	2
аж	*аж	аж	2
гуляць	*гуляць	играть	2
ці	*піша	которому	2
тваю	*тваю	твой	2
шарля	*шарля	шарля	2
сніць	*сніць	он	2
сарваныя	*сарваныя	сорванные	2
змірыцца	*змірыцца	смириться	2
нюнорска	*нюнорска	поскольку	2
твой	*твой	твоя	2
прамільгнула	*прамільгнула	промелькнуло	2
прагноза	*прагноза	прогноза	2
пераскаквае	*пераскаквае	перепрыгивает	2
сэрвісаў	*сэрвісаў	сервисов	2
ці	*чжуанцзы	иногда	2
джэк	*джэк	джек	2
супадае	*супадае	совпадает	2
называлі	*называлі	называли	2
прыгажэй	*прыгажэй	красивее	2
яны	*спяць	они	2
суседзі	*казалі	с	2
рабіў	*рабіў	делал	2
чакае	*чакае	ждет	2
півам	*чарапічным	пивом	2
товада	*товада	товада	2
звальняцца	*звальняцца	увольняться	2
твая	*твая	твоё	2
фарсі	*фарсі	здравствует	2
на	*казахскай	на	2
думае	*думае	,	2
—	*о	—	2
тваёй	*тваёй	твоей	2
пачытаць	*пачытаць	почитать	2
асвойваецца	*асвойваецца	осваивается	2
ці	*піша	кто	2
арганізаваць	*арганізаваць	устроить	2
чытаў	*чытаў	читал	2
чапай	*чапай	трогай	2
здымалі	*здымалі	снимали	2
марнаваць	*марнаваць	терять	2
трасці	*трасці	трясти	2
тудлан	*тудлан	наделила	2
раскіданыя	*раскіданыя	разбросаны	2
ён	*наснілася	снилось	2
акно	*акно	окно	2
жадаю	*жадаю	желаю	2
любіць	*любіць	мюриэл	2
юэбін	*юэбін	юэбин	2
часам	*афарыст	он	2
шчыра	*малюе	рисует	2
любіў	*любіў	любил	2
джэка	*джэка	джеком	2
салмана	*рушдзі	—	2
пройдзе	*пройдзе	пройдёт	2
азначалі	*азначалі	означали	2
майк	*майк	майк	2
нагадвае	*нагадвае	напоминает	2
буды	*буды	будды	2
ўзяў	*ўзяў	взял	2
валодае	*валодае	обладает	2
купляйце	*купляйце	покупайте	2
«	*ведаю	«	2
найдаўжэйшае	*найдаўжэйшае	самое	2
мілер	*мілер	миллер	2
галаснейшы	*галаснейшы	и	2
цёмны	*цёмны	тёмную	2
пашанцавала	*пашанцавала	повезло	2
шы	*шы	ши	2
спіць	*спіць	спит	2
зусім	*паміраць	совершенно	2
казахскай	*казахскай	казахском	2
знаходзіцца	*знаходзіцца	находится	2
вылез	*вылез	вылез	2
адрэж	*адрэж	отрежь	2
іншапланецяне	*іншапланецяне	инопланетяне	2
кашалёк	*згубi*ла	кошелёк	2
эўрабачаньня	*эўрабачаньня	евровидения	2
спрабаваў	*спрабаваў	пытался	2
чжуанцзы	*чжуанцзы	он	2
кракаў	*кракаў	краков	2
цёмныя	*цёмныя	тёмные	2
ці	*чжуанцзы	кто	2
марыў	*марыў	мечтал	2
соцрэалістычныя	*соцрэалістычныя	соцреалистические	2
заплятала	*заплятала	заплетала	2
балатавацца	*балатавацца	баллотироваться	2
забівае	*забівае	убивает	2
меў	*меў	меня	2
ӱскырт	ӱ*скырт	упрямого	2
дурыце	*дурыце	дурите	2
імперыялістамі	*імперыялістамі	империалистами	2
тут	*ляплю	леплю	2
забіваюць	*забіваюць	кончают	2
сӧрваленыт	*сӧ*рваленыт	упрашивали	2
дазваляе	*дазваляе	»	2
ідэальны	*ідэальны	идеальный	2
вучыў	*вучыў	учил	2
барысаўдрэва	*барысаўдрэва	борисовдрева	2
дазваляе	*выбраць	выбрать	2
срэбны	*срэбны	серебряную	2
адрэсу	*адрэсу	адрес	2
давядзецца	*давядзецца	придется	2
бачыш	*бачыш	видишь	2
прэзыдэнт	*прэзыдэнт	президент	2
пачынаецца	*пачынаецца	начинается	2
нараджаюцца	*нараджаюцца	рождаются	2
невялічкая	*невялічкая	небольшая	2
развешвае	*развешвае	развешивает	2
’	*яўляліся	звёздочки	2
падобнае	*падобнае	похожее	2
перо	*перо	перро	2
,	*чжуанцзы	приснилось	2
:	*славацкай	:	2
патрэбны	*патрэбны	нужен	2
зроблена	*зроблена	сделано	2
спазнаеш	*спазнаеш	познаешь	2
перакладаю	*перакладаю	перевожу	2
адрэдагавала	*адрэдагавала	отредактировала	2
знайшоў	*знайшоў	нашёл	2
найяскравейшая	*найяскравейшая	наиярчайшая	2
падобны	*падобны	похоже	2
дзверы	*дзверы	дверь	2
салмана	*рушдзі	рушди	2
дакраніся	*дакраніся	дотронься	2
тэрэза	*тэрэза	тереза	2
любляць	*любляць	любят	2
маша	*маша	маша	2
няўжо	*няўжо	неужели	2
называецца	*называецца	функция	2
думаеш	*думаеш	думаешь	2
гаворыць	*гаворыць	говорит	2
салмана	*салмана	салмана	2
з	*імітацыяй	с	2
засыхалі	*засыхалі	засыхали	2
ало	*ало	алло	2
набліжаліся	*набліжаліся	приближалось	2
апавядаў	*апавядаў	рассказывал	2
прадаюцца	*прадаюцца	продаются	2
патчам	*патчам	для	2
збіраюся	*збіраюся	собираюсь	2
жырафаў	*жырафаў	жирафов	2
абажаю	*абажаю	обожаю	2
інапланецянамі	*інапланецянамі	инопланетянами	2
уш	*уш	поцелуй	2
«	*замасціць	области	2
»	*міхалова	«	2
ён	*наснілася	он	2
лазанью	*лазанью	лазанью	2
без	*клавы	без	2
лі	*лі	ли	2
злезлі	*злезлі	слезли	2
нарадзілася	*нарадзілася	родилась	2
метро	*грушаўка	«	2
выкрадалі	*выкрадалі	похищали	2
рок	*рок	рок	2
«	*купляйце	покупайте	2
ці	*чжуанцзы	он	2
ці	*піша	которой	2
робяць	*робяць	делают	2
стае	*стае	становится	2
талончык	*талончык	талончик	1
’	*яўляецца	ли	1
міцкевіча	*міцкевіча	мицкевича	1
пацалаваў	*пацалаваў	мэри	1
галаснейшы	*галаснейшы	.	1
«	*ведаю	кто	1
падыходзіць	*падыходзіць	подходит	1
дагэтуль	*дагэтуль	кот	1
«	*ало	это	1
ганаруся	*ганаруся	горжусь	1
стуліў	*стуліў	сомкнул	1
«	*ну	так	1
роўтэр	*роўтэр	роутер	1
прайшло	*прайшло	праздник	1
слухайце	*слухайце	слушайте	1
паглядзеў	*паглядзеў	посмотрел	1
фнорд	*любіць	любит	1
спадарыне	*спадарыне	привет	1
здарылася	*здарылася	стряслось	1
дзякуй	*дзякуй		1
кансервы	*кансервы	консервы	1
таксама	*чжуанцзы	которой	1
бывай	*бывай	пока	1
сакрэт	*сакрэт	?	1
вырашаць	*вырашаць	решать	1
алаха	*алаха	аллаха	1
сато	*сато	сато	1
палягае	*палягае	в	1
някляева	*някляева	некляева	1
пачаставаць	*пачаставаць	что	1
рамашку	*рамашку	ромашку	1
зроблены	*зроблены	сделан	1
сакрэт	*сакрэт	тайну	1
,	*македонскай	,	1
сустракаю	*сустракаю	встречаю	1
мухамад	*мухамад	мухаммед	1
педафілы	*педафілы	,	1
забывай	*забывай	забывай	1
здольны	*здольны	способен	1
любіць	*любіць	время	1
адгуджана	*адгуджана	,	1
камп	*камп	компьютерные	1
гуляў	*гуляў	играл	1
фарсі	*фарсі	фарси	1
гаворыць	*гаворыць	.	1
прагноза	*прагноза		1
што	*наснілася	которому	1
маеш	*маеш	тебя	1
бегай	*бегай	бегай	1
чак-чак	*чак-*чак	чак-чак	1
разнознівае	*разнознівае	различает	1
«	*мачыць	мочить	1
абралі	*абралі	выбрали	1
балела	*балела	болело	1
канкурэнтаздатнасці	*канкурэнтаздатнасці	казахстана	1
срэбнымі	*срэбнымі	серебряными	1
—	*о	так	1
пробуй	*пробуй	пробуй	1
імперыялізму	*імперыялізму	империализма	1
’	*сказала	что	1
прыносяць	*прыносяць	приносят	1
збаўце	*збаўце	убавьте	1
i	*павi*нны	поступать	1
французкай	*французкай	языке	1
тэт-а-тэт	*тэт-а-*тэт	тет-а-тет	1
гольф	*гольф	гольф	1
,	*адмаўляецца	угостить	1
кенам	*кенам	-	1
спакушаюць	*спакушаюць	малолетних	1
пан	*тадэвуш	»	1
працаваць	*працаваць	хочется	1
працаваць	*працаваць	продолжала	1
ушым	*ушым	умом	1
павялічылася	*павялічылася	увеличилось	1
пакажы	*пакажы	покажи	1
ставiцца	*адзi*н	в	1
слухаеце	*слухаеце	слушаете	1
разражаджаная	*разражаджаная	разряжена	1
іерогліфа	*іерогліфа	иероглифа	1
ніла	*ніла	после	1
спакушае	*спакушае	совращает	1
праяўляліся	*праяўляліся	проявлялись	1
прасты	*прасты	...	1
бегае	*бегае	быстрее	1
патэлефаную	*патэлефаную	перезвоню	1
разлічваць	*разлічваць	рассчитывать	1
вучуся	*вучуся	учусь	1
дапамогай	*спаму	спама	1
жарэ	*жарэ	жрёт	1
прысніся	*прысніся	приснись	1
гаварыў	*гаварыў	говорил	1
таннейшых	*таннейшых	нет	1
тараторыць	*тараторыць	тараторит	1
моваў	*моваў	мире	1
ем	*ем	ем	1
некурцоў	*некурцоў	курящих	1
павольней	*павольней	медленнее	1
зайздросціць	*зайздросціць	завидует	1
лжывую	*лжывую	на	1
«	*мяню	«	1
жывёш	*жывёш	живёшь	1
выставу	*выставу	выставку	1
зарадзілася	*зарадзілася	зародилась	1
думала	*думала	думала	1
маляваць	*маляваць	рисовать	1
перамагаем	*перамагаем	побеждаем	1
садзіць	*садзіць	сажает	1
французкай	*французкай	французском	1
гэй	*гэй	эй	1
леў	*леў	прыгнул	1
гуляць	*гуляць	сегодня	1
злітуйцеся	*злітуйцеся	работали	1
прысягнуў	*прысягнуў	поклялся	1
салмана	*рушдзі	салмана	1
(	*здавалася	казалось	1
люблю	*люблю	кофе	1
выкідвай	*выкідвай	выбрасывай	1
выставу	*выставу	«	1
пачаставаць	*пачаставаць	и	1
насіць	*насіць	,	1
змяняе	*змяняе	меняет	1
кушеч	*кушеч	взялся	1
вольны	*вольны	в	1
каптурко	*каптурко	гримм	1
часам	*афарыст	иногда	1
паўнаэкранных	*паўнаэкранных	полноэкранных	1
нигунамат	*ни*гунамат	не	1
вучышся	*вучышся	день	1
высланае	*высланае	добрыми	1
бо	*прамакутная	не	1
»	*міхалова	михалово	1
«	*дзякуй	``"	1
натхнення	*ісландскую	вдохновения	1
паспаць	*паспаць	поспать	1
еў	*еў	ел	1
бабруйск	*бабруйск	бобруйска	1
працаваў	*працаваў	работал	1
вучыць	*вучыць	учит	1
—	*скажа	скажет	1
выкарыстоўваецца	*выкарыстоўваецца	страдательный	1
пан	*тадэвуш	пан	1
,	*адмаўляецца	работников	1
еш	*еш	этих	1
ніводнага	*ніводнага	проспрягать	1
пуэн	*пуэн	.	1
сустракаюцца	*сустракаюцца	встречаются	1
размаўляйце	*размаўляйце	говорите	1
салоная	*салоная	солёная	1
кашгары	*кашгары	кашгаре	1
знявага	*знявага	неприемлемы	1
абміналі	*абміналі	обходили	1
ідэалогія	*ідэалогія	мой	1
выбрукавана	*выбрукавана	вымощена	1
нарадзіўся	*нарадзіўся	и	1
пераўсталёўваць	*пераўсталёўваць	переустанавливать	1
тыгай	*тыгай	такой	1
праэкт	*праэкт	проект	1
адлюстроўвае	*адлюстроўвае	отражает	1
маеце	*маеце	хочется	1
прыдзе	*прыдзе	придёт	1
купіў	*купіў	на	1
што	*зрабіць	сделать	1
прысніў	*прысніў	бабочка	1
так	*лінсхотэне	потому	1
дазваляе	*выбраць	позволяет	1
высланае	*высланае	выстлан	1
што	*зрабіць	многое	1
ці	*піша	долго	1
павiнны	*ставi*цца	равными	1
разумнейшы	*разумнейшы	билл	1
адгуджана	*адгуджана	миновать	1
гэта	*адсвяткаваць	отпраздновать	1
насіць	*насіць	стал	1
размаўляе	*размаўляе	действительно	1
любое	*любое	любое	1
забіваюць	*забіваюць	с	1
сумую	*сумую	скучаю	1
«	*яндекс	«	1
орэст	*орэст	орест	1
дваццаць	*дваццаць	десять	1
прагаласаваў	*прагаласаваў	проголосовал	1
пракампасціруйце	*пракампасціруйце	,	1
ведаць	*ведаць	?	1
шчыра	*малюе	,	1
хапае	*хапае	хватает	1
размаўляць	*размаўляць	во	1
цэліцеся	*цэліцеся	целитесь	1
выпей	*выпей	,	1
маеш	*маеш	ты	1
зліць	*зліць	нравится	1
пан	*тадэвуш	тадеуш	1
,	*дзякуй	спасибо	1
інтэрнэце	*інтэрнэце	интернете	1
ці	*чжуанцзы	бабочка	1
закохвалася	*закохвалася	влюблялась	1
пуэн	*пуэн	острым	1
спазнаеш	*спазнаеш	читаешь	1
нават	*разумееш	понимаешь	1
’	*яўляецца	является	1
адчуў	*адчуў	непрошенным	1
зарабляю	*зарабляю	евро	1
выдзяўбе	*выдзяўбе	выклюет	1
пачаставаць	*пачаставаць	чтобы	1
зліць	*зліць	злить	1
о	*о	о	1
паслясмак	*паслясмак	горькое	1
яўляецца	*яўляецца	.	1
гледжання	*гледжання	с	1
мроя	*мроя	мечта	1
леў	*леў	лев	1
(	*здавалася	(	1
часам	*афарыст	которому	1
борам	*борам	бором	1
безнадзейныя	*безнадзейныя	безнадёжны	1
.	*нязгодных	банят	1
азначалі	*азначалі	наречии	1
«	*ведаю	знаю	1
пятроўшчына	*пятроўшчына	откроют	1
опцыя	*опцыя	опция	1
высахлі	*высахлі	высохли	1
фэйсбуцы	*фэйсбуцы	вас	1
ўзяў	*ўзяў	я	1
ствараеце	*ствараеце	создаёте	1
знайдзе	*знайдзе	найдёт	1
крыўдуеш	*крыўдуеш	недоволен	1
іўрыт	*іўрыт	иврит	1
згубіў	*згубіў	кошелёк	1
пагуляць	*пагуляць	поиграть	1
шэі	*шэі	шеи	1
твой	*твой	случайно	1
снедаў	*снедаў	завтракал	1
«	*ну	сегодня	1
еҥым	*еҥ*ым	человека	1
метро	*грушаўка	»	1
бегае	*бегае	бегает	1
сайт	*сайт	свой	1
жадаеце	*жадаеце	увидеть	1
размаўляюць	*размаўляюць	языке	1
па	*засудзяць	по	1
баюся	*баюся	боюсь	1
бракуе	*бракуе	нас	1
пачаставаць	*пачаставаць	,	1
вучацца	*вучацца	учатся	1
і	*раздрабіць	стремясь	1
заблукаеш	*заблукаеш	заблудишься	1
сэзон	*сэзон	сезон	1
таксама	*чжуанцзы	тоже	1
замяняем	*замяняем	заменяем	1
лонадана	*лонадана	лондона	1
разумнейшы	*разумнейшы	умнее	1
.	*зрабіў	бы	1
пафарбаваць	*пафарбаваць	своей	1
асноўваецца	*асноўваецца	.	1
паўнаэкранных	*паўнаэкранных	,	1
садавінай	*садавінай	.	1
«	*дзякуй	''"	1
арктыцы	*арктыцы	арктике	1
расчыняецца	*расчыняецца	растворяется	1
павяртайся	*павяртайся	возвращайся	1
мюрыэл	*мюрыэл	время	1
міліцыянтам	*міліцыянтам	милиционером	1
спакушаюць	*спакушаюць	,	1
актор	*актор	актер	1
паглядзела	*паглядзела	посмотрела	1
цао	*цао	.	1
казалі	*казалі	другой	1
шэкспіра	*шэкспіра	шекспира	1
іен	*іен	иен	1
чакала	*чакала	ждала	1
адрамантаваць	*адрамантаваць	я	1
сніць	*сніць	которому	1
цытаваць	*цытаваць	цитировать	1
зарабляў	*зарабляў	зарабатывал	1
шахматы	*шахматы	шахматы	1
ровар	*ровар	велосипед	1
паснедаў	*паснедаў	позавтракал	1
траціць	*траціць	тратит	1
болей	*болей	предпочитаю	1
давядзецца	*іначай	умирать	1
гатуеце	*гатуеце	готовите	1
сустрэла	*сустрэла	встретила	1
творыць	*творыць	творит	1
памыляецца	*памыляецца	ошибается	1
некурцоў	*некурцоў	некурящих	1
таксама	*чжуанцзы	иногда	1
складаюць	*складаюць	составляют	1
немагчымы	*немагчымы	невозможен	1
рупіць	*рупіць	болит	1
паміраць	*давядзецца	умирать	1
чыла	*чыла	сердечный	1
прадбачыць	*прадбачыць	предсказать	1
тваёй	*тваёй	стало	1
таннейшых	*таннейшых	подешевле	1
гэта	*адсвяткаваць	флаг	1
пачаставаць	*пачаставаць	хозяин	1
інтэрнэце	*інтэрнэце	на	1
застаўляе	*застаўляе	заставляет	1
прыдумваў	*прыдумваў	придумывал	1
бібліяй	*бібліяй	библии	1
кажуць	*кажуць	говорят	1
хадзем	*хадзем	что	1
чалавеканенавісных	*чалавеканенавісных	человеконенавистнических	1
гатаваць	*гатаваць	готовить	1
толькі	*свеціць	светло	1
львоўскіх	*львоўскіх	львовских	1
часам	*афарыст	или	1
схавалася	*схавалася	спряталось	1
«	*званым	черепичным	1
ўмее	*ўмее	умеет	1
імкнучыся	*імкнучыся	вооружение	1
зрабіла	*зрабіла	сделала	1
памятаеце	*памятаеце	помните	1
ўстанавілі	*ўстанавілі	установили	1
метро	*грушаўка	метро	1
ведаеш	*ведаеш	ты	1
так	*лінсхотэне	теперь	1
ён	*наснілася	иногда	1
памятаеш	*памятаеш	помнишь	1
купіце	*купіце	купите	1
хуйні	*хуйні	хуйни	1
замасціць	*замасціць	замостить	1
дазваляе	*дазваляе	.	1
ускладае	*ускладае	надежды	1
хапае	*хапае	у	1
загойваюцца	*загойваюцца	заживают	1
іскрыць	*іскрыць	искрит	1
ніхто	*насамрэч	никто	1
лжывую	*лжывую	ложную	1
агурбаш	*агурбаш	агурбаш	1
лукашэнка	*лукашэнка	лукашенко	1
ганаруся	*ганаруся	и	1
жоднага	*жоднага	одного	1
купіць	*купіць	должны	1
карлас	*карлас	карлос	1
сталых	*сталых	зрелых	1
запрашаем	*запрашаем	приглашаем	1
згубіўшы	*згубіўшы	потеряв	1
’	*яўляліся	застенчивые	1
знявага	*знявага	``	1
бачылі	*бачылі	видели	1
«	*меркую	я	1
’	*яўляліся	появлялись	1
існуе	*існуе	она	1
толькі	*свеціць	,	1
ядуць	*ядуць	едят	1
сымпатычных	*сымпатычных	симпатичных	1
аватары	*аватары	аватаре	1
праблемаў	*праблемаў	проблем	1
пярсідская	*пярсідская	фарси	1
акторам	*акторам	актером	1
любіць	*любіць	нравится	1
застаўляе	*застаўляе	роптать	1
ліпнуць	*ліпнуць	львовских	1
дзякуй	*дзякуй	слава	1
ізалентай	*ізалентай	изолентой	1
рамсэс	*рамсэс	рамсес	1
нарадзіўся	*нарадзіўся	родился	1
львоўскі	*львоўскі	львовский	1
па	*засудзяць	осудят	1
адрэеску	*адрэеску	госпоже	1
пачаставаць	*пачаставаць	когда	1
асноўваецца	*асноўваецца	для	1
татоэба	*татоэба	татоэба	1
паясніў	*паясніў	объяснил	1
ушым	*ушым	его	1
страляйце	*страляйце	погодите	1
гуцы	*гуцы	лишь	1
паміраць	*давядзецца	совершенно	1
мыю	*мыю	стираю	1
«	*замасціць	растянуть	1
не	*ўмее	не	1
крывёў	*крывёў	кровей	1
садиктак	сади*ктак	,	1
’	*яўляюцца	являются	1
дэзарганізаваць	*дэзарганізаваць	силы	1
хм-м-м	*хм-*м-*м	хм-м-м	1
хуана	*хуана	хуана	1
ютарныя	*ютарныя	вдохновить	1
выбрукавана	*выбрукавана	благими	1
давялося	*давялося	пришлось	1
турбуй	*турбуй	беспокой	1
квінтэсенцыя	*квінтэсенцыя	квинтэссенция	1
паслужыць	*паслужыць	история	1
пафарбаваць	*пафарбаваць	покрасить	1
бракуе	*бракуе	недостаточно	1
дажыву	*дажыву	дожить	1
булачку	*булачку	булочку	1
выпей	*выпей	выпей	1
іўрыт	*іўрыт	выучить	1
расії	*расії	предложение	1
збіраць	*збіраць	собирать	1
.	*нязгодных	несогласных	1
пазычыць	*пазычыць	одолжить	1
перасунь	*перасунь	передвинь	1
сказана	*сказана	говорится	1
куй	*куй	куй	1
»	*рэкламавалі	с	1
імкнучыся	*імкнучыся	консервы	1
сталася	*сталася	.	1
алан	*алан	алан	1
горкая	*горкая	чай	1
чытаю	*чытаю	читаю	1
чытаў	*чытаў	ни	1
дабранач	*дабранач	доброй	1
ён	*ну	не	1
дажыву	*дажыву	мне	1
опцыя	*опцыя	области	1
разнознівае	*разнознівае	добро	1
—	*о	уже	1
карысны	*карысны	полезный	1
абяцала	*абяцала	обещало	1
мусім	*мусім	мы	1
салмана	*салмана	рушди	1
калі	*лічыць	что	1
еўрабачанне	*еўрабачанне	2011	1
ўчасна	*ўчасна	хоть	1
зарубі	*зарубі	заруби	1
таксама	*чжуанцзы	которому	1
прысніў	*прысніў	которому	1
чакаючы	*чакаючы	дожидаясь	1
маеце	*маеце	друзей	1
эстонскай	*эстонскай	эстонском	1
водзіць	*водзіць	плохо	1
імперыялістамі	*імперыялістамі	маршаллизованных	1
занепакоілася	*занепакоілася	встревожилась	1
імкнучыся	*імкнучыся	демократии	1
найдаўжэйшае	*найдаўжэйшае	какое	1
смяяліся	*смяяліся	девочкой	1
чытаць	*чытаць	привычка	1
гуцы	*гуцы	этом	1
завецца	*завецца	шелковницей	1
твайго	*твайго	твоего	1
адчуў	*адчуў	чувствовал	1
,	*чжуанцзы	—	1
выкарыстоўвуючы	*выкарыстоўвуючы	используя	1
»	*папсавалі	»	1
вучышся	*вучышся	?	1
блытаюць	*блытаюць	средства	1
сніць	*сніць	которой	1
прасты	*прасты	простой	1
павiнны	*ставi*цца	совестью	1
спадарыне	*спадарыне	андрееску	1
выбраць	*выбраць	выбрать	1
сайтаў	*сайтаў	сайтов	1
что	*что	что	1
ці	*піша	бабочка	1
зсср	*зсср	ссср	1
бачыла	*бачыла	видела	1
львоў	*львоў	львове	1
ўзяў	*ўзяў	зонтик	1
цікавіць	*цікавіць	интересует	1
дазваляе	*дазваляе	выбрать	1
патрык	*патрык	патрик	1
паглядзіце	*паглядзіце	посмотрите	1
ліпнуць	*ліпнуць	липнут	1
суседзі	*казалі	соседи	1
ставiцца	*адзi*н	друг	1
ззяюць	*ззяюць	сияют	1
спяшайся	*спяшайся	торопись	1
вучуся	*вучуся	занимаюсь	1
вылез	*вылез	пелёнок	1
двузначная	*двузначная	?	1
тваю	*тваю	твою	1
моё	*моё	мой	1
правым	*правым	правым	1
дажджыстым	*дажджыстым	.	1
неправы	*неправы	неправ	1
«	*замасціць	размерами	1
выпей	*выпей	чаю	1
баіцца	*баіцца	идти	1
адрэдагавала	*адрэдагавала		1
львоўскіх	*львоўскіх	.	1
«	*дзякуй	``	1
саромеецца	*саромеецца	стесняется	1
дык	*наце	.	1
сустрэну	*сустрэну	встречу	1
зрабіў	*зрабіў	ошибся	1
вольны	*вольны	время	1
замасціць	*замасціць	«	1
слухаў	*слухаў	слушал	1
прысніў	*прысніў	или	1
тэхас	*тэхас	техас	1
свойго	*свойго	.	1
есць	*есць	есть	1
’	*яўляюць	остановки	1
«	*замасціць	,	1
павінну	*павінну	должны	1
узводзіць	*узводзіць	клевещет	1
людзi	*людзi	и	1
колю	*колю	колю	1
абароненасць	*абароненасць	защищённость	1
ставіцца	*ставіцца	флаг	1
блытаюць	*блытаюць	путают	1
ня	*ня	в	1
маеце	*маеце	комнат	1
сурокі	*сурокі	порчу	1
абяцала	*абяцала	ей	1
тваім	*тваім	твоём	1
i	*павi*нны	правах	1
здрадзіў	*здрадзіў	ты	1
львоўскай	*львоўскай	львовской	1
баіцца	*баіцца	боится	1
кушеч	*кушеч	ты	1
на	*казахскай	выходит	1
.	*наступстваў	.	1
парламентская	*парламентская		1
людзi	*людзi	все	1
інфекцыя	*інфекцыя	инфекция	1
плавае	*плавае	плавает	1
замёрзнеш	*замёрзнеш	замёрзнешь	1
заспявай	*заспявай	спой	1
дадаваць	*дадаваць	добавлять	1
бэці	*бэці	убила	1
чакайце	*чакайце	ждите	1
нигунамат	*ни*гунамат	забудется	1
імкнучыся	*імкнучыся	но	1
што	*наснілася	иногда	1
змніць	*змніць	единицы	1
карпаты	*карпаты	карпаты	1
парламентская	*парламентская	парламентская	1
натхнення	*ісландскую	нюнорска	1
гледжання	*гледжання	точки	1
водзіць	*водзіць	жена	1
ісландскім	*ісландскім	исландским	1
яўляецца	*яўляецца	коран	1
сайтаў	*сайтаў	языке	1
ніякіх	*серадах	и	1
губка	*губка	губка	1
«	*ну	похоронили	1
пазнаёміць	*пазнаёміць	познакомить	1
пабачыць	*пабачыць	увидеть	1
роўтэр	*роўтэр	новый	1
на	*казахскай	на"	1
паслухаць	*паслухаць	послушать	1
сайт	*сайт	сайт	1
працую	*працую	работаю	1
нефертары	*нефертары	нефертари	1
паважаюць	*паважаюць	уважают	1
ведаюць	*ведаюць	знают	1
перастрыбнуў	*перастрыбнуў	прыгнул	1
адзна	*адзна	-	1
маеце	*маеце	у	1
распаўсюджвайце	*распаўсюджвайце	распространяйте	1
дажджыстым	*дажджыстым	вечером	1
даведацца	*даведацца	узнать	1
садиктак	сади*ктак	всё	1
парагвай	*парагвай	парагвай	1
падлі…	*падлі…	подлей…	1
салмана	*салмана	стихи	1
максымальным	*максымальным	максимальном	1
станавілася	*станавілася	не	1
паслясмак	*паслясмак	послевкусие	1
даведаецца	*даведаецца	узнает	1
пацалуй	*пацалуй	поцелуй	1
кузэн	*кузэн	кузен	1
хапае	*хапае	слов	1
«	*ало	алло	1
лічу	*лічу	думаю	1
заняволіць	*заняволіць	поработить	1
дагэтуль	*дагэтуль	бы	1
доўга	*праснуўшыся	проснувшись	1
размаўляе	*размаўляе	говорят	1
ўмееш	*ўмееш	кататься	1
«	*меркую	-	1
сварыць	*сварыць		1
прайшоў	*прайшоў	прошла	1
юпітэра	*юпітэра	.	1
писе	*пи*се	его	1
ісландскім	*ісландскім	,	1
часам	*афарыст	которой	1
чы	*чы	может	1
»	*міхалова	петровщина	1
дагэтуль	*дагэтуль	сих	1
таму	*заразіў	заразил	1
косы	*косы	косы	1
здарыўся	*здарыўся	позавчера	1
дагэтуль	*дагэтуль	ещё	1
ну	*ну	ну	1
шыпоў	*шыпоў	шипов	1
«	*ну	уже	1
можа	*зрабіць	людям	1
чыла	*чыла	попусту	1
падманулі	*падманулі	обманули	1
пытарен	*пытарен	все	1
опцыя	*опцыя	с	1
еўра	*еўра	евро	1
размаўляю	*размаўляю	говорю	1
адказвае	*адказвае	отвечает	1
частуе	*частуе	строителей	1
педафілы	*педафілы	совращают	1
хварэю	*хварэю	болею	1
цалаваў	*цалаваў	целовал	1
зайздросціць	*зайздросціць		1
адпраўляецца	*адпраўляецца	отправляется	1
цзыю	*цзыю	ши	1
дажджыстым	*дажджыстым	друге	1
чжуанцзы	*чжуанцзы	которой	1
«	*купляйце	«	1
падлічваюць	*падлічваюць	подсчитывают	1
тый	*тый	ты	1
завецца	*завецца	называется	1
свойго	*свойго	покрасить	1
бардэлі	*бардэлі	борделе	1
ён	*наснілася	же	1
ажарабілася	*ажарабілася	кобыла	1
раблю	*раблю	делаю	1
працоўнага	*працоўнага	сокращении	1
суматра	*суматра	суматра	1
справіўся	*справіўся	справился	1
цвятаева	*цвятаева	цветаева	1
чжуанцзы	*чжуанцзы	которому	1
думаў	*думаў	думал	1
накрытая	*накрытая	была	1
здымаем	*здымаем	снимаем	1
пазычыце	*пазычыце	одолжите	1
мюрыэл	*мюрыэл	меня	1
давяраю	*давяраю	доверяю	1
«	*мачыць	«	1
ездзе	*адзначана	что	1
прыводзіць	*прыводзіць	приводит	1
адзна	*адзна	из	1
павiнны	*ставi*цца	правах	1
дазваляе	*выбраць	режим	1
.	*досвед	.	1
писе	*пи*се	острым	1
гуляем	*гуляем	играем	1
сядайце	*сядайце	садитесь	1
функцыянальнасцю	*функцыянальнасцю	функциональностью	1
гарбату	*гарбату	чай	1
адрамантуй	*адрамантуй	почини	1
вырашылі	*вырашылі	решили	1
нараджаюцца	*нараджаюцца	равными	1
ці	*чжуанцзы	долго	1
ўношу	*ўношу	вношу	1
дык	*дык	так	1
бойся	*бойся	бойся	1
ўсталяваў	*ўсталяваў	установил	1
ведаем	*ведаем	знаем	1
так	*лінсхотэне	нет	1
расеі	*расеі	много	1
талончык	*талончык	взял	1
твае	*твае	твои	1
імперыялісты	*імперыялісты	империалисты	1
ці	*чжуанцзы	или	1
паглядзі	*паглядзі	посмотри	1
патрэбная	*патрэбная	нужна	1
прасцейшая	*прасцейшая	,	1
чжуанцзы	*чжуанцзы	иногда	1
ісландскім	*ісландскім	не	1
іра	*іра	ира	1
аконца	*аконца	.	1
радактараў	*радактараў	редакторов	1
дажджыстым	*дажджыстым	каждым	1
хадановіч	*хадановіч	хаданович	1
львове	*львове	во	1
шы	*шы	цзыю	1
зарабляю	*зарабляю	зарабатываю	1
часам	*афарыст	бабочка	1
прысніў	*прысніў	которой	1
бізнэсмэн	*бізнэсмэн	бизнесмен	1
пагадзяцца	*пагадзяцца	согласятся	1
выправіш	*выправіш	исправишь	1
амфітрыты	*амфітрыты	амфитриты	1
датычыцца	*датычыцца	касается	1
дэзарганізаваць	*дэзарганізаваць	дезорганизовать	1
зсср	*зсср	здравствует	1
наліваю	*наліваю	наливаю	1
жоднага	*жоднага	читал	1
ўдзячны	*ўдзячны	благодарен	1
найноўшыя	*найноўшыя	новейшие	1
застаецца	*застаецца	остаётся	1
«	*мачыць	в	1
размаўляе	*размаўляе	говорит	1
страляючы	*страляючы	стреляя	1
,	*чжуанцзы	чжуан-цзы	1
знае	*знае	знает	1
садавінай	*садавінай	фруктами	1
сайтаў	*сайтаў	сайтам	1
працаваць	*працаваць	разговаривать	1
пройдзе	*пройдзе	казани	1
несмачная	*несмачная	невкусный	1
траціць	*траціць	изучая	1
забівай	*забівай	убивай	1
страляйце	*страляйце	стреляйте	1
ён	*наснілася	которому	1
i	*павi*нны	совестью	1
«	*меркую	``	1
улучыць	*улучыць	попасть	1
разумееш	*разумееш	понимаешь	1
что	*что	большинства	1
пракампасціруйце	*пракампасціруйце	многоразового	1
думаюць	*думаюць	думают	1
фаната	*фаната	фаната	1
шортын	*шортын	выплакала	1
чалавеканенавісных	*чалавеканенавісных	теорий	1
актуальная	*актуальная	практичен	1
звяртаць	*звяртаць	обращать	1
вольны	*вольны	свободное	1
карысней	*карысней	полезнее	1
небачная	*небачная	.	1
ажаніцца	*ажаніцца	.	1
ці	*піша	или	1
казалі	*казалі	соседи	1
істота	*істота	выдуманное	1
праносіць	*праносіць	проносить	1
пералічаныя	*пералічаныя	,	1
цікавіць	*цікавіць		1
імкнучыся	*імкнучыся	раздробить	1
жоднага	*жоднага	ни	1
чытаючы	*чытаючы	читая	1
асноўваецца	*асноўваецца	основывается	1
стуліў	*стуліў	до	1
ібрагім	*ібрагім	ибрагим	1
што	*наснілася	которой	1
лянуецца	*лянуецца	ленится	1
гарбаткі	*гарбаткі	.	1
брусэль	*брусэль	брюссель	1
еҥым	*еҥ*ым	упрямого	1
праглядзець	*праглядзець	посмотреть	1
гма	*гма	гмо	1
ведаць	*ведаць	мою	1
стае	*стае	:	1
адчуваў	*адчуваў	чувствовал	1
дэзарганізаваць	*дэзарганізаваць	и	1
наводзіць	*наводзіць	на	1
стала	*падтрымліваць	поддерживать	1
спорта	*спорта	спорта	1
пашуковая	*пашуковая	поисковая	1
сакрэт	*сакрэт	очень	1
дацкі	*дацкі	,	1
галандыя	*галандыя	голландия	1
раксалана	*раксалана	роксолана	1
купіць	*купіць	купить	1
водзіць	*водзіць	водит	1
каўтае	*каўтае	глотает	1
мусім	*мусім	должны	1
»	*рэкламавалі	рекламировали	1
чуеш	*чуеш	слышишь	1
навелы	*навелы	новеллы	1
найчасцей	*найчасцей	чаще	1
праглядзець	*праглядзець	которые	1
узвесці	*узвесці	оклеветать	1
чжуанцзы	*чжуанцзы	бабочка	1
пярсідская	*пярсідская	персидский	1
казалі	*казалі	говорили	1
давялося	*давялося	dmenu	1
i	*павi*нны	равными	1
іўрыце	*іўрыце	иврите	1
ведаў	*ведаў	знал	1
размаўляе	*размаўляе	на	1
есць	*есць	ест	1
ўдвох	*ўдвох	вдвоём	1
мёртвы	*мёртвы	мёртв	1
падараваў	*падараваў	подарил	1
паказвае	*паказвае	означает	1
перастрыбнуў	*перастрыбнуў	скрозь	1
так	*лінсхотэне	!	1
абяцаў	*абяцаў	обещал	1
яго	*ведалі	знали	1
паспяшайся	*паспяшайся	поспеши	1
шупшалмаш	*шупшалмаш	сердечный	1
плаваюць	*плаваюць	плавают	1
й	*й	таков	1
паліць	*паліць	курить	1
натхніць	*натхніць	на	1
.	*зрабіў	.	1
ён	*наснілася	которой	1
моё	*моё	отец	1
лёгкіх	*лёгкіх	от	1
прысніў	*прысніў	иногда	1
«	*замасціць	расположение	1
фнорд	*любіць	фнорд	1
рэлігіёзны	*рэлігіёзны	религиозный	1
ускладае	*ускладае	возлагает	1
купіў	*купіў	в	1
тайландзе	*тайландзе	таиланде	1
састарэлых	*састарэлых	пожилых	1
праносіць	*праносіць	нельзя	1
прыпыніце	*прыпыніце	прекратите	1
ня	*ня	не	1
ён	*наснілася	она	1
зефір	*зефір	зефир	1
будавалася	*будавалася	строилась	1
сварыць	*сварыць	ругает	1
весці	*весці	вести	1
прыгатаваннем	*прыгатаваннем	пищи	1
сустракаюцца	*сустракаюцца	ещё	1
асноўваецца	*асноўваецца	на	1
вядзе	*вядзе	ведёт	1
здарылася	*здарылася	.	1
знайшлі	*знайшлі	нашли	1
праспрагаць	*праспрагаць	проспрягать	1
натхнення	*ісландскую	использовали	1
’	*яўляліся	.	1
прапіў	*прапіў	пропил	1
купіў	*купіў	интересую	1
празрэнні	*празрэнні	своих	1
адрэж	*адрэж	отмерь	1
так	*лінсхотэне	так	1
дабудзь	*дабудзь	добудь	1
саэб	*саэб	саэб	1
высушу	*высушу	высушу	1
зсср	*зсср	да	1
’	*яўляюцца	прямоугольниками	1
тайская	*тайская	тайский	1
судзячы	*судзячы	судя	1
перазваню	*перазваню	перезвоню	1
дзверы	*дзверы	двери	1
напаўняла	*напаўняла	наполняло	1
ставіцца	*ставіцца	.	1
захутка	*захутка	слишком	1
працуюць	*працуюць	работают	1
прыносіць	*прыносіць	приносит	1
дырку	*дырку	дырку	1
коткі	*коткі	кошки	1
доўга	*праснуўшыся	который	1
здрадзіў	*здрадзіў	предал	1
задумваюся	*задумваюся	задумываюсь	1
наводзіць	*наводзіць	клевещет	1
фарсі	*фарсі	персидский	1
ці	*піша	иногда	1
ўмею	*ўмею	умею	1
вянуць	*вянуць	вянут	1
«	*замасціць	показа	1
пасля	*абеда	после	1
мяняецца	*мяняецца	меняется	1
стала	*падтрымліваць	.	1
сайтам	*сайтам	сайтом	1
закахаўся	*закахаўся	влюбился	1
ня	*ня	верю	1
блытаюць	*блытаюць	так	1
,	*дзякуй	,	1
дацкай	*дацкай	не	1
фнорд	*фнорд	google	1
сніць	*сніць	иногда	1
гаворыць	*гаворыць	быстро	1
гыч	*гыч	не	1
дацкай	*дацкай	датским	1
»	*рэкламавалі	»	1
ведаеце	*ведаеце	случайно	1
’	*сказала	из	1
пацалаваў	*пацалаваў	поцеловал	1
падабаецца	*падабаецца	,	1
снедае	*снедае	завтракает	1
натхнення	*ісландскую	для	1
мінесоце	*мінесоце	миннесоте	1
замасціць	*замасціць	области	1
выпісваюць	*выпісваюць	на	1
горкая	*горкая	горький	1
пачаставаць	*пачаставаць	а	1
хапае	*хапае	недостаточно	1
замяняем	*замяняем	исландским	1
ніякіх	*серадах	дух	1
падабаўляць	*падабаўляць	подобавлять	1
шинчавӱдыжым	*ши*нчавӱ*дыжым	она	1
адрэеску	*адрэеску	!	1
выпісваюць	*выпісваюць	выписывают	1
узвесці	*узвесці	трудящиеся	1
узбекскую	*узбекскую	узбекскую	1
акторам	*акторам	великим	1
маскаль	*маскаль	москаль	1
уш	*уш	никогда	1
найяскравейшая	*найяскравейшая	самая	1
любляць	*любляць	этот	1
сандра	*сандра	сандра	1
купляючы	*купляючы	покупая	1
цао	*цао	хитрость	1
зрабіць	*зрабіць	,	1
траціў	*траціў	тратил	1
ніводнага	*ніводнага	одного	1
шукаў	*шукаў	искал	1
пачаставаць	*пачаставаць	ставят	1
паслужыць	*паслужыць	послужит	1
мёртвы	*мёртвы	мёртвая	1
наняты	*наняты	сивый	1
чаю	*чаю	чаю	1
грэю	*грэю	грею	1
прайшло	*прайшло	прошёл	1
будзеш	*вучыцца	учиться	1
паліць	*паліць	из-за	1
лектынат	*лектынат	взялся	1
распрацаваная	*распрацаваная	разработана	1
развіваецца	*развіваецца	развивающемся	1
адхілілася	*адхілілася	отпрянула	1
улучыць	*улучыць	слишком	1
прыдумаць	*прыдумаць	придумать	1
чытаеш	*чытаеш	познаешь	1
адвучыўся	*адвучыўся	отучился	1
сварыць	*сварыць	?	1
«	*дзякуй	!	1
татоэба	*татоэба	предназначена	1
шнобелеўскую	*шнобелеўскую	шнобелевскую	1
пятроўшчына	*пятроўшчына	»	1
меў	*меў	него	1
адмаўляць	*адмаўляць	отрицать	1
частуе	*частуе	угощает	1
фэйсбуцы	*фэйсбуцы	фейсбуке	1
выкалі	*выкалі	выколи	1
размаўляю	*размаўляю	разговариваю	1
чакае	*чакае	победителя	1
’	*яўляюць	объявляют	1
пазнаў	*пазнаў	познал	1
збалансованага	*збалансованага	сбалансированного	1
зліць	*зліць	меня	1
выйграць	*выйграць	выиграть	1
заматай	*заматай	замотай	1
пятнаццаць	*пятнаццаць	пятнадцать	1
штосьці	*штосьці	что-то	1
размаўлялі	*размаўлялі	разговаривали	1
чую	*чую	слышу	1
«	*купляйце	белорусское	1
будзеш	*вучыцца	будешь	1
свойго	*свойго	своей	1
усталявалі	*усталявалі	тесный	1
параўнайце	*параўнайце	сравните	1
траян	*траян	троян	1
й	*й	и	1
ідэалогія	*ідэалогія	для	1
вучышся	*вучышся	учишься	1
пераходзь	*пераходзь	переходи	1
пазнаёміліся	*пазнаёміліся	познакомились	1
прысудзіў	*прысудзіў	приговорил	1
серыйная	*серыйная	серийная	1
—	*о	похоронили	1
чакаў	*чакаў	бена	1
суседзі	*казалі	:	1
бялізну	*бялізну	белье	1
фнорд	*фнорд	фнорд	1
,	*адмаўляецца	флаг	1
асноўваецца	*асноўваецца	идеология	1
вэбмайстры	*вэбмайстры	вебмастеры	1
мяжуюць	*мяжуюць	граничат	1
чыла	*чыла	равно	1
бракуе	*бракуе	у	1
звяжуся	*звяжуся	свяжусь	1
ўзнікла	*ўзнікла	возникла	1
садиктак	сади*ктак	равно	1
ідэалогія	*ідэалогія	.	1
дык	*дык	—	1
