гэта	эта	это	91
не	не	нет	23
яе	неё	её	18
гэта	этот	это	15
няма	нету	нет	11
нам	зам	нам	11
яна	яна	она	10
у	в	во	10
больш	более	больше	9
яму	яму	ему	9
слова	слово	слова	9
ж	ж	же	7
гэтым	этим	этом	7
песню	пёсню	песню	6
кветкі	цветка	цветы	6
гетэр	гетер	геттер	6
дрэва	дерево	дерева	6
тысячы	тысяче	тысячи	5
сваё	своё	свое	5
выкарыстання	использования	пользования	5
ўсё	всё	все	5
ёй	ней	ей	5
магу	маге	могу	5
раней	ранее	раньше	5
неба	небо	неба	4
іх	них	их	4
два	два	две	4
дамашняе	домашнего	домашнее	4
,	звезды	звёзды	4
май	май	имей	4
нядзелі	воскресенье	воскресеньям	4
мая	мая	моя	3
гарачая	горячая	горячий	3
французскую	французскую	французский	3
адзін	один	одна	3
свабоднымi	свободнымi	свободными	3
зоркі	звезды	звёзды	3
напісаны	написанный	написана	3
школьныя	школьные	школьных	3
ты	бы	ты	3
пра	о	об	3
варожага	вражеского	вражеский	3
раніцы	утре	утро	3
нямецкая	немецкая	немецкий	3
згвалтаванне	изнасилование	изнасиловании	3
возера	озеро	озера	3
выдуманая	вымышленная	вымышленное	3
парку	парк	парке	3
цябе	тебя	тебе	3
ўмее	них	их	3
выгляду	вида	виду	3
найлепшы	наилучший	лучший	3
яго	его	него	3
адчыненымі	открытыми	открытой	2
гэтым	этим	этому	2
правы	права	прав	2
чырвонае	красной	красное	2
захаду	запада	западу	2
горкі	горки	горькое	2
розныя	разные	различных	2
звычку	привычку	привычка	2
я	наладок	настроек	2
ў	в	во	2
прысеў	присев	присел	2
футболе	футболе	футболу	2
вадзіцы	водице	водицы	2
элегантная	элегантная	элегантна	2
ўсход	восток	востоку	2
начальніка	начальника	начальником	2
павярнулася	повернулась	вернулась	2
мінулым	прошлым	прошлом	2
беларускае	белорусской	белорусское	2
мой	мой	мою	2
адно	одно	один	2
ваш	ваш	ваше	2
свае	свои	своих	2
беларускую	белорусскую	белорусский	2
нямецкую	немецкую	немецкий	2
выклічце	вызывайте	вызовите	2
пара	пара	пора	2
наша	наш	наша	2
агародніна	овощ	овощи	2
купляйце	белорусской	белорусское	2
усё	всё	все	2
яшчэ	ещё	еще	2
гэтая	это	эта	2
кодам	кодом	кодами	2
гэтае	этой	этот	2
прапанову	предложение	предложении	2
ўсё	всё	всю	2
ўвагі	внимания	внимание	2
важная	важная	важны	2
спадару	господине	господину	2
поспеху	успехе	успехам	2
знішчаны	уничтоженный	уничтожен	2
кошыку	корзинке	корзине	2
адзін	один	одно	2
дзіцяці	ребёнке	ребёнка	2
нашае	нашей	наша	2
ён	он	она	2
нашу	нашу	нашей	2
бок	сторона	сторону	2
марка	марка	марко	2
іх	них	ним	2
вялікі	большой	большое	2
агні	огне	огни	2
пераклала	переложила	перевела	2
мне	мне	меня	2
ўсім	всем	всём	2
таму	поэтому	потому	2
якой	которой	которому	2
апетыту	аппетита	аппетиту	2
.	порнографию	порнографии	2
сястра	сестра	сестры	2
пытанні	вопросе	вопросу	2
дзяцінства	детство	детстве	2
том	том	тома	2
праблемы	проблемы	проблем	2
прэзідэнта	президента	президенты	2
большы	больший	больше	2
сваім	своим	своём	2
манга	манго	манга	2
садзе	саде	саду	2
за	в	во	2
нашым	нашими	нашим	2
маё	моё	моём	2
мір	всем	всём	2
адкрытым	открытым	открытыми	2
такая	такая	такой	2
ці	или	ли	2
сотні	сотне	сотни	2
слізкае	скользкой	скользкое	2
звязнай	связной	связным	2
гэтыя	эти	это	2
дзяржаўны	государственное	государственный	2
гэты	этот	это	2
дзіця	ребёнок	ребёнка	2
добрую	хорошую	хорошая	2
вывучаць	изучат	изучать	2
таксама	также	тоже	2
тоні	тоне	тони	2
меркаванні	мнении	мнения	2
калекцыю	коллекцию	коллекция	2
ва	в	во	2
электрамеханіку	электромеханике	электромеханику	2
зачыніце	закроете	закройте	2
буракі	свёклы	свеклу	2
сказ	предложение	предложении	2
мэры	мэры	мэри	2
офісу	офису	офиса	2
лісця	листа	листьев	2
песні	пёсне	песни	2
папала	попала	попало	2
удавы	удавы	вдовы	2
пакоі	комнате	комнаты	2
сведчанні	свидетельстве	свидетельства	2
парнаграфію	детскую	детской	2
небяспечныя	опасные	опасными	2
жудаснага	ужасного	ужасному	2
вядомы	известный	известен	2
майму	моему	моим	2
здароўя	эта	это	2
англійскай	английским	английском	2
вядомае	известной	известно	2
французская	французская	французский	1
карычневы	коричневый	коричневое	1
«	нету	нет	1
налева	налево	влево	1
я	едет	ездит	1
жыхарства	жительство	жительства	1
замка́	замка́	замка	1
той	тот	той	1
нямецкай	немецким	немецкого	1
была	была	было	1
ветраных	ветреных	ветряных	1
гэты	эта	эту	1
паляпшэнне	улучшение	улучшении	1
працы	работе	работы	1
гатовы	готовый	готов	1
часу	времени	времён	1
жыццё	электричестве	электричества	1
мой	моё	мой	1
поўная	полный	полна	1
маці	мать	матери	1
вывучыць	изучить	научиться	1
цягам	них	их	1
прыродныя	природные	природными	1
ўзвышэнне	возвышение	возвышении	1
сем	ней	ей	1
што	которому	которой	1
але	но	не	1
мой	мой	моя	1
кітай	китай	китае	1
набыла	приобрела	обрела	1
пайсці	пойти	уйти	1
дапамогуць	помогут	поможет	1
акружаная	окружённая	окружена	1
расце	растёт	растет	1
шматразовага	многократного	многоразового	1
што	что	то	1
матэматыку	математике	математики	1
замежных	иностранных	иностранным	1
рускай	русским	русском	1
папала	попала	покупал	1
вайну	войну	войне	1
шакаладнае	шоколадного	шоколадное	1
вялікім	большим	большом	1
носе	носе	носу	1
перакладуць	переложат	переведут	1
здаровым	здоровым	здоровом	1
верыць	верить	верит	1
багатая	богатая	богат	1
чарапіцы	укладки	кладке	1
кароткае	короткой	коротка	1
гэта	эта	этот	1
белае	белого	белое	1
мой	мой	моей	1
песнямі	пёснями	песнями	1
новыя	новые	новых	1
ўласную	собственную	собственном	1
найлепшая	наилучшая	наилучший	1
месцы	месте	места	1
дзень	ночью	ночь	1
паказаў	показов	показал	1
пялёнак	пелён	пелёнок	1
рэсурсы	ресурсы	ресурсами	1
добрая	хорошая	хороша	1
лета	лето	лета	1
парасонам	зонтиком	зонтом	1
кожная	каждая	каждой	1
бульбу	картофель	картофеле	1
што	эта	это	1
дзіцяці	ребёнке	ребёнку	1
свой	свой	своё	1
полымя	пламя	полымя	1
працягнула	продолжила	продолжала	1
непрымальныя	неприемлемые	неприемлемы	1
кітайскай	китайской	китайском	1
палічцы	полочке	полке	1
песня	пёсня	песня	1
японію	японию	японии	1
настаўніку	учителе	учителю	1
такі	токи	таким	1
надзеі	надежде	надежды	1
ўваходзіць	входить	входит	1
паклёп	клевета	клевещет	1
кроку	шаге	шага	1
важныя	важные	важны	1
хлусіць	врать	врёт	1
грым	грим	гримм	1
папулярная	популярная	популярна	1
гаворцы	речи	наречии	1
забаронены	запрещённый	запрещен	1
правёў	провёл	провел	1
гатовае	готовой	готов	1
блакітнае	голубой	голубое	1
мару	мечту	мечта	1
эзатэрычных	эзотерических	экзотерических	1
рускай	русской	русском	1
гісторыя	общество	общества	1
розумам	умом	разумом	1
зброі	оружии	оружия	1
вялікі	большой	большая	1
люстэрка	зеркало	зеркальце	1
беларускай	белоруской	белорусской	1
зачынены	закрытый	закрыт	1
цягніку	часы	часов	1
будучыні	будущем	будущего	1
прыхільнікаў	силки	силы	1
хоць	хотя	хоть	1
ружы	розе	розы	1
направа	направо	вправо	1
госці	гостье	гости	1
праліў	пролив	пролил	1
кут	угол	уголок	1
афарызмы	который	которой	1
выпадковыя	случайные	случайны	1
зайцы	зайце	зайцы	1
афарызмы	который	которому	1
пабудову	общество	общества	1
тэрміновая	срочная	срочное	1
банку	банке	банку	1
прыпынак	остановка	остановку	1
.	свет	светло	1
щто	щто	что	1
нядобры	нехороший	хороший	1
тым	тем	чем	1
будзе	будет	пребудет	1
заплюшчыце	закроете	закройте	1
сэрца	сердце	сердцу	1
вуліцах	улицах	улицам	1
метра	метра	метро	1
што	что	кто	1
гарачы	горячий	горящий	1
побыту	быта	быту	1
золата	золото	золота	1
адмоўнае	отрицательной	отрицательное	1
вывучыць	изучить	выучить	1
нашым	нашим	нашем	1
роўна	ровно	равно	1
—	эта	это	1
мужу	муже	мужу	1
гультай	лентяй	ленивый	1
чацвёртым	четвёртым	четвёртом	1
«	они	она	1
каментарыям	комментариям	комментарии	1
рэжым	отражения	изображения	1
сапраўднае	настоящей	настоящая	1
чым	чем	тем	1
свайго	своей	свою	1
чалавека	человека	человеку	1
старшыні	председателе	председателю	1
абдурыла	одурачила	обдурила	1
мэры	мэры	мери	1
ранняй	ранним	раннем	1
цікавую	интересную	интересую	1
гэтае	этого	этот	1
польшчы	польше	польши	1
.	несчастья	несчастий	1
застаўся	остался	осталось	1
сучасным	современным	современном	1
нямецкай	немецкой	немецкого	1
сучаснай	литературе	литературы	1
японскую	японскую	японский	1
гады	гады	годы	1
сваёй	своей	своими	1
забаронены	запрещённый	запрещён	1
)	чужим	чужом	1
высновы	вывода	выводу	1
вуліц	паутины	паутине	1
новая	новая	нова	1
пераможца	победитель	победителя	1
вымаўленні	произношении	произношения	1
вядомы	известный	известным	1
эгаістычная	эгоистичная	эгоистична	1
паляцеў	улетел	полетел	1
якой	которой	котором	1
турэцкай	турецкой	турецком	1
купляў	покупок	покупал	1
лепшы	лучший	лучше	1
яе	неё	ней	1
пакой	комната	комнату	1
танная	дешёвая	дешёвый	1
татарскай	татарским	татарском	1
мясцовым	местным	местном	1
заняпад	упадок	упадке	1
зрабіў	эта	это	1
беларусі	тем	этим	1
птушка	птица	птичка	1
лацінская	латинская	латинский	1
блізарукі	близорукий	близорук	1
думаю	думой	думаю	1
ездзіць	ездить	ездит	1
гэта	это	этого	1
кітайскай	китайским	китайского	1
ўрокам	уроком	урокам	1
старадаўняй	старинной	старинном	1
пачаўся	начался	началось	1
адмерай	отмерь	отрежь	1
глыбокае	глубокой	глубокое	1
перакладзіце	переложите	переведите	1
апошнім	последним	последнее	1
краі	крайу	края	1
дні	дне	дня	1
цётка	тётка	тётя	1
з	детство	детства	1
шчаслівы	счастливый	счастлив	1
хвіліну	минуту	минутку	1
прыгоннае	крепостного	крепостное	1
кніга	книга	книжка	1
песні	пёсне	песне	1
зялёную	зелёную	зелёный	1
богу	боге	богу	1
азёрамі	озёрами	озерами	1
спявае	поёт	поет	1
найлепшая	наилучшая	лучшая	1
разы	разы	раза	1
прыйдзе	придёт	придет	1
значку	значке	значку	1
скончыць	закончить	завершить	1
бацька	отец	отца	1
роўнымi	ровнымi	равными	1
наша	наша	наше	1
аднаразовага	одноразового	многоразового	1
сваім	своим	своей	1
фізкультуры	физкультуре	физкультуры	1
навошта	зачем	почему	1
значэнні	значении	значения	1
гарах	гарях	горах	1
партыі	тёсным	тесном	1
пытанні	вопросе	вопросы	1
апытаных	опрошенных	опрашиваемых	1
табе	тебе	тебя	1
рацыю	рацию	рация	1
гэта	эти	это	1
расплюшчыце	откроете	откройте	1
шаўкоўніцай	шелковицей	шелковницей	1
японскай	японской	японского	1
лепшая	лучшая	лучше	1
што	что	это	1
невялікім	небольшим	небольшом	1
розных	разных	различных	1
сябе	себя	себе	1
краіна	страна	страны	1
бадзёры	бодрый	бодрящий	1
саміх	них	их	1
песенным	песенным	песенном	1
раману	роману	романа	1
на	на	бена	1
станоўчае	положительной	положительное	1
багатая	богатая	богата	1
сваёй	своим	своего	1
англійская	английская	английский	1
маім	моим	моём	1
