к	*к	до	92
до	*до	до	59
три	*три	три	37
наш	*наш	наш	21
ни	*ни	ні	19
здесь	*здесь	тут	17
токио	*токио	токіо	17
теннис	*теннис	теніс	14
взять	*взять	взяти	14
файоло	*файоло	файоло	12
мистер	*мистер	містер	12
ко	*ко	до	12
некоторые	*некоторые	деякі	12
поехал	*поехал	поїхав	12
пить	*пить	пити	11
рано	*рано	рано	11
плавать	*плавать	плавати	11
эсперанто	*эсперанто	есперанто	11
наши	*наши	наші	11
устал	*устал	втомився	11
дезмонд	*дезмонд	десмонд	10
меленянах	*меленянах	меленянах	10
ласло	*ласло	лазло	10
читать	*читать	читати	10
дверь	*дверь	двері	9
ваших	*ваших	ваших	9
,	*наш	,	9
мэри	*мэри	мері	9
домой	*домой	додому	9
вернусь	*вернусь	повернуся	9
изучать	*изучать	вивчати	9
поехать	*поехать	поїхати	9
боится	*боится	боїться	9
вернулся	*вернулся	повернувся	9
последний	*последний	останній	8
рад	*рад	радий	8
скучаю	*скучаю	сумую	8
жирка	*жирка	жирку	8
детки	*детки	діти	8
ваши	*ваши	ваші	8
потерял	*потерял	загубив	8
пожалуйста	*пожалуйста	будь	8
к	*к	на	8
зонтик	*зонтик	парасольку	8
яани	*яани	яані	8
нашем	*нашем	нашому	8
зонтик	*зонтик	парасолю	7
женился	*женился	одружився	7
геттер	*геттер	геттер	7
выглядишь	*выглядишь	виглядаєш	7
ни	*ни	не	7
париже	*париже	парижі	7
киото	*киото	кіото	7
робинзон	*робинзон	робінзон	7
касабланке	*касабланке	касабланці	7
нашей	*нашей	нашої	7
нью-йорке	*нью-*йорке	нью-йорку	7
боюсь	*боюсь	боюся	7
спросил	*спросил	спитав	7
америке	*америке	америці	7
разве	*разве	хіба	7
японец	*японец	японець	6
чашку	*чашку	чашку	6
мадам	*мадам	мадам	6
ненавижу	*ненавижу	ненавиджу	6
читаю	*читаю	читаю	6
наша	*наша	наша	6
вернётся	*вернётся	повернеться	6
петр	*петр	петре	6
сэм	*сэм	семе	6
завтрашнего	*завтрашнего	завтрашнього	6
жирка	*жирка	жирко	6
комары	*комары	комарі	6
попробуй	*попробуй	спробуй	6
помню	*помню	пам'ятаю	6
.	*блестит	.	6
взял	*взял	взяв	6
интернете	*интернете	інтернеті	6
тони	*тони	тоні	6
ошибок	*грамматических	помилок	6
проснулся	*проснулся	прокинувся	6
понятием	*абстрактным	поняттям	6
ваш	*ваш	ваш	6
нашим	*нашим	нашим	6
похожи	*похожи	схожі	6
поговорить	*поговорить	поговорити	6
столько	*столько	стільки	6
плакала	*плакала	плакала	5
изучить	*изучить	вивчити	5
троих	*троих	трьох	5
изучает	*изучает	вивчає	5
уйти	*уйти	піти	5
,	*ширина	,	5
свободное	*свободное	вільний	5
вышел	*вышел	вийшов	5
шкафу	*шкафу	шафі	5
наше	*наше	наше	5
ни	*ни	жодної	5
вино	*вино	вино	5
подумать	*подумать	подумати	5
водить	*водить	водити	5
украли	*украли	вкрали	5
бред	*бред	маячіння	5
другой	*другой	іншого	5
бывает	*бывает	буває	5
вашего	*вашего	вашого	5
старше	*старше	старіший	5
возьми	*возьми	візьми	5
эй	*эй	гей	5
доволен	*доволен	задоволений	5
первобытный	*первобытный	первісна	5
понтон	*понтон	понтон	5
гордон	*гордон	гордон	5
америки	*америки	америки	5
придурок	*придурок	придурок	5
любом	*любом	будь-якому	5
будто	*будто	немов	5
пешком	*пешком	пішки	5
вернется	*вернется	повернеться	5
обожает	*обожает	обожнює	5
ни	*ни	жодного	5
японцев	*японцев	японців	5
ушли	*ушли	пішли	5
бездянка	*бездянка	бездянка	5
курить	*курить	.	5
встаю	*встаю	встаю	5
незнакомец	*незнакомец	незнайомець	5
последние	*последние	останні	5
мег	*мег	мег	5
джим	*джим	джим	5
поймал	*поймал	спіймав	5
магнитофон	*магнитофон	магнітофон	4
»	*смородина	»	4
яблочный	*яблочный	яблучний	4
,	*подумал	,	4
марки	*марки	марки	4
дочитал	*дочитал	дочитав	4
лыжах	*лыжах	лижах	4
гитаре	*гитаре	гітарі	4
валентино	*валентино	валентино	4
изучают	*изучают	вивчають	4
пальто	*пальто	пальто	4
пианино	*пианино	піаніно	4
ланд	*ланд	лунд	4
чешется	*чешется	свербить	4
нидерланды	*нидерланды	нідерланди	4
опаздывает	*опаздывает	спізнюється	4
жарко	*жарко	спекотно	4
рено	*рено	рено	4
франция	*франция	франція	4
.	*дилма	.	4
сладкий	*сладкий	солодкий	4
сэр	*сэр	сер	4
ударила	*ударила	вдарила	4
потерялся	*потерялся	загубився	4
рыбалку	*рыбалку	рибалити	4
вашу	*вашу	вашу	4
выбежал	*выбежал	вибіг	4
штатов	*штатов	штатів	4
молния	*молния	блискавка	4
футов	*футов	футів	4
одиноко	*одиноко	самотньо	4
свитер	*свитер	светр	4
блажеи	*блажеи	блажеї	4
вышла	*вышла	вийшла	4
бейсбол	*бейсбол	бейсбол	4
ушла	*ушла	пішла	4
гольф	*гольф	гольф	4
какой	*какой	який	4
несла	*несла	несла	4
и	*первооткрыватели	і	4
соскучился	*соскучился	скучив	4
родителей	*родителей	.	4
шейфер	*шейфер	шефер	4
нэнси	*нэнси	ненсі	4
бэтти	*бэтти	бетті	4
плакать	*плакать	плакати	4
выглядит	*выглядит	виглядає	4
кен	*кен	кен	4
кейт	*кейт	кейт	4
сфотографировать	*сфотографировать	сфотографувати	4
головы	*головы	голови	4
мюриэл	*мюриэл	мюріел	4
воспользоваться	*воспользоваться	скористатися	4
двери	*двери	двері	4
старше	*старше	старший	4
ехать	*ехать	їхати	4
гордится	*гордится	пишається	4
братиславе	*братиславе	братиславі	4
франков	*франков	франків	4
лежит	*лежит	лежить	4
десятиминутный	*десятиминутный	десять	4
танцевала	*танцевала	танцювала	4
ричард	*ричард	річард	4
трубку	*трубку	слухавку	4
угодно	*угодно	завгодно	4
ваше	*ваше	ваше	4
и	*пиджак	і	4
париж	*париж	париж	4
других	*других	інших	4
какого	*какого	якого	4
какой	*какой		4
лекарство	*лекарство	ліки	4
петя	*петя	пєтя	4
львове	*львове	львів	4
хотелось	*хотелось	хотілося	4
клади	*клади	клади	4
ребят	*ребят	хлопці	4
хоккайдо	*хоккайдо	хоккайдо	4
бабочку	*бабочку	метелика	4
светится	*светится	світиться	4
шоколадное	*шоколадное	шоколадне	4
бетти	*бетти	бетті	4
мухи	*мухи	мухи	4
лучший	*лучший	найкращий	4
и	*стеснительные	і	4
волнуйся	*волнуйся	хвилюйся	4
жениться	*жениться	одружитися	4
поздравил	*поздравил	привітав	4
коротка	*коротка	коротке	4
здравствуй	*здравствуй	вітаю	3
убраться	*убраться	прибрати	3
арти	*арти	арті	3
участие	*участие	взяти	3
поймал	*поймал	три	3
рождеством	*рождеством	новим	3
водоросли	*водоросли	водорості	3
рождества	*рождества	різдва	3
беле	*беле	белі	3
кататься	*кататься	кататися	3
просыпаетесь	*просыпаетесь	прокидаєшся	3
одолжить	*одолжить	позичити	3
тратишь	*тратишь	витрачаєш	3
ближайшая	*ближайшая	найближча	3
влюбился	*влюбился	закохався	3
обратили	*обратили	звернули	3
напрокат	*напрокат	напрокат	3
вставать	*вставать	вставати	3
туда	*забиться	туди	3
мокрое	*мокрое	мокрого	3
изобрёл	*изобрёл	винайшов	3
соскучился	*соскучился	я	3
необходимо	*необходимо	необхідно	3
поплаваем	*поплаваем	поплаваємо	3
новоявленный	*новоявленный	новоспечена	3
тихом	*тихом	тихому	3
казани	*казани	казані	3
шахматы	*шахматы	грає	3
улыбнулась	*улыбнулась	посміхнулася	3
грязные	*грязные	брудне	3
испекла	*испекла	зробила	3
успеть	*успеть	встигнути	3
передохли	*передохли	поморилася	3
дней	*до	днів	3
дом	*собственный	дім	3
буханку	*буханку	буханця	3
белиной	*белиной	белиної	3
выбирать	*гноя	вибирати	3
мари	*мари	марі	3
руководитель	*классный	керівник	3
простудился	*простудился	застудився	3
боязливые	*бываем	боязкі	3
возле	*возле	біля	3
навестить	*навестить	провідати	3
менее	*менее	менш	3
замужем	*замужем	одружена	3
деном	*деном	деном	3
последнюю	*последнюю	останню	3
удалось	*удалось	вдалося	3
помни	*помни	пам	3
теннис	*теннис	граю	3
будто	*будто	наче	3
клином	*клином	клином	3
встаёт	*встаёт	встає	3
вырастила	*вырастила	виростила	3
цветомузыка	*цветомузыка	квіткоджаз	3
,	*потому	,	3
наполеона	*наполеона	наполеона	3
пташки	*пташки	пташки	3
»	*грушевка	»	3
белу	*белу	белу	3
майк	*майк	майк	3
и	*людских	та	3
изучаю	*изучаю	вивчаю	3
спросил	*спросил	запитав	3
вечность	*вечность	вічність	3
австралии	*австралии	австралії	3
лжец	*лжец	брехун	3
украл	*украл	вкрав	3
бабье	*москву	бабине	3
плыть	*плыть	плисти	3
,	*боязливые	,	3
понравился	*понравился	колір	3
долькой	*долькой	долькою	3
болит	*болит	болить	3
кулешов	*аркадий	кулешов	3
альто	*альто	альто	3
приемник	*приемник	приймач	3
соскучился	*соскучился	за	3
двоичная	*двоичная	двоїчне	3
феррари	*феррари	феррарі	3
жалует	*жалует	тії	3
купаться	*купаться	купатись	3
,	*настойчива	,	3
буй	*буй	буй	3
ванной	*ванной	ванній	3
закладок	*социальных	закладок	3
свыкнись	*свыкнись	звикнути	3
нашей	*нашей	нашій	3
нам	*даждь	нам	3
иван	*иван	іван	3
анджей	*анджей	анджей	3
это	*откладывал	це	3
наш	*наш	наша	3
предпочла	*предпочла	зволіла	3
кобыла	*кобыла	кобила	3
многоразового	*проездного	багаторазового	3
мост	*мост	міст	3
поводу	*поводу	здавання	3
пикник	*пикник	пікнік	3
»	*михалово	»	3
наверстать	*наверстать	надолужити	3
,	*меленянах	,	3
ржаветь	*ржаветь	ржавіти	3
уладьте	*уладьте	владнайте	3
грозовыми	*грозовыми	горобині	3
яйца	*жарить	яйця	3
сухопутных	*сухопутных	наші	3
другой	*другой	з	3
сани	*сани	сани	3
поспать	*поспать	поспати	3
гусеница	*гусеница	гусениця	3
и	*пусто	і	3
другие	*другие	інші	3
простые	*простые	прості	3
свободна	*свободна	вільна	3
полной	*полной	повної	3
и	*боязливые	і	3
танцевал	*танцевал	танцював	3
перезвоню	*перезвоню	передзвоню	3
летать	*летать	літати	3
одноразового	*прокомпостируйте	одноразового	3
пожаловать	*пожаловать	просимо	3
опиум	*опиум	опіум	3
танцует	*танцует	танцює	3
похолодает	*похолодает	похолодає	3
бывал	*бывал	бував	3
синим	*синим	синіх	3
сбежал	*сбежал	втік	3
бирманских	*бирманских	бірманських	3
убежать	*убежать	втекти	3
приложиться	*приложиться	прикластися	3
древнейшая	*древнейшая	найдайвніше	3
опоздал	*опоздал	запізнився	3
голову	*голову	голову	3
ваш	*ваш	ваша	3
презирать	*презирать	зневажати	3
джейн	*джейн	джейн	3
колумб	*колумб	колумб	3
тише	*тише	тихіше	3
какой	*какой	яке	3
просить	*просить	просити	3
потребуется	*потребуется	знадобиться	3
чурбан	*чурбан	добешку	3
спросил	*спросил	-	3
домовладелец	*домовладелец	домовласник	3
ах	*ах	ах	3
женат	*женат	одружений	3
таневич	*таневич	танєвич	3
потеряла	*потеряла	втратила	3
потерять	*потерять	втратити	3
целый	*целый	цілий	3
оставил	*угарте	залишив	3
парижа	*парижа	парижа	3
услышать	*услышать	почути	3
глупые	*глупые	нерозумні	3
зубную	*зубную	зубну	3
кимоно	*кимоно	кімоно	3
задать	*задать	поставити	3
светит	*светит	світить	3
покататься	*покататься	проїхатися	3
атласе	*атласе	атласі	3
.	*благоденствовать	.	3
отправляюсь	*отправляюсь	вирушаю	3
всякое	*всякое	всяке	3
красивая	*красивая	красива	3
узбекскую	*узбекскую	узбецьку	3
исключительно	*питаются	виключно	3
,	*футуролог	,	3
мягким	*мягким	м	3
древние	*древние	стародавні	3
мороженое	*мороженое	морозиво	3
диалект	*диалект	діалект	3
устроитесь	*устроитесь	приживетесь	3
полного	*полного	повного	3
отключил	*отключил	відключив	3
потеря	*потеря	втрата	3
прошу	*прошу	перепрошую	3
насекомых	*насекомых	комах	3
дворовый	*дворовый	дворовий	3
граничит	*граничит	межує	3
и	*нору	й	3
некоторых	*некоторых	деяких	3
перекатился	*перекатился	’	3
стеснительные	*стеснительные	соромливі	3
просыпаются	*просыпаются	прокидаються	3
касабланки	*касабланки	касабланки	3
гораздо	*гораздо	набагато	3
антенны	*антенны	антени	3
спальни	*спальни	спальні	3
синее	*синее	синє	3
сумерках	*сумерках	сутінках	3
командный	*командный	командний	3
лиллиэн	*лиллиэн	лілліен	3
женаты	*женаты	одружені	3
мило	*мило	міло	3
дочери	*три	доньки	3
одолжил	*одолжил	позичив	3
испекла	*испекла	приготувала	3
выпал	*выпал	випав	3
пропустить	*пропустить	пропустити	3
,	*травмирован	,	3
истории	*нашей	землі	3
зацветёт	*зацветёт	заквітне	3
люси	*люси	люсі	3
однажды	*однажды	одного	3
меряет	*меряет	міряє	3
дневника	*нашего	щоденника	3
клубе	*клубе	клубі	3
геттер	*геттер	ґеттер	3
а	*мертвым	а	3
пахнет	*пахнет	пахне	3
тернии	*тернии	терни	3
,	*скучаем	,	3
коем	*коем	якому	3
?	*получилось	?	3
очередь	*последнюю	чергу	3
проник	*проник	проникнув	3
любом	*любом	у	3
я	*наливаю	я	3
читал	*читал	читав	3
вкусно	*вкусно	смачно	3
слепая	*слепая	сліпа	3
билл	*билл	біл	3
,	*закладок	,	3
буди	*буди	буди	3
празднуется	*празднуется	святкується	3
зелёной	*зелёной	зеленою	3
понадобится	*понадобится	знадобиться	3
сербии	*сербии	сербії	3
производят	*производят	виготовляють	3
бы	*понадобился	би	3
коул	*коул	коул	3
врун	*врун	брехун	3
сноповяза	*сноповяза	скиртяра	3
период	*ледниковый	період	3
поскорее	*поскорее	скоріше	3
различным	*различным	різних	3
виноват	*виноват	винен	3
непрактичности	*непрактичности	непрактичності	3
ни	*ни	жоден	3
возьмем	*возьмем	візьмемо	3
последнюю	*последнюю	останній	3
похож	*похож	схожий	3
выпорхнет	*выпорхнет	випорхне	3
,	*ехал	,	3
нору	*вырыть	нору	3
яна	*яна	яна	3
шансы	*неплохие	шанси	3
обязанность	*обязанность	обов	3
гилис	*гилис	джилліс	3
пожениться	*пожениться	одружитися	3
преподаю	*преподаю	викладаю	3
наших	*наших	наших	3
горит	*горит	горить	3
чёрного	*чёрного	чорного	3
сценаристов	*гильдию	сценаристів	3
смокинг	*смокинг	смокінг	3
плывем	*плывем	пливемо	3
несчастную	*несчастную	нещасне	3
прокомпостируйте	*многоразового	прокомпостуйте	3
сандаю	*сандаю	сандаю	3
прибыл	*касабланку	прибув	3
клыки	*клыки	ікла	3
свободен	*свободен	вільний	3
отправляется	*отправляется	відправляється	3
становились	*становились	таборах	3
гулять	*гулять	гуляти	3
испекла	*испекла	спекла	3
потрясающей	*потрясающей	запаморочливою	3
проще	*проще	простіше	3
красивой	*красивой	вродливою	3
и	*смолистая	і	3
двери	*двери	ці	3
сыграй	*сыграй	зіграй	3
америку	*америку	америки	3
ближайшем	*ближайшем	найближчому	3
ошибся	*ошибся	помилився	3
понадобился	*пете	потребував	3
ездит	*ездит	їздить	3
вашему	*вашему	вашому	3
свойственно	*свойственно	властиво	3
генеалогическое	*генеалогическое	генеалогічне	3
посоветовал	*посоветовал	порадив	3
волнуюсь	*волнуюсь	хвилююся	3
ледников	*ледников	льодовиків	3
при	*общаться	за	3
юми	*юми	юмі	3
бездянке	*бездянке	бездянці	3
позже	*позже	пізніше	2
различить	*различить	розрізнити	2
носороги	*носороги	носороги	2
цену	*какую	ціну	2
иву	*иву	вербу	2
здесь	*здесь	!	2
ожеребилась	*ожеребилась	ожеребилася	2
красивы	*красивы	красиві	2
ароматом	*ароматом	пахощами	2
ирвинг	*ирвинг	івінґ	2
трилобита	*трилобита	трилобіта	2
пальме	*пальме	пальмі	2
голубые	*голубые	блакитні	2
язычество	*язычество	язичництво	2
шутишь	*шутишь	жартуєш	2
вылечил	*вылечил	вилікував	2
вертится	*вертится	крутиться	2
нагоняет	*нагоняет	хилить	2
задумайся	*задумайся	поміркуй	2
тратьте	*тратьте	втрачайте	2
перепадала	*перепадала	отримував	2
к	*к	і	2
три	*три	аварії	2
сэма	*сэма	піаніно	2
прямом	*прямом	повному	2
мамонты	*мамонты	мамонти	2
впадала	*впадала	впадала	2
познаются	*познаются	пізнаються	2
признание	*стыдливое	одкровення	2
штатах	*штатах	штатах	2
провалился	*провалился	провалилася	2
поклонница	*поклонница	шанувальниця	2
годится	*годится	годиться	2
к	*к	жити	2
уйду	*уйду	піду	2
беспомощен	*беспомощен	безпомічний	2
стараются	*стараются	стараються	2
перезвонить	*перезвонить	зателефонувати	2
молод	*молод	молодий	2
.	*мастей	.	2
белорусский	*изучает	білоруську	2
шип	*шип	шип	2
красивые	*красивые	красиві	2
хедда	*хедда	гедда	2
фаршад	*фаршад	фаршад	2
рукав	*рукав	притримував	2
.	*купаться	.	2
белая	*другая	біла	2
нервничает	*нервничает	нервує	2
пышный	*пышный	пишний	2
прилипла	*прилипла	черевика	2
.	*пальто	.	2
.	*ложными	.	2
допотопными	*допотопными	тваринами	2
бурые	*бурые	бурі	2
вымыть	*вымыть	вимити	2
раздражительный	*раздражительный	роздратованою	2
залезешь	*залезешь	залізеш	2
,	*кен	,	2
наше	*наше	наша	2
жирке	*жирке	жиркові	2
удалить	*удалить	видалити	2
перерезать	*перерезать	перерізувати	2
.	*касабланку	.	2
облачно	*облачно	хмарно	2
подвинуть	*подвинуть	посунути	2
кинозвездой	*великой	кінозіркою	2
спорили	*спорили	сперечалися	2
хоппер	*хоппер	хоппер	2
шахматы	*шахматы	,	2
сразился	*сразился	воював	2
черный	*черный	чорний	2
неверных	*неверных	невірні	2
вышли	*вышли	вийшли	2
.	*касабланке	.	2
китая	*китая	китаю	2
маркс	*маркс	маркс	2
ваш	*ваш	парасолю	2
ичиро	*ичиро	ічіро	2
силурийского	*силурийского	силурійського	2
клин	*клин	клин	2
никакого	*никакого	ніякого	2
шваба	*шваба	шваба	2
беларуси	*беларуси	білорусі	2
здесь	*здесь	є	2
практичность	*практичность	практичність	2
паста	*паста	паста	2
злиться	*злиться	гніватися	2
туфель	*вместо	черевиків	2
керамикой	*керамикой	керамікою	2
переносили	*переносили	переносили	2
.	*прыгни	.	2
солгал	*солгал	збрехав	2
батут	*батут	батут	2
хуй	*хуй	хуй	2
ракетку	*ракетку	ракетку	2
вполне	*вполне	цілком	2
книги	*любые	книги	2
выражаются	*выражаются	за	2
путин	*путин	путін	2
доисторической	*доисторической	доісторичній	2
деревянный	*деревянный	’	2
...	*лагун	...	2
ранние	*ранние	ранні	2
мягкий	*мягкий	м	2
голливудский	*голливудский	голівудська	2
.	*кончается	.	2
удачи	*удачи	вдачі	2
порвано	*порвано	розірвана	2
искупаться	*искупаться	купатись	2
прыгай	*прыгай	отрибай	2
покрыт	*покрыт	покрита	2
львов	*львов	левів	2
сочиняют	*сочиняют	створюють	2
замечательное	*замечательное	чудовий	2
оглянись	*оглянись	подивись	2
караоке	*караоке	караоке	2
джонсон	*джонсон	джонсон	2
нептун	*нептун	нептун	2
шляпа	*шляпа	капелюх	2
спешу	*спешу	поспішаю	2
безумцу	*безумцу	безумцеві	2
вкусным	*вкусным	смачна	2
берите	*берите	беріть	2
подскользнитесь	*подскользнитесь	посковзніться	2
эстонской	*эстонской	естонській	2
лихо	*лихо	лихо	2
оран	*оран	орана	2
выкрутить	*выкрутить	викрутити	2
наших	*дожили	наших	2
возница	*возница	візник	2
черепаху	*черепаху	черепаху	2
одевайтесь	*одевайтесь	вдягайтесь	2
грааль	*грааль	грааль	2
ёко	*ёко	йоко	2
окунуть	*окунуть	скупати	2
.	*нераздельны	.	2
.	*наших	.	2
саша	*саша	саша	2
сосёт	*сосёт	ссе	2
солнцезащитные	*солнцезащитные	завеликі	2
руки	*дрожат	руки	2
сына	*единственного	сина	2
одета	*одета	одягнена	2
будит	*будит	будить	2
жирки	*жирки	жирка	2
весили	*весили	важили	2
выхлопными	*выхлопными	вихлопними	2
склонен	*склонен	схильний	2
стеснительные	*порочно	хибно	2
языков	*других	мов	2
нашей	*нашей	.	2
,	*полюбил	,	2
поговорим	*поговорим	поговоримо	2
любом	*любом	в	2
.	*небольшая	.	2
марсель	*марсель	марселя	2
баскетбол	*баскетбол	баскетбол	2
для	*шкаф	для	2
какая	*какая		2
топор	*топор	сокира	2
лихорадка	*лихорадка	гарячка	2
евангелина	*евангелина	євангеліна	2
мистером	*мистером	містером	2
про	*собственную	власну	2
расслабиться	*расслабиться	розслабитися	2
к	*к	додачу	2
вылетает	*вылетает	відлітає	2
развести	*развести	розвести	2
телевизорные	*телевизорные	телевізійні	2
сияющими	*сияющими	сяючими	2
братиславу	*братиславу	братиславу	2
разрушил	*разрушил	зруйнував	2
.	*мель	!	2
мыть	*мыть	мити	2
три	*три	роки	2
нюнорска	*нюнорска	нюношку	2
шерстистые	*шерстистые	вовнисті	2
.	*трилобитами	.	2
пианино	*пианино	семовому	2
венецию	*венецию	венеції	2
блейна	*мистера	блейна	2
выглядят	*выглядят	виглядає	2
фред	*фред	фред	2
танака	*танака	танака	2
комары	*комары	комари	2
другой	*другой	інший	2
теннисную	*теннисную	тенісну	2
танабата	*танабата	танабата	2
исписал	*исписал	списав	2
вора	*поймать	злодія	2
наливай	*наливай	наливай	2
обеда	*до	обіду	2
леплю	*леплю	ліплю	2
весёлого	*весёлого	веселого	2
шапку	*шапку	шапку	2
петра	*петра	петра	2
кассетный	*кассетный	касетний	2
горько	*горько	гірко	2
терплю	*терплю	переношу	2
шахматы	*шахматы	том	2
древние	*древние	давні	2
воровал	*воровал	крав	2
апельсины	*апельсины	апельсини	2
ваше	*ваше	вашу	2
повлияет	*повлияет	вплине	2
пообедали	*пообедали	пообідали	2
транслитерацию	*транслитерацию	транслітерацію	2
берн	*берн	берн	2
промокли	*промокли	намокли	2
тыква	*тыква	гарбуз	2
мавр	*мавр	мавр	2
;	*днесь	;	2
младшей	*младшей	молодшою	2
кулак	*железный	кулак	2
стремглав	*стремглав	хутко	2
фоторобот	*фоторобот	фоторобот	2
классное	*классное	чудовий	2
высшая	*высшая	остаточна	2
потерей	*потерей	втратою	2
бледным	*бледным	блідим	2
другое	*другое	інша	2
отрубил	*отрубил	відрубав	2
гордится	*гордится	батько	2
булочной	*булочной	хлібному	2
нравы	*нравы	наших	2
чтобы	*грею	аж	2
уподобляйся	*уподобляйся	уподібнюйся	2
грабли	*грабли	граблі	2
мачете	*мачете	мачете	2
кругосветное	*кругосветное	навколосвітню	2
упрямый	*упрямый	вперта	2
избавиться	*избавиться	позбутися	2
отче	*отче	отче	2
закурить	*закурить	закурити	2
поменяетесь	*поменяетесь	поміняєтесь	2
особа	*особа	особою	2
техас	*техас	техас	2
типичный	*типичный	типовий	2
томатным	*томатным	томатним	2
трёх	*трёх	трьома	2
мель	*здесь	мілина	2
нашу	*нашу	нашу	2
недомогание	*недомогание	нездужання	2
разрушили	*разрушили	зруйнували	2
исправишь	*исправишь	виправиш	2
нептуна	*нептуна	нептуна	2
ошибиться	*ошибиться	помилитися	2
какому	*какому	якому	2
мертвый	*мертвый	мертвий	2
собственный	*собственный	власну	2
пребывания	*пребывания	у	2
ильзу	*ильзу	ільзу	2
вернитесь	*вернитесь	повертайтесь	2
мяса	*мяса	хорошої	2
припев	*припев	приспів	2
позже	*позже	пізно	2
джуди	*джуди	джуді	2
?	*сражается	?	2
небольшой	*небольшой	невеличку	2
нельзя	*нельзя	різати	2
нервишки	*нервишки	нерви	2
небеси	*небеси	;	2
воспользоваться	*воспользоваться	можеш	2
пота	*пота	поту	2
радостный	*радостный	радісний	2
.	*иномарка	.	2
!	*мотоцикл	!	2
гей	*гей	ґей	2
лошади	*лошади	ненадовго	2
девятичасовой	*девятичасовой	десятигодинний	2
отцвели	*отцвели	відцвіли	2
поклонников	*поклонников	прихильників	2
прилипла	*прилипла	мого	2
рыбалку	*рыбалку	малим	2
к	*к	біса	2
одень	*одень	надінь	2
браться	*браться	братися	2
заноза	*заноза	скалка	2
банное	*банное	банний	2
мороженых	*мороженых	морозива	2
вино	*вино	пиво	2
чудесное	*чудесное	чудове	2
подобрала	*подобрала	підняла	2
окончил	*окончил	закінчив	2
растерялся	*растерялся	розгубився	2
потерь	*потерь	утрат	2
токийский	*токийский	токійський	2
...	*следов	.	2
обое	*обое	обоє	2
до	*до	побачимось	2
нянек	*нянек	няньок	2
прохладно	*прохладно	прохолодно	2
задаёт	*задаёт	задає	2
понтона	*понтона	понтону	2
починить	*починить	полагодити	2
хорхе	*хорхе	хорхе	2
перемене	*перемене	до	2
здесь	*здесь		2
соленая	*соленая	солона	2
мия	*мия	мія	2
шнайдером	*шнайдером	шнайдером	2
настанет	*настанет	настане	2
бирюза	*бирюза	бірюза	2
тайфун	*тайфун	тайфун	2
товарного	*товарного	товарного	2
это	*теленок	це	2
.	*скучна	.	2
зарплата	*низкая	зарплатня	2
полная	*полная	повна	2
нашему	*нашему	нашій	2
опоздаешь	*опоздаешь	спізнишся	2
какое	*какое		2
кейко	*кейко	вона	2
шалят	*шалят	пустують	2
старших	*три	старших	2
протоптали	*протоптали	протоптали	2
вашу	*вашу	ваших	2
тратят	*тратят	марнують	2
сладко	*сладко	солодко	2
анжелика	*анжелика	анжеліка	2
неспокойно	*неспокойно	неспоійно	2
нарита	*нарита	наріта	2
грина	*грина	гріна	2
бедки	*бедки	малий	2
полчаса	*полчаса	півгодини	2
москве	*москве	москви	2
убираться	*убираться	прибирати	2
задал	*задал	йому	2
пробежал	*пробежал	пробіг	2
.	*тоньше	.	2
кодировка	*кодировка	кодування	2
будите	*будите	будіть	2
вытерпела	*вытерпела	витримати	2
необходим	*необходим	необхідний	2
полный	*полный	є	2
караулить	*караулить	чатувати	2
карл	*карл	карл	2
вставать	*вставать	рано	2
предпочитаю	*предпочитаю	перевагу	2
.	*туфель	.	2
.	*юбке	.	2
поменялась	*поменялась	помінялася	2
неразглашении	*неразглашении	нерозголошення	2
усыновили	*мэри	усиновили	2
грабитель	*грабитель	грабіжник	2
нара	*нара	нара	2
обследован	*обследован	досліджено	2
нашей	*нашей	нові	2
висит	*висит	висить	2
понадобиться	*понадобиться	знадобитися	2
пришей	*пришей	приший	2
родителей	*родителей	батьків	2
курсовая	*курсовая	робота	2
тряпкой	*тряпкой	слимаком	2
читаю	*читаю	не	2
фриман	*фриман	фріман	2
шуми	*шуми	шуми	2
пьёт	*пьёт	чашку	2
гилис	*гилис	гілліс	2
ни	*ни	нема	2
ванну	*ванну	ванну	2
мадмуазель	*мадмуазель	мадемуазель	2
стирает	*стирает	пере	2
дастин	*дастин	дастін	2
.	*пожениться	.	2
цыпленок	*цыпленок	курчатко	2
становишься	*становишься	стаєш	2
даждь	*насущный	насущний	2
спросил	*ни	спитав	2
.	*кинозвездой	.	2
полагать	*полагать	вважати	2
уехал	*уехал	поїхав	2
утрачено	*утрачено	втрачений	2
ручья	*ручья	струмка	2
учетную	*учетную	обліковий	2
префекта	*префекта	префекта	2
эсперанто	*эсперанто	розповсюджуйте	2
взял	*взял	узяв	2
.	*отделяет	.	2
джунглях	*джунглях	джунглях	2
установили	*установили	встановили	2
антоним	*антоним	антонім	2
присутствовало	*присутствовало	присутньо	2
хуйня	*хуйня	хуйня	2
наклонилась	*наклонилась	нахилилася	2
специально	*специально	спеціально	2
чуть	*чуть	більше	2
барс	*барс	барс	2
.	*путать	.	2
паша	*паша	павло	2
красива	*красива	красива	2
искусственные	*искусственные	штучні	2
поиграем	*поиграем	пограймо	2
к	*к	їх	2
спросила	*спросила	спитала	2
посылаем	*посылаем	посилаємо	2
меленянах	*меленянах	меленяни	2
переспал	*переспал	переспав	2
бибер	*бибер	бібер	2
позаботиться	*позаботиться	подбати	2
кончается	*кончается	закінчується	2
платон	*платон	платон	2
насекомые	*насекомые	комахи	2
ванг	*ванг	ванг	2
мечтатель	*мечтатель	мрійник	2
нижней	*нижней	нижній	2
японцев	*ездит	їздить	2
ужарил	*ужарил	вдарив	2
потеряешь	*потеряешь	втеряєш	2
спрячься	*спрячься	в	2
поступили	*поступили	вчинили	2
тушкан	*тушкан	тушкан	2
поделилась	*поделилась	поділилася	2
повезло	*повезло	пощастило	2
рыбалку	*рыбалку	я	2
предъявила	*предъявила	нові	2
выйдешь	*выйдешь	вийдеш	2
переговорил	*переговорил	побалакав	2
возле	*возле	коло	2
прощай	*прощай	бувай	2
лифтовой	*лифтовой	ліфтовий	2
ко	*ко	зі	2
именно	*кончилось	саме	2
монро	*монро	монро	2
против	*плыть	проти	2
направляются	*направляются	у	2
горжусь	*горжусь	пишаюся	2
.	*бабье	.	2
понтону	*понтону	понтону	2
нидо	*нидо	нідо	2
признался	*признался	зізнався	2
поломан	*поломан	.	2
ильза	*ильза	ільза	2
обналичьте	*обналичьте	беріть	2
уныла	*уныла	нудна	2
устал	*устал	втомлений	2
ибрагим	*ибрагим	ібрагім	2
ненавидела	*ненавидела	ненавиділа	2
некоторые	*некоторые	дехто	2
.	*ружья	.	2
прошу	*прошу	прошу	2
перец	*перец	перець	2
шерман	*шерман	шерман	2
атаковал	*атаковал	атакував	2
.	*косметика	.	2
джозеф	*джозеф	джозеф	2
бабочка	*бабочка	метелик	2
,	*мишек	,	2
рыжеватые	*рыжеватые	волосся	2
затаив	*затаив	затамувавши	2
гилисом	*гилисом	джиллісом	2
щётку	*щётку	щітку	2
блажей	*блажей	блажей	2
сиськи	*сиськи	цицьок	2
выложился	*выложился	повну	2
джордж	*джордж	джордж	2
разбивает	*разбивает	розбиває	2
покореженное	*покореженное	понівечене	2
обязательно	*обязательно	"обов'язково	2
отличить	*отличить	відрізники	2
становились	*становились	ставали	2
сеньора	*сеньора	сеньйора	2
шанхайский	*шанхайский	шанхайський	2
упорядоченное	*упорядоченное	множина	2
наручные	*наручные	наручний	2
твиттер	*твиттер	твітер	2
успел	*успел	встиг	2
посоветуйся	*посоветуйся	порадься	2
насекомые	*насекомые	вподоби	2
и	*рейха	i	2
сенная	*сенная	сінна	2
вкусный	*вкусный	смачна	2
переговоров	*переговоров	перемовин	2
глупо	*отвергать	нерозумно	2
поймал	*поймал	рибини	2
к	*к	цієї	2
оконце	*наше	загляне	2
средиземном	*средиземном	середземному	2
исправит	*исправит	уродився	2
блевотины	*блевотины	блювотиння	2
смеешь	*смеешь	смієш	2
.	*мертв	.	2
застегни	*застегни	застібни	2
христофор	*христофор	христофор	2
другой	*другой	вчити	2
поступил	*поступил	вступив	2
прогулялись	*прогулялись	прогулялися	2
утки	*утки	качки	2
выбор	*единственный	вибір	2
режут	*режут	ріжуть	2
маркони	*маркони	марконі	2
афины	*афины	афін	2
поплавать	*поплавать	в	2
здесь	*здесь	,	2
годится	*годится	користним	2
классно	*классно	смачно	2
стало	*аниме	аніме	2
встал	*встал	встав	2
опаздывает	*опаздывает	запізнюється	2
блейн	*блейн	блейн	2
блондинкой	*блондинкой	білявкою	2
уходит	*уходит	виходить	2
звонила	*звонила	телефонувала	2
красил	*красил	фарбував	2
проложил	*проложил	проклала	2
пиклз	*пиклз	піклз	2
нудным	*нудным	нудним	2
паразитирую	*паразитирую	паразитую	2
линда	*линда	лінда	2
автомобиль	*водить	машиною	2
привидения	*привидения	привидів	2
родители	*родители	ватьки	2
транзитные	*транзитные	супровідні	2
опыта	*никакого	досвіду	2
опаздывай	*опаздывай	запізнюйся	2
измерь	*измерь	зміряй	2
рик	*рик	ріку	2
мэрилин	*мэрилин	мерілін	2
исияма	*исияма	ісіяма	2
осенила	*осенила	прийшла	2
увяз	*увяз	загруз	2
употреблять	*употреблять	вживати	2
шестидесятилетний	*шестидесятилетний	шестидесятирічний	2
.	*племена	.	2
маток	*маток	маток	2
полную	*полную	наповнену	2
когда-то	*здесь	колись	2
фал	*фал	фал	2
,	*спросил	,	2
каникул	*каникул	канікули	2
готовься	*готовься	готуйся	2
убежать	*убежать	втікти	2
разрушает	*враждебность	руйнує	2
поженились	*поженились	одружилися	2
машинистом	*машинистом	машиністом	2
ваших	*ваших	вашу	2
заводишься	*заводишься	заводишся	2
водил	*водил	водив	2
коелодонт	*коелодонт	коелодонт	2
угощайся	*угощайся	пригощайся	2
хламу	*хламу	брухту	2
болтай	*болтай	хитай	2
благородного	*благородного	шляхетної	2
.	*тост	.	2
дориана	*дориана	доріана	2
шекспире	*шекспире	шекспіра	2
добраться	*добраться	до	2
пани	*пани	пані	2
отсутствовал	*отсутствовал	учора	2
последняя	*последняя	останній	2
трусихой	*трусихой	боягузкою	2
непрактичное	*непрактичное	непрактична	2
джека	*джека	джека	2
гадкий	*гадкий	гидке	2
побрил	*побрил	поголив	2
холоднокровные	*холоднокровные	холоднокровні	2
носит	*носит	носить	2
бить	*бить	бити	2
блейн	*блейн	блейне	2
липнут	*к	до	2
вежливым	*вежливым	ввічливий	2
замечательный	*замечательный	чудового	2
великим	*великим	великим	2
.	*вернуть	.	2
египтяне	*египтяне	єгиптяни	2
блокнота	*блокнота	блокноти	2
лиха	*лиха	хвацька	2
насчёт	*насчёт	стосовно	2
джеймс	*джеймс	джеймс	2
унаследовал	*унаследовал	успадкував	2
ни	*ни	»	2
пирожки	*пирожки	пиріжки	2
понравится	*понравится	сподобається	2
кошечку	*кошечку	кошеня	2
воевала	*воевала	воювала	2
.	*пить	.	2
больший	*больший	більший	2
древо	*древо	дерево	2
мономорфизм	*мономорфизм	мономорфізм	2
помоне	*помоне	помоні	2
анкару	*анкару	анкару	2
пойдемте	*пойдемте	пливемо	2
убежал	*убежал	втік	2
каким	*каким	десять	2
женда	*женда	жендо	2
зеландии	*зеландии	зеландії	2
ножницы	*ножницы	ножиці	2
благоприятствовала	*благоприятствовала	сприяла	2
опаздывал	*опаздывал	запізнювався	2
пчёлах	*пчёлах	бджіл	2
.	*получится	.	2
бегает	*бегает	бігає	2
капельки	*капельки	краплини	2
темнеет	*темнеет	темніє	2
кэти	*кэти	кеті	2
каким	*каким	яким	2
нездоровая	*нездоровая	нездорова	2
стыдиться	*стыдиться	бути	2
нил	*нил	нил	2
понравилась	*понравилась	сподобалась	2
собственными	*собственными	власних	2
мужественный	*мужественный	чоловіка	2
джойс	*джойс	джойс	2
микробам	*микробам	мікробам	2
покачивается	*покачивается	гойдається	2
антикварная	*великолепная	меблі	2
любезен	*любезен	люб	2
потеплее	*потеплее	тепліше	2
к	*к	по	2
кладите	*кладите	кладіть	2
теряется	*теряется	легко	2
сбил	*сбил	збило	2
ошиблись	*ошиблись	помилились	2
трусов	*трусов	боягузів	2
медикаменты	*медикаменты	медикаменти	2
жюля	*жюля	жюля	2
сверкнула	*сверкнула	блиснула	2
дима	*дима	діма	2
случилось	*ни	буде	2
потому	*потому	тому	2
нашей	*нашей	нашого	2
горит	*горит	палає	2
успокоиться	*успокоиться	запокоїтись	2
.	*блейна	.	2
дождливая	*дождливая	дощова	2
адама	*адама	адама	2
твёрже	*твёрже	твердішого	2
сзади	*сзади	позаду	2
женятся	*женятся	одружуються	2
высшего	*высшего	вищої	2
миннесоте	*миннесоте	мінесоті	2
фрак	*фрак	фрак	2
плитках	*плитках	плиткам	2
левую	*левую	ліву	2
метла	*метла	мітла	2
меленяны	*меленяны	меленяни	2
заполучить	*заполучить	дістати	2
рябое	*рябое	рабоє	2
.	*заглянули	.	2
апартаменты	*апартаменты	апартаменти	2
постучал	*постучал	постукав	2
обязательно	*обязательно	обов'язково	2
эй	*эй	що	2
заплакала	*заплакала	заплакала	2
фриман	*фриман	?	2
несчастный	*несчастный	нещасний	2
лос-анджелес	*лос-*анджелес	лос-анжелеса	2
потеряно	*потеряно	втрачено	2
голубые	*голубые	очі	2
проглотить	*проглотить	проковтнути	2
пелёнках	*пелёнках	пелюшках	2
возьму	*возьму	візьму	2
ласковый	*ласковый	покірливе	2
метёт	*метёт	заміта	2
споём	*споём	заспіваємо	2
поиграть	*поиграть	погратись	2
золото	*украл	золото	2
всю	*украсть	всю	2
разногласия	*разногласия	розбіжності	2
стыдливое	*стыдливое	одкровення	2
курить	*курить	заборонено	2
заменяем	*заменяем	датською	2
лилли	*лилли	ліллі	2
выпрашивать	*выпрашивать	випрошувати	2
соусом	*соусом	соусом	2
-	*лайм	-	2
шкафах	*шкафах	шафі	2
каком	*каком	якому	2
установил	*установил	його	2
подбежала	*подбежала	підбіг	2
униформа	*униформа	уніформа	2
подумай	*подумай	подумай	2
меленяны	*меленяны	меленян	2
лунатик	*лунатик	сновида	2
кюрасао	*кюрасао	кюрасао	2
иве	*иве	вербі	2
попустись	*попустись	облиш	2
сибуе	*сибуе	сібуя	2
руми	*руми	румі	2
браузер	*браузер	не	2
потерял	*потерял	я	2
пощупал	*пощупал	пощупав	2
противоположность	*противоположность	протилежність	2
худшему	*худшему	найгіршого	2
ржавым	*ржавым	іржавим	2
джеком	*джеком	джека	2
пьёшь	*пьёшь	п	2
танцевать	*танцевать	танцювати	2
приемнике	*приемнике	приймач	2
кататься	*кататься	смородину	2
сглаз	*сглаз	вроки	2
батьку	*батьку	батька	2
америки	*америки	америку	2
компактную	*компактную	компактну	2
полной	*полной	повній	2
становились	*становились	все	2
придирается	*придирается	чіпляється	2
появились	*появились	з	2
банкет	*банкет	бенкет	2
ваша	*ваша	ваш	2
джерри	*джерри	джері	2
чертят	*чертят	черкають	2
жрать	*жрать	жерти	2
панов	*панов	панів	2
тяжелая	*какая	важка	2
величайших	*величайших	найвидатніших	2
познакомился	*познакомился	познайомився	2
запакуй	*запакуй	запакуйте	2
никакого	*никакого	жодного	2
камина	*камина	каміна	2
ручей	*ручей	струмок	2
якоже	*наша	і	2
а	*мертвым	адже	2
насмешкам	*насмешкам	кпинів	2
половину	*отсняли	половину	2
настроек	*настроек	налаштувань	2
какому	*какому	якій	2
сара	*сара	сара	2
поклялся	*поклялся	присягнув	2
пьёт	*чашке	чашку	2
боюсь	*боюсь	боюсь	2
банан	*банан	банан	2
свободные	*свободные	вільні	2
ложусь	*ложусь	лягаю	2
грей	*грей	грій	2
грей	*грей	ґрей	2
сойти	*сойти	вийти	2
спросить	*спросить	спитати	2
мародеры	*мародеры	мародери	2
согласна	*согласна	згодна	2
.	*красивые	.	2
хлестала	*хлестала	сікла	2
коулом	*гордоном	коула	2
,	*каникулах	,	2
починил	*починил	поремонтував	2
варьируется	*варьируется	коливається	2
колю	*колю	репертуарі	2
марок	*марок	марок	2
исключительный	*исключительный	винятковий	2
львов	*львов	львова	2
доживёт	*доживёт	доживе	2
спросить	*спросить	запитати	2
мяч	*мяч	м	2
тернии	*тернии	зірок	2
станислав	*станислав	станіслав	2
советолог	*советолог	радянолог	2
уснуть	*уснуть	заснути	2
радоваться	*радоваться	радіти	2
угарте	*угарте	угарте	2
кенгуру	*кенгуру	кенгуру	2
зонтик	*зонтик	лишив	2
жутко	*жутко	сумую	2
богдан	*богдан	богдан	2
ни	*ни	найменшого	2
другой	*другой	...	2
произношение	*произношение	вимову	2
мочить	*мочить	мочити	2
насекомое	*насекомое	комаха	2
мороженное	*мороженное	морозиво	2
неразумно	*неразумно	нерозумно	2
автобусной	*автобусной	автобусної	2
к	*к	дідька	2
дешевле	*дешевле	дешевшу	2
спешит	*спешит	поспішає	2
справится	*справится	впорається	2
карл	*карл	карле	2
пахнет	*пахнет	смачно	2
до	*до		2
классной	*классной	класній	2
эпохальная	*эпохальная	епохальна	2
концентрационных	*концентрационных	в	2
забронировала	*забронировала	забронювала	2
соответствует	*соответствует	очікуванням	2
кена	*кена	кена	2
дударева	*дударева	дударева	2
вашингтон	*вашингтон	вашингтон	2
малейшего	*малейшего	найменшого	2
купаюсь	*купаюсь	купаюся	2
поехала	*поехала	поїхала	2
минутку	*минутку	хвилинку	2
мексикой	*мексикой	мексикою	2
позавтракал	*позавтракал	.	2
.	*проветри	.	2
красивый	*красивый		2
дядька	*дядька	дядько	2
ледниковом	*ледниковом	льодовиковому	2
зонтик	*зонтик	парасоля	2
мери	*мери	мері	2
полна	*полна	повен	2
летают	*летают	літають	2
новости	*чудесные	новина	2
запирается	*запирается	замикається	2
другой	*другой	у	2
саша	*саша	сашко	2
закурить	*закурить	запалити	2
ехать	*ехать	поїхати	2
поступят	*поступят	вступлять	2
—	*патрик	—	2
голове	*голове	голові	2
юбки	*юбки	спіднички	2
брать	*брать	брати	2
америку	*америку	америку	2
телёнок	*телёнок	телятко	2
блузка	*блузка	блуза	2
лучшая	*лучшая	найкраща	2
зрелая	*зрелая	зріла	2
согласен	*согласен	згоден	2
антикватис	*антикватис	антікватіс	2
протрезел	*протрезел	протверезів	2
пауков	*пауков	павуків	2
потерял	*потерял	відібрало	2
предшествует	*предшествует	передує	2
к	*к	звик	2
великого	*великого	великого	2
согласились	*согласились	погодилися	2
поэтому	*поэтому	отже	2
дю	*дю	де	2
насчёт	*насчёт	до	2
кожная	*кожная	шкырний	2
выбивают	*выбивают	вишибають	2
кипяток	*кипяток	окріп	2
париж	*париж	парижу	2
починил	*починил	полагодив	2
пуста	*пуста	порожньо	2
.	*уйти	...	2
читает	*читает	читає	2
попробуем	*попробуем	спробуємо	2
понятны	*понятны	зрозумілими	2
пью	*пью	п'ю	2
,	*киборг	,	2
нью-йорка	*нью-*йорка	нью-йорка	2
гей	*гей	голубий	2
размножаться	*размножаться	розмножуватися	2
брунцвик	*брунцвик	брунцвік	2
молодой	*молодой	молодий	2
бездянкой	*бездянкой	бездянкою	2
кассету	*кассету	касету	2
грея	*грея	грея	2
бесчисленное	*бесчисленное	незлічена	2
?	*ягода	?	2
социальная	*социальная	соціальна	2
заключённые	*заключённые	’	2
позавтракать	*позавтракать	поснідати	2
ругайся	*ругайся	лайся	2
бездарь	*бездарь	нездара	2
свыкнись	*свыкнись	звикай	2
надевал	*надевал	одягав	2
липла	*липла	липув	2
зародилась	*зародилась	зародилася	2
настоящая	*настоящая	спражня	2
большущий	*большущий	величезний	2
.	*рано	.	2
волнуется	*волнуется	хвилюється	2
ричард	*ричард	річарде	2
возницы	*возницы	візника	2
синий	*синий	синій	2
придти	*придти	прийти	2
возлюби	*возлюби	полюби	2
выйти	*выйти	вийти	2
.	*кулешов	.	2
вместо	*вместо	замість	2
баночку	*баночку	ікри	2
стометровку	*стометровку	стометрівку	2
бе	*бе	бе	2
одноклассников	*одноклассников	однокласників	2
поужинаете	*поужинаете	повечеряєте	2
уехала	*токио	поїхала	2
молодой	*молодой	.	2
заезжают	*заезжают	бувають	2
.	*усовершенствован	.	2
низине	*низине	низині	2
польше	*польше	польщі	2
приметы	*приметы	прикмети	2
ездит	*карпаты	карпати	2
разбуди	*разбуди	розбуди	2
были	*беженцев	були	2
.	*собственные	.	2
.	*босса	.	2
к	*к	-	2
атами	*атами	атамі	2
вашим	*вашим	вашими	2
последнее	*последнее	останнім	2
пешком	*пешком	.	2
ясное	*ясное	ясна	2
помине	*помине	промовка	2
сортирах	*сортирах	сортирах	2
спросил	*спросил	-"	2
ни	*ни	ані	2
употребляется	*употребляется	використовується	2
,	*скрипят	,	2
влюбился	*влюбился	покохав	2
дурость	*дурость	дурня	2
толерантным	*толерантным	толерантним	2
японцы	*японцы	японці	2
прилипла	*жвачка	прилипла	2
джил	*джил	джил	2
пареной	*пареной	простого	2
джастин	*джастин	джастін	2
поливает	*поливает	поливає	2
помолчи	*помолчи	помовчи	2
японка	*японка	японка	2
исходными	*исходными	програмним	2
несчастных	*несчастных	нещасних	2
старательно	*старательно	старанно	2
.	*спросил	.	2
математическая	*математическая	математична	2
берлине	*берлине	берліні	2
.	*чеки	.	2
.	*воевать	.	2
а	*мертвым	—	2
вернулся	*вернулся	вернувся	2
несчастные	*несчастные	нещасні	2
меня	*ненавидишь	мене	2
дешевле	*дешевле	дешевший	2
лиза	*лиза	ліза	2
поехали	*поехали	поїхали	2
черешня	*черешня	черешня	2
ваших	*ваших	!	2
мужчина	*мужчина	чоловік	2
советолог	*советолог	совєтолог	2
богата	*богата	багата	2
прекратится	*прекратится	до	2
попросил	*попросил	попросив	2
джинсам	*джинсам	джинсів	2
пари	*пари	парі	2
зелёный	*зелёный	зелений	2
портят	*портят	освіту	2
потрясающе	*потрясающе	потрясно	2
форматировать	*форматировать	форматувати	2
познакомились	*познакомились	познайомилися	2
подвозите	*подвозите	підвозите	2
приложение	*приложение	застосунок	2
припарковалась	*странная	припаркувалася	2
выколи	*выколи	виколи	2
случилось	*ни	що	2
гналась	*гналась	гналася	2
вяленая	*вяленая	’	2
великолепный	*великолепный	чудовий	2
доберусь	*доберусь	доберуся	2
спорить	*спорить	сперечатись	2
дух	*захватывало	дух	2
нюнорска	*нюнорска	для	2
сломались	*сломались	зламався	2
ближнего	*ближнего	ближнього	2
примерно	*примерно	приблизно	2
фрукты	*кислые	фрукти	2
поосторожней	*поосторожней	обережно	2
задавать	*задавать	ставити	2
высмеивать	*высмеивать	висміювати	2
аккаунт	*аккаунт	акаунт	2
.	*удастся	.	2
крестный	*крестный	хресний	2
неверным	*неверным	невірним	2
здесь	*здесь	.	2
поступок	*поступок	поведінка	2
покрасили	*покрасили	пофарбували	2
подружились	*подружились	потоваришували	2
создатели	*создатели	створювачі	2
сжигает	*сжигает	спалює	2
другие	*другие	й	2
изобретать	*изобретать	винаходити	2
отнимает	*отнимает	забирає	2
карфаген	*карфаген	карфаген	2
спальне	*спальне	спальні	2
спалось	*спалось	заснути	2
важное	*какое	важливу	2
пожелать	*пожелать	приємного	2
смородина	*черная	?	2
спячу	*спячу	збожеволію	2
оденемся	*оденемся	одягнутись	2
львов	*львов	львів	2
облачка	*облачка	жодної	2
к	*к	у	2
запонки	*запонки	запонки	2
бурбон	*бурбон	бурбон	2
спится	*спится	спиться	2
свободными	*свободными	вільними	2
садись	*садись	оідай	2
бабушка	*бабушка	бабуся	2
утёнок	*утёнок	каченя	2
подрыва	*подрыва	терплю	2
руа	*руа	руа	2
красивые	*красивые	гарні	2
жарко	*жарко	жарко	2
буддизм	*буддизм	буддизм	2
чая	*чая	чаю	2
катя	*катя	катя	2
моста	*моста	мосту	2
рассвело	*рассвело	розвиднілося	2
предпочитаю	*предпочитаю	я	2
деревне	*деревне	селі	2
формалистской	*формалистской	формалістичною	2
.	*домой	.	2
амазонка	*амазонка	амазонка	2
устал	*устал	втомилася	2
настоящая	*настоящая	справжнє	2
смит	*смит	сміт	2
наилучший	*наилучший	найкращий	2
кислорода	*атома	кисню	2
пересказываю	*пересказываю	переказую	2
просыпаюсь	*просыпаюсь	прокидаюся	2
пожалел	*пожалел	пошкодував	2
поклонник	*поклонник	шанувальник	2
скучать	*скучать	скучатиму	2
скидку	*трёхпроцентную	знижку	2
омуте	*омуте	болоті	2
побуду	*побуду	побуду	2
путать	*нельзя	змішувати	2
приготовимся	*приготовимся	приготуємось	2
укрыта	*укрыта	накрита	2
мицкевича	*мицкевича	міцкевича	2
просим	*просим	просимо	2
нашей	*до	до	2
»	*испортили	»	2
московиц	*московиц	московиц	2
.	*ванная	.	2
барахлит	*барахлит	барахлить	2
симпатичная	*симпатичная	симпатична	2
убежала	*убежала	утік	2
отличить	*отличить	відрізнити	2
ружьё	*ружьё	рушницю	2
курить	*курить	палити	2
микроскопом	*микроскопом	мікроскопом	2
бьют	*бьют	б	2
убежала	*убежала	втекла	2
стеснительные	*порочно	соромливі	2
сверчок	*сверчок	цвіркун	2
сливок	*сливок	вершків	2
дышу	*дышу	дишу	2
лимон	*лимон	лимон	2
восьми	*восьми	восьмої	2
спеть	*спеть	заспівати	2
другой	*другой	складніше	2
потрясающая	*потрясающая	потрясна	2
солнцезащитные	*солнцезащитные	сонцезахисні	2
.	*к	.	2
свет	*выключится	світло	2
посоветовался	*посоветовался	порадився	2
мексиканский	*мексиканский	мексиканський	2
,	*одноразового	,	2
.	*рано	рано	2
хоббитов	*хоббитов	гобітів	2
задирает	*задирает	задирає	2
сыпь	*сыпь	висип	2
хироси	*хироси	.	2
жрёт	*жрёт	жере	2
всюду	*всюду	всюди	2
утку	*утку	качку	2
помнишь	*помнишь	пам'ятаєш	2
ванильных	*ванильных	ванільних	2
порносайт	*порносайт	порносайт	2
сердится	*сердится	сердиться	2
успокоиться	*успокоиться	заспокоїтись	2
непростой	*непростой	непростий	2
другие	*другие	інакші	2
мистер	*мистер	містере	2
порожнее	*порожнее	порожнє	2
шутить	*шутить	кепкувати	2
позже	*позже	настала	2
старалась	*старалась	намагалася	2
небогатых	*небогатых	небегатих	2
чаю	*чаю	чаю	2
стюардессе	*стюардессе	стюардесою	2
к	*к	приєднатись	2
«	*звучит	«	2
посмешищем	*посмешищем	посміховиськом	2
.	*устал	.	2
роста	*невысокого	зросту	2
вкусные	*вкусные	страви	2
отправилась	*отправилась	відправилася	2
курить	*курить	тереторії	2
сленг	*сленг	сленг	2
оденься	*оденься	вдягнися	2
преддвериях	*преддвериях	небом	2
переправлял	*переправлял	постачав	2
пустого	*пустого	пустого	2
вкусно	*вкусно	пахне	2
пуговицы	*пуговицы	ґудзики	2
трубкой	*трубкой	люлькою	2
скучаю	*скучаю	скучаю	2
мокрая	*мокрая	мокрий	2
дуная	*дуная	дунаю	2
придумывал	*придумывал	придумував	2
»	*зелёная	»	2
стеснялся	*стеснялся	соромився	2
присмотришь	*присмотришь	подбаєш	2
доброту	*доброту	доброту	2
вернись	*вернись	повернись	2
пейджер	*пейджер	пейджер	2
насчёт	*насчёт	перепочинемо	2
порылся	*порылся	порився	2
других	*других	.	2
десятиминутный	*десятиминутный	на	2
сексуален	*сексуален	сексуальний	2
!	*хмельницкий	!	2
моет	*моет	миє	2
.	*опаздывает	.	2
троих	*троих	дітей	2
ко	*ко	цікавиться	2
бездонный	*бездонный	бездонну	2
смородина	*черная	смородина	2
трилобитов	*трилобитов	трилобітів	2
таиланде	*таиланде	тайланді	2
достаточных	*достаточных	достатніх	2
дарёному	*дарёному	дарованому	2
потерь	*потерь	втрата	1
ближайшая	*ближайшая	художня	1
вымыл	*вымыл	за	1
курить	*курить	мусить	1
будто	*будто	впевнені	1
рождеством	*рождеством	мінський	1
.	*москаль	.	1
припарковать	*припарковать	де	1
ника	*ника	ніка	1
бывал	*бывал	,	1
китае	*китае	китаї	1
форду	*форду	потелефонувати	1
охотился	*охотился	полював	1
замечательная	*замечательная	чудова	1
прощенья	*прощенья	пробачення	1
подснежники	*подснежники	проліски	1
хмурый	*хмурый	смутний	1
постель	*постель	ліжко	1
итальянцы	*итальянцы	італійці	1
высшее	*высшее	найвищий	1
зеркальце	*зеркальце	люстерко	1
задала	*задала	поставила	1
какой	*какой	фінляндії	1
ни	*ни	для	1
дожидаясь	*дожидаясь	наступної	1
перевозит	*перевозит	перевозить	1
другими	*другими	іншими	1
удалось	*удалось	,	1
подготовиться	*подготовиться	готуватися	1
утраченным	*утраченным	втраченим	1
парамаунта	*парамаунта	парамаунту	1
карьеры	*карьеры	більшу	1
пародию	*пародию	пародію	1
часты	*часты	часто	1
лгун	*лгун	,	1
и	*пиджак	брюки	1
создатели	*создатели	ісландським	1
голову	*голову	!	1
специально	*специально	навмисне	1
сфотографирую	*сфотографирую	сфотографую	1
холера	*холера	розповсюджена	1
трос	*трос	трос	1
поедем	*поедем	поїдемо	1
минуточку	*минуточку	хвилину	1
разыскиваемыми	*разыскиваемыми	з	1
бейсбол	*бейсбол	парку	1
ларри	*ларри	"ларрі	1
великий	*великий	чудовий	1
лежат	*лежат	лежать	1
билл	*билл	білл	1
противились	*противились	противилися	1
мужчинами	*мужчинами	чоловіками	1
основывается	*основывается	ґрунтується	1
вставьте	*вставьте	вставте	1
собственные	*собственные	власні	1
направляются	*направляются	прямують	1
вырвалось	*вырвалось	тенет	1
везет	*везет	щастить	1
америку	*америку	удома	1
тони	*тони	сподобався	1
несет	*несет	несе	1
бригадирши	*бригадирши	бригадниці	1
заснул	*заснул	заснув	1
тревожить	*тревожить	тебе	1
звонят	*звонят	дзвонять	1
воровать	*воровать	красти	1
танцевали	*танцевали	танцювали	1
гавайях	*гавайях	декілька	1
подушку	*голову	подушку	1
здесь	*здесь	немає	1
остальные	*остальные	ніж	1
красивая	*красивая	вродлива	1
здешними	*здешними	тутейшими	1
знамо	*знамо	звісно	1
изяществом	*изяществом	грацією	1
пылкую	*пылкую	ця	1
злость	*злость	злість	1
учетной	*учетной	облікового	1
забраться	*забраться	залізти	1
путешествовать	*путешествовать	"''	1
никаких	*никаких	снодійного	1
три	*три	рибини	1
опять	*опять	знову	1
неверен	*неверен	невірна	1
создатели	*создатели	,	1
фотокамеру	*фотокамеру	фотокамеру	1
следить	*следить	стежити	1
постарше	*постарше	старшій	1
помните	*помните	ігру	1
потеря	*потеря	доньки	1
немцев	*немцев	німців	1
подвёз	*подвёз	підвезе	1
младше	*младше	молодший	1
богат	*богат	багатим	1
вырезать	*вырезать	вирізати	1
закладок	*социальных	безумовно	1
плюнуть	*плюнуть	простіше	1
безгрешен	*безгрешен	шке	1
деревянный	*деревянный	це	1
великой	*великой	величезною	1
.	*уходили	.	1
головой	*головой	головою	1
выпал	*выпал	ѿ	1
толерантным	*толерантным	до	1
иррациональный	*иррациональный	іраціональна	1
серийная	*серийная	вбивця	1
парочка	*парочка	є	1
фотографии	*потрясающие	вражаючі	1
сырая	*сырая	сира	1
львове	*львове	не	1
меленянское	*меленянское	меленянське	1
ароматом	*ароматом	парфумів	1
классное	*классное	час	1
повидать	*повидать	побачитися	1
ширину	*ширину	вшир	1
жениться	*жениться	не	1
коулом	*гордоном	.	1
нашей	*нашей	нашою	1
хвастается	*хвастается	він	1
злой	*злой	.	1
домохозяйка	*домохозяйка	домогосподарка	1
патчем	*патчем	dmenu	1
воспользоваться	*воспользоваться	ти	1
стегозавра	*стегозавра	стегозавра	1
гораздо	*гораздо	кращий	1
прогрессирует	*прогрессирует	прогресує	1
ваш	*ваш	у	1
поприветствовала	*поприветствовала	привітала	1
поговорить	*поговорить	полюблять	1
сноповязом	*сноповязом	скиртяром	1
клубника	*клубника	полуниця	1
возрасте	*возрасте	віці	1
любом	*любом	випадку	1
интригует	*интригует	інтригує	1
становилось	*становилось	холодніше	1
форду	*форду	форду	1
украл	*украл	хтось	1
участия	*участия	участі	1
голландца	*голландца	голландця	1
вырваться	*вырваться	вирватися	1
гораздо	*гораздо	мій	1
романтик	*романтик	романтик	1
атомов	*атомов	атомів	1
соловей	*соловей	соловей	1
вернётесь	*вернётесь	повернетеся	1
орать	*орать	репетувати	1
забывчивы	*забывчивы	схильні	1
чёрного	*чёрного	перевагу	1
храпит	*храпит	сну	1
продавщица	*продавщица	продавець	1
благоприятствовала	*благоприятствовала	.	1
лежал	*лежал	лежав	1
трое	*трое	троє	1
месье	*месье	мосьє	1
колебался	*колебался	вагався	1
остальные	*остальные	в	1
виделись	*виделись	бачилися	1
локтем	*локтем	ліктем	1
поделаешь	*поделаешь	поробиш	1
фирменные	*фирменные	фірмовий	1
транзитные	*транзитные	листи	1
нашу	*нашу	наш	1
модеста	*модеста	російського"	1
становятся	*становятся	стають	1
улетит	*улетит	злетить	1
воде	*к	води	1
путает	*путает	плутає	1
отчаянно	*отчаянно	відчайдушно	1
путешествовать	*путешествовать	подорожувати	1
хваталку	*хваталку	хваталку	1
промок	*промок	промок	1
футов	*футов	на	1
светофор	*светофор	працює	1
перестроил	*перестроил	батько	1
кролики	*кролики	крілики	1
перчаток	*перчаток	нових	1
мост	*мост	новий	1
лицемер	*лицемер	лицемір	1
боюсь	*боюсь	.	1
ошеломила	*ошеломила	приголомшила	1
посчитай	*посчитай	порахуй	1
красивые	*красивые	які	1
здравствует	*здравствует	хай	1
боязливые	*бываем	буваємо	1
чихаю	*чихаю	чихаю	1
эй	*эй	ей	1
приложение	*приложение	додаток	1
целительница	*целительница	цілительниця	1
пьёт	*пьёт	випиває	1
производит	*производит		1
насчёт	*насчёт	щодо	1
японцев	*ездит	за	1
добраться	*добраться	дістатися	1
здесь	*здесь	крамниця	1
небольшой	*небольшой		1
трилобитов	*трилобитов	силурійського	1
прижми	*прижми	тримай	1
рыдала	*рыдала	ридала	1
мечтаешь	*мечтаешь	мрієш	1
гольф	*гольф	вправно	1
конкурирует	*конкурирует	конкурує	1
плаваю	*плаваю	плаваю	1
рассудит	*рассудит	покаже	1
патчем	*патчем	патчем	1
сына	*единственного	єдиного	1
.	*франции	.	1
остальные	*остальные	,	1
и	*стеснительные	буваємо	1
вернулись	*вернулись	повернулися	1
ни	*ни	перекладають	1
следовавший	*следовавший	йшов	1
голливудский	*голливудский	сволота	1
прислужиться	*прислужиться	прислужитись	1
униформа	*униформа	відмінності	1
безгрешен	*безгрешен	годым	1
стружке	*стружке	солодко	1
впечатляет	*впечатляет	це	1
псарь	*псарь	пани	1
зарезервированы	*зарезервированы	.	1
бананом	*бананом	бананом	1
стало	*аниме	того	1
молодая	*молодая	молода	1
ужинал	*ужинал	вечеряв	1
бабушка	*бабушка	бабусю	1
развлекались	*развлекались	увечері	1
клади	*клади	не	1
опаздывать	*опаздывать	запізнюватися	1
увидятся	*увидятся	побачаться	1
ни	*ни	анi	1
укусила	*укусила	вкусив	1
.	*сердит	.	1
поймал	*поймал	упіймав	1
танцует	*танцует	потім	1
сбрасывать	*сбрасывать	вазі	1
прошептал	*прошептал	щось	1
послушаться	*послушаться	послухатися	1
запомни	*запомни	"запам'ятай	1
верилось	*верилось	вірилося	1
табуретка	*табуретка	табуретка	1
зацветает	*зацветает	зацвітає	1
очнитесь	*очнитесь	прокиньтеся	1
чудесна	*чудесна	чудова	1
ненавидела	*ненавидела	вона	1
помню	*помню	пам'ятаю"	1
выпал	*выпал	падъ	1
картонных	*картонных	кілька	1
собственно	*собственно	зізнаюсь	1
радостней	*радостней	радісніший	1
бред	*бред	цілковита	1
отче	*отче	хліб	1
синяя	*синяя	синя	1
отняла	*отняла	у	1
крупные	*крупные	що	1
поэтому	*поэтому	тому	1
неподвижно	*неподвижно	заплющеними	1
сходила	*сходила	розпачі	1
захватчики	*захватчики	викрадачі	1
карие	*карие	справді	1
лезь	*лезь	лізь	1
храним	*храним	як	1
угощайтесь	*угощайтесь		1
себя	*воспитанно	поводитись	1
нашей	*нашей	-	1
прямоугольна	*прямоугольна	,	1
полна	*полна	.	1
столик	*столик	столик	1
рассердил	*рассердил	розізлив	1
догадываться	*догадываться	здогадуватися	1
возьмите	*возьмите	будь	1
установил	*установил	зміг	1
униформа	*униформа	"?	1
вашей	*вашей	вашого	1
тает	*тает	тане	1
сошёл	*сошёл	не	1
веранду	*веранду	веранду	1
гожусь	*гожусь	годжуся	1
карбоновое	*карбоновое	карбонову	1
портят	*портят	псують	1
бросилась	*бросилась	афіша	1
бездянка	*бездянка	ця	1
ушёл	*ушёл	,	1
перемен	*перемен	»	1
похож	*похож	зеландії	1
согласен	*согласен	згодний	1
ни	*ни	жодне	1
упаковал	*упаковал	том	1
привидения	*привидения	привиди	1
лает	*лает	гавкає	1
нюнорска	*основывается	.	1
клянусь	*клянусь	присягаюся	1
сладко	*сладко	солодко"	1
посвечу	*посвечу	посвічу	1
жопа	*жопа	дупа	1
уходим	*уходим	тільки	1
гвозди	*гвозди		1
удался	*удался	експеремент	1
непостоянные	*непостоянные		1
нездоров	*нездоров	нездоровий	1
хоккайдо	*хоккайдо	бував	1
утихнет	*утихнет	вщухне	1
саночки	*саночки	оскомину	1
водятся	*водятся	плодяться	1
употреблять	*употреблять	теплим	1
джордан	*джордан	джордан	1
расслабьтесь	*расслабьтесь	розслабтеся	1
шопена	*шопена	шопена	1
посылать	*посылать	добре	1
чтобы	*грею	під	1
плыви	*плыви	пливи	1
америки	*америки	південну	1
японцев	*японцев	їздить	1
посчастливилось	*посчастливилось	пощастило	1
ящер	*ящер	ящір	1
годы	*годы	розплачуються	1
модеста	*модеста	мусоргського	1
негде	*негде	більше	1
снотворного	*снотворного	снодійного	1
другой	*другой	наша	1
всякой	*всякой	всякій	1
чтобы	*грею	,	1
возле	*возле	а	1
кондиционирование	*кондиционирование	сильне	1
мудры	*мудры	.	1
дорого	*дорого	дорого	1
угарте	*угарте	угарт"	1
ян	*ян	ян	1
погулять	*погулять	погуляти	1
к	*к		1
обсохнуть	*обсохнуть	обсохнути	1
изобретать	*изобретать	нові	1
изменения	*изменения	,	1
целыми	*целыми	цілоденно	1
потеряла	*потеряла	",	1
звучит	по-*вьетнамски	єтнамською	1
сожалению	*сожалению	жаль	1
присутствовал	*присутствовал	присутнім	1
изучал	*изучал	вивчав	1
аккаунт	*фейсбуке	акаунт	1
плакал	*плакал	плакала	1
ставили	*ставили	ставили	1
какой	*какой	якої	1
исландский	*исландский	для	1
взял	*взял	позичив	1
председателя	*председателя	обирали	1
поскорее	*поскорее	приходь	1
помню	*помню	"не	1
женда	*женда	женда	1
диджей	*диджей	діджей	1
брился	*брился	голився	1
летает	*летает	опудало	1
сырой	*сырой	.	1
смерти	*боюсь	боюся	1
выдались	*выдались	січня	1
прокисло	*прокисло	скисло	1
зверь	*зверь	яка	1
горбатого	*горбатого	хто	1
берегись	*берегись	обережно	1
курит	*курит	.	1
бей	*бей	вдар	1
ездит	*ездит	.	1
берут	*берут	беруть	1
европейцы	*европейцы	європейці	1
крупные	*крупные	існують	1
молодо	*молодо	молодо	1
настоящий	*настоящий	справжня	1
крис	*крис	кріс	1
камнем	*камнем	каменем	1
чародеи	*чародеи	чарівники	1
псарь	*псарь	підпанки	1
теннис	*теннис	грав	1
сдвинем	*сдвинем	зрушимо	1
плюнуть	*плюнуть	простого	1
повзрослел	*повзрослел	подорослішав	1
окажете	*окажете	мені	1
роксолана	*роксолана	роксолана	1
наше	*наше	нашу	1
взял	*взял	з	1
виделись	*виделись	бачились	1
америку	*америку	дістанемось	1
бывшего	*бывшего	колишнього	1
встаёте	*встаёте	"''	1
получилось	*получилось	вийшло	1
мальчишками	*мальчишками	хлопцями	1
воздвигли	*воздвигли	спорудили	1
словио	*словио	словіо	1
высшего	*высшего	має	1
клубе	*клубе	продаються	1
понкьелли	*понкьелли	понк'єллі	1
столь	*столь	речення	1
бирманских	*бирманских	я	1
припарковалась	*странная	дивна	1
задать	*задать	?	1
плюшевая	*плюшевая	плюшева	1
перестроил	*перестроил	гараж	1
бегает	*бегает	сестра	1
к	*к	підготувалася	1
светофор	*светофор	світлофор	1
лысой	*лысой	лисій	1
улыбнись	*улыбнись	посміхнися	1
производит	*производит	?	1
анна	*анна	анна	1
предпочитаю	*предпочитаю	перед	1
сближаемся	*сближаемся	до	1
родила	*родила	двадцятирічна	1
зажечь	*зажечь	не	1
прощайте	*прощайте	тримайтесь	1
пьёшь	*пьёшь	"п'єш	1
старину	*старину	улмыж	1
всего	*выглядит	найкраще	1
пломбы	*пломбы	пломби	1
простыни	*простыни	простирадла	1
субботниках	*субботниках	суботниках	1
нравы	*нравы	та	1
заполнять	*заполнять	заповнювати	1
понравился	*понравился	не	1
морочь	*морочь	вішай	1
целый	*целый	цілу	1
ни	*ни	б	1
бедки	*бедки	,	1
неверных	*неверных	він	1
поэтому	*поэтому	за	1
промазать	*промазать	схибити	1
ни	*ни	,	1
познакомьте	*познакомьте		1
жирный	*жирный	.	1
похвалы	*похвалы	похвали	1
судьбы	*судьбы	.	1
до	*до	добраніч	1
очнись	*очнись	прокинься	1
этакой	*этакой	отакої	1
попросить	*попросить	попросити	1
перчаток	*перчаток	.	1
великих	*великих	велика	1
завтракаю	*завтракаю	я	1
всяком	*всяком	усякому	1
браузеры	*браузеры	.	1
сладким	*сладким	солодким	1
встревожилась	*встревожилась	занепокоїлася	1
пожелаете	*пожелаете	добре	1
до	*до	ohropax	1
беле	*беле	відказав	1
фотогеничен	*фотогеничен	фотогенічний	1
ваше	*ваше	.	1
послушайся	*послушайся		1
бывал	*бывал	хоккайдо	1
тошнило	*тошнило	нудило	1
постарался	*постарался	намагатимуся	1
ездит	*ездит	в	1
блузка	*блузка	пасуватиме	1
привидения	*привидения	примари	1
потрогаю	*потрогаю	до	1
пиццу	*пиццу	піццу	1
нашим	*нашим	мосту	1
выклюет	*выклюет	виклює	1
рад	*рад	радітиму	1
бери	*бери	бери	1
иван	*иван	так	1
белоснежное	*белоснежное	дійсно	1
мейзнер	*мейзнер	мейзнер	1
поймали	*поймали	ведмедя	1
поцеловать	*поцеловать	поцілувати	1
молод	*молод	.	1
ни	*ни		1
ошибок	*грамматических	ж	1
читал	*читал	часом	1
касабланку	*касабланку	касабланку	1
чаю	*чаю	чашку	1
тряслась	*тряслась	тремтіла	1
ушли	*ушли	.	1
незнакомцев	*незнакомцев	незнайомців	1
петр	*петр	петр	1
искупаться	*искупаться	скупатись	1
низине	*низине	побудовано	1
сэм	*сэм	сем	1
обманут	*обманут	збрешуть	1
диарея	*диарея	діарея	1
погас	*погас	згас	1
пригородный	*пригородный	приміський	1
перегораживайте	*перегораживайте	загороджуйте	1
злить	*злить	злити	1
исландский	*исландский	.	1
зеландии	*зеландии	новій	1
прилежанием	*прилежанием	старанністю	1
предпочитаю	*предпочитаю		1
пылкую	*пылкую	палке	1
целый	*целый	тут	1
десерт	*десерт	куштували	1
жалует	*жалует	як	1
прибираться	*прибираться	кімнату	1
одухотворено	*одухотворено	одухотворене	1
подумают	*подумают	подумали	1
великим	*великим	вченим	1
вините	*вините	звинувачуйте	1
мило	*мило	матері	1
пальм	*пальм	пальм	1
сбрасывать	*сбрасывать	у	1
становились	*становились	ставало	1
выйдет	*выйдет	вийде	1
нашей	*до	нашої	1
вернуться	*вернуться	повернутися	1
глуп	*глуп	дурний	1
покровительством	*покровительством	сприяння	1
вставай	*вставай	вставай	1
докладывали	*докладывали	докладали	1
настоящие	*настоящие	теперішні	1
упаковать	*упаковать	щоб	1
кверху	*кверху	прекрасніше	1
аптечка	*аптечка	унизу	1
опоздаете	*опоздаете	пропустите	1
аой	*аой	аой	1
пунктуальный	*пунктуальный	пунктуальний	1
зарегистрироваться	*зарегистрироваться	зареєструватися	1
предъявила	*предъявила	надала	1
шило	*шило	бика	1
случилось	*ни	це	1
настоящий	*настоящий	справжній	1
траходон	*траходон	траходон	1
рассердить	*рассердить	розсердити	1
выбор	*единственный	єдиний	1
ни	*ни	про	1
спрячься	*спрячься	сховайся	1
младшая	*младшая	молодша	1
плюшевых	*плюшевых	літака	1
чашку	*чашку	чашечку	1
потерявши	*потерявши	втеряєш	1
бутылочку	*бутылочку	!	1
шоколадное	*шоколадное	печиво	1
отчитываться	*отчитываться	звітувати	1
убежал	*убежал	утік	1
тяжелая	*какая	яка	1
давай	*другим	дай	1
диваном	*диваном	канапою	1
изобретать	*изобретать	легко	1
стёрт	*стёрт	стертий	1
какао	*какао	какао	1
токио	*токио	сполучує	1
спели	*спели	заспівали	1
другой	*другой	ж	1
до	*до	прогулялися	1
лёг	*лёг	ліг	1
лает	*лает	гавка	1
дебил	*дебил	дебіл	1
старика	*старика	старого	1
небесех	*небесех	небесах	1
хрупкий	*хрупкий	крихка	1
вытащил	*вытащил	витягнув	1
уходом	*уходом		1
мамонт	*мамонт	мамонт	1
белорусский	*изучает	не	1
окончен	*окончен	закінчено	1
уганды	*уганды	уганди	1
красивый	*красивый	має	1
воспрещён	*воспрещён	заборонено	1
пианино	*пианино	граю	1
поймана	*поймана	спіймана	1
другой	*другой	іншій	1
окажете	*окажете	не	1
к	*к	блуза	1
танцевала	*танцевала	столі	1
равнодушен	*равнодушен	пива	1
начеку	*начеку	напоготові	1
какого	*какого	ти	1
колю	*колю	.	1
потеряли	*потеряли	хто	1
идиотка	*идиотка	ідіотка	1
виноват	*виноват	.	1
патронов	*патронов	патронів	1
летают	*летают	летають	1
тодзи	*тодзи	тодзі	1
ставить	*ставить	складати	1
домой	*домой	іду	1
пробуждает	*пробуждает	пробуджує	1
пьёте	*пьёте	"п'єте	1
!	*аж	!	1
переписали	*переписали	переписали	1
порисовать	*порисовать	помалювати	1
пьёшь	*пьёшь	завджи	1
вполне	*вполне	впевнений	1
ни	*ни	я	1
становится	*становится	і	1
столкнулся	*столкнулся	зіштохнувся	1
ни	*ни	«	1
кролик	*кролик	білий	1
чёрного	*чёрного	надаю	1
тварь	*тварь	тварюко	1
изменчива	*изменчива	мінлива	1
перекуют	*перекуют	перекують	1
дохнут	*дохнут	дохнуть	1
свяжите	*свяжите	"зв'яжіть	1
перекатился	*перекатился	перекотився	1
рулите	*рулите	керу	1
классовые	*классовые	класові	1
.	*вкусный	та	1
закоулок	*закоулок	закуток	1
странно	*странно	,	1
сам	*носить	як	1
завтракает	*завтракает	снідає	1
наших	*наших	білоруськів	1
покончил	*покончил	.	1
пустую	*пустую	цю	1
нечто	*нечто	варте	1
рад	*рад	вражений	1
чуть	*чуть	я	1
наклонилась	*наклонилась	камінчик	1
большей	*большей	більшої	1
ложным	*ложным	.	1
покончил	*покончил	покінчив	1
.	*задумываюсь	.	1
орест	*орест	орест	1
окончится	*окончится	експеремент	1
потребовалась	*потребовалась	вічність	1
поступок	*поступок	ваша	1
дурацкого	*дурацкого	ідіотського	1
сам	*носить	того	1
насчёт	*насчёт	відносно	1
боялась	*боялась	боялася	1
однажды	*однажды	дня	1
садитесь	*садитесь	сідайте	1
искупаемся	*искупаемся	скупатись	1
отвратительно	*отвратительно	гидко	1
пить	*пить	вживати	1
бизон	*бизон	бізон	1
?	*получилось	не	1
берт	*берт	берт	1
тараканы	*тараканы	таргани	1
замужем	*замужем	виходила	1
наших	*наших	і	1
спросить	*спросить	поставити	1
мистере	*мистере	містера	1
плюшевых	*плюшевых	ведмедиків	1
арбуз	*арбуз	кавун	1
квантовая	*квантовая	квантова	1
мясо	*мясо	м	1
долги	*остави	;	1
богаты	*богаты	багаті	1
остальных	*остальных	.	1
пьёте	*пьёте	п'єте	1
становились	*тоньше	ставало	1
пекин	*пекин	пекін	1
головы	*головы	на	1
просыпаюсь	*просыпаюсь	,	1
разбежались	*разбежались	навсібіч	1
издали	*издали	здалеку	1
!	*поступках	!	1
пешком	*пешком	10	1
спускайся	*спускайся	опускайся	1
порвала	*порвала	порвала	1
блузку	*блузку	блузку	1
направляются	*сообщники	і	1
апельсины	*апельсины	помаранчі	1
переношу	*переношу	переношу	1
вылепил	*вылепил	виліпив	1
кишки	*кишки	кишки	1
евгений	*евгений	євген	1
душно	*душно	задуха	1
йокогама	*йокогама	йокогама	1
чернильных	*чернильных	чорнильних	1
буерак	*буерак	байрак	1
переодеться	*переодеться	перевдягнутися	1
общепризнанной	*общепризнанной	стане	1
убирать	*убирать	прибирати	1
покое	*покое	у	1
скобки	*скобки	дужки	1
другие	*другие	додачу	1
вежливой	*вежливой	ввічливою	1
всюду	*всюду	ставитися	1
крупными	*крупными	дуже	1
до	*до	десятої	1
к	*к	причетний	1
старики	*старики	люди	1
заводь	*заводь	затока	1
будильник	*будильник	будильник	1
полетел	*полетел	полетів	1
свободными	*свободными	своїй	1
зеландии	*зеландии	схожий	1
равнодушен	*равнодушен	байдужий	1
старался	*старался	я	1
.	*тоньше	і	1
суров	*суров	суровий	1
.	*внешнеэкономическим	зовнішньоекономічних	1
мезозойскую	*мезозойскую	мезозойську	1
окончится	*окончится	закінчиться	1
предпочитаю	*предпочитаю	алкоголю	1
вытерпеть	*вытерпеть	стерпіти	1
обопрись	*обопрись	обіпрись	1
допотопными	*допотопными	землі	1
красивый	*красивый	тоні	1
участия	*участия	брати	1
весенняя	*весенняя	весняна	1
зонтик	*зонтик	не	1
обиделся	*обиделся	образився	1
покрепче	*покрепче	міцніше	1
черное	*черное	чорне	1
закричала	*закричала	закричала	1
окутал	*окутал	оповив	1
мост	*мост	мосту	1
чек	*чек	чек	1
тадеуш	*тадеуш	тадеуш	1
бывает	*бывает	.	1
берёт	*берёт	книгу	1
орет	*орет	волає	1
предназначение	*предназначение	будь-якою	1
пробкой	*пробкой	пробкою	1
засранцев	*засранцев	в	1
бездействующим	*бездействующим	бездіяльним	1
польша	*польша	польща	1
нависла	*нависла	наді	1
вольнодумцем	*вольнодумцем	вільнодумцем	1
несла	*несла	корзину	1
мужчинам	*мужчинам	чоловікам	1
воздвиг	*воздвиг	спорудив	1
бетти	*бетти	беті	1
арабы	*арабы	араби	1
солнцезащитные	*солнцезащитные	сонячні	1
гугла	*гугла	допомогою	1
похожи	*похожи	як	1
поймал	*поймал	його	1
одинок	*одинок	самотнім	1
напрягаешься	*напрягаешься	напружуєшся	1
согласиться	*согласиться	погодитись	1
.	*вкусный	.	1
черным	*черным	видовисько	1
кружевом	*кружевом	мереживом	1
великого	*великого	видатного	1
стыдливое	*стыдливое	.	1
однажды	*однажды	разу	1
плачь	*плачь	ласка	1
странное	*странное	...	1
редьку	*редьку	редьку	1
к	*к	ди	1
горькое	*горькое	гіркі	1
приступа	*приступа	.	1
варьете	*варьете	примхи	1
и	*стеснительные	ж	1
пьеса	*пьеса	п	1
синей	*синей	фланелі	1
пробрался	*пробрался	прокрався	1
липнут	*к	липнуть	1
вернитесь	*вернитесь	поверніться	1
пелёнках	*пелёнках	подушках	1
позже	*позже	ласка	1
снился	*снился	снився	1
здравствуйте	*здравствуйте	добридень	1
гордится	*гордится	вами	1
голову	*голову	лапшу	1
к	*к	повернула	1
к	*к	мені	1
греет	*греет	гріє	1
богат	*богат	,	1
корень	*корень	корінь	1
несет	*несет	курка	1
яблони	*яблони	яблуньки	1
свари	*свари	звари	1
гладить	*гладить	прасувати	1
спросил	*спросил	,	1
чесал	*чесал	спробував	1
потребовалась	*потребовалась	знадобиться	1
мужчин	*мужчин	продаються	1
забывчивы	*забывчивы	забувати	1
босс	*босс	босе	1
свыкнись	*свыкнись	вже	1
чашкой	*чашкой	чашкою	1
опять	*опять	нього	1
встал	*встал	дуже	1
ива	*ива	верба	1
бэтмана	*бэтмана	бетмена	1
настал	*настал	!	1
лошадь	*лошадь	.	1
пчёл	*пчёл	бджіл	1
морковку	*морковку	морквину	1
нил	*нил	найдовша	1
файтак	*файтак	файтак	1
поэтому	*поэтому	ось	1
поцарапал	*поцарапал	подряпав	1
незачёт	*незачёт	незалік	1
поумнел	*поумнел	помудрішала	1
какую	*какую	книгу	1
пораньше	*пораньше	прийду	1
поспешил	*поспешил	поквапився	1
сходку	*сходку	на	1
замужем	*замужем	заміж	1
нельзя	*нельзя	не	1
развязались	*развязались	розв'язалися"	1
попробую	*попробую	спробую	1
непредвиденный	*непредвиденный	непередбачений	1
поживаешь	*поживаешь	ся	1
сам	*носить	де	1
и	*боязливые	ж	1
иностранки	*иностранки	іноземки	1
покровительством	*покровительством	за	1
выпорхнет	*выпорхнет		1
нашим	*нашим	прощаємо	1
сбудется	*сбудется	.	1
мяч	*мяч	яч	1
берут	*берут	на	1
передумал	*передумал	передумав	1
и	*людских	людських	1
останавливайтесь	*останавливайтесь	.	1
любовники	*любовники	коханці	1
возраста	*возраста	.	1
минуточку	*минуточку	хвилинку	1
финляндии	*финляндии	фінляндії	1
огромная	*огромная		1
рассердиться	*рассердиться	рогніватись	1
легче	*переносить	легше	1
скользкие	*скользкие	слизькі	1
собственного	*собственного	соромно	1
сводит	*сводит	зводить	1
вышла	*вышла	вона	1
ошиблась	*ошиблась	помилилася	1
другим	*другим	іншим	1
выпьем	*выпьем	випиймо	1
ведра	*ведра	відра	1
отмоется	*отмоется	відмиється	1
китов	*китов	китів	1
гнилое	*гнилое	гниле	1
произвели	*произвели	спавили	1
подевался	*подевался	подівся	1
кружится	*кружится	.	1
пиджак	*пиджак	пасує	1
лезь	*лезь	ходи	1
мебель	*антикварная	.	1
дори	*дори	дорі	1
сломался	*сломался	зламався	1
присутствовали	*присутствовали	.	1
ерунда	*ерунда	дрібниці	1
новоявленный	*новоявленный	голівудська	1
всякого	*всякого	усякої	1
читая	*читая	із	1
дождливые	*дождливые	до	1
ни	*ни	холодна	1
поймал	*поймал	.	1
показались	*показались	здалися	1
мяса	*мяса	м	1
камень	*камень	камінь	1
возраст	*возраст	вік	1
увидеться	*увидеться	тебе	1
услышать	*меленянах	меленяни	1
шипы	*шипы	шипи	1
витамины	*витамины	оуцільні	1
преградил	*преградил		1
что	*пообедал	.	1
некоторые	*некоторые	полюбляють	1
жительства	*жительства	проживання	1
последняя	*последняя	остання	1
храпит	*храпит	голосно	1
немцы	*немцы	німці	1
другого	*другого	нас	1
успеет	*успеет	на	1
зонтик	*зонтик	у	1
ларри	*ларри	ларрі	1
будильник	*будильник	скільки	1
бирманских	*бирманских	12	1
посторонней	*посторонней	сторонньої	1
обязан	*обязан	зобов'язаний	1
чешется	*чешется	у	1
гордится	*гордится	ваш	1
синхронного	*синхронного	сінхронного	1
хочется	*хочется	перекладати	1
стареет	*стареет	старіє	1
сжигает	*сжигает	нищить	1
состоялась	*состоялась	відбулася	1
гавайях	*гавайях	гавайях	1
иероглифы	*иероглифы	ієрогліфи	1
курю	*курю	.	1
сытый	*сытый	ситий	1
прилипла	*прилипла	прилипла	1
единственная	*единственная	єдина	1
других	*других	вийшло	1
ни	*ни	без	1
ледниковый	*ледниковый	льодовиковий	1
пристрелю	*пристрелю	застрелю	1
гамлета	*гамлета	грає	1
женюсь	*женюсь	одружуся	1
пиццу	*пиццу	піцу	1
мне	*загородило	мені	1
мальчишки	*мальчишки	хлопці	1
чёрный	*чёрный	чорний	1
просыпаешься	*просыпаешься	прокидаєшся	1
братиславе	*братиславе	лишились	1
понадобится	*понадобится	етапу	1
синано	*синано	сінано	1
крупными	*крупными	великими	1
твёрдом	*твёрдом	твердому	1
задала	*задала	декілька	1
трезвенник	*трезвенник	непитущий	1
бумаги	*бумаги	паперу	1
лузер	*лузер	лузер	1
чикаго	*чикаго	чікаго	1
другого	*другого	.	1
насмешишь	*насмешишь	насмішиш	1
зверь	*зверь		1
создатели	*создатели	мови	1
соломинка	*соломинка	ооломинка	1
вернусь	*вернусь	незабаром	1
драгоценные	*драгоценные	дорогоцінне	1
сдастся	*сдастся	здається	1
ветряных	*ветряных	бачив	1
гей	*гей	звикай	1
горечь	*горечь	гіркоту	1
вытерла	*вытерла	витерла	1
разозлился	*разозлился	розлютився	1
надрываются	*надрываются	тягають	1
лучшим	*лучшим	був	1
руа	*руа	де	1
потрогаю	*потрогаю	доторкнутися	1
прилежнее	*прилежнее	старанніше	1
ерунды	*ерунды	дурниць	1
бегает	*бегает	кожного	1
кататься	*кататься	лижах	1
развлекались	*развлекались	розважалися	1
кэнсукэ	*кэнсукэ	кенсуке	1
болит	*болит	дупа	1
передвинь	*передвинь	пересунь	1
притворяется	*притворяется		1
лопнуло	*лопнуло	урвався	1
стеснительные	*стеснительные	хибно	1
тафтс	*тафтс	тафтс	1
спроси	*спроси	спитай	1
разведётся	*разведётся	розлучиться	1
новообращённый	*новообращённый	новозверений	1
осенила	*осенила	мені	1
тягаться	*тягаться	змагатися	1
починил	*починил	гарно	1
юми	*юми	—	1
другой	*другой	ви	1
звонить	*звонить	дзвонити	1
жребий	*жребий	кинуто	1
липнут	*липнут	липнуть	1
уборная	*уборная	прибиральня	1
деревни	*деревни	села	1
чернильных	*чернильных	декілька	1
равно	*вчерашнего	весело	1
кристин	*кристин	кристін	1
прекратится	*прекратится	припиниться	1
другой	*другой	клуба	1
аисты	*аисты	лелеки	1
строки	*строки	рядки	1
направляетесь	*направляетесь	направляєтеся	1
барабана	*барабана	барабана	1
величайших	*величайших	вважається	1
ивонн	*ивонн	івон	1
однажды	*однажды	ти	1
двадцатилетняя	*двадцатилетняя	дочка	1
младший	*младший	молодший	1
звучит	по-*вьетнамски	звучить	1
ловить	*ловить	рибалити	1
здесь	*здесь	...	1
кончилось	*кончилось	.	1
молодые	*молодые	молоді	1
хуй	*хуй	іди	1
...	*черточек	...	1
медный	*медный	мідний	1
андрееску	*андрееску	адреєску	1
здравствуйте	*здравствуйте	драстуйте	1
оказываемых	*оказываемых	учинених	1
себя	*воспитанно	виховано	1
курит	*курит	палить	1
спелое	*спелое	стигле	1
стружке	*стружке	стружці	1
завидую	*завидую	заздрю	1
бейсбол	*бейсбол	грали	1
стрела	*стрела	стріла	1
верблюды	*верблюды	верблюди	1
домой	*домой	іти	1
злюсь	*злюсь	злюся	1
выпадает	*выпадает	.	1
смыло	*смыло	змило	1
настоящая	*настоящая	не	1
водятся	*водятся	рве	1
засранцев	*засранцев	задрипанців	1
ушёл	*ушёл	пішов	1
сладостей	*сладостей	солодощів	1
богат	*богат	багатий	1
взять	*взять	новий	1
покрасил	*покрасил	пофарбував	1
потерей	*нашей	втратою	1
жрёт	*жрёт	цей	1
услышав	*услышав	почувши	1
захватчики	*захватчики	засуджені	1
нью-йорке	*нью-*йорке	свого	1
посторонним	*посторонним	стороннім	1
камень	*камень	камінчик	1
вместо	*вместо	приймач	1
ни	*ни	один	1
простудиться	*простудиться	застудитися	1
последнее	*последнее	мюріел	1
кверху	*кверху	здіймається	1
одноклассники	*одноклассники	однокласники	1
возьмите	*возьмите	візьміть	1
юна	*юна	молода	1
переливать	*переливать	переливати	1
атаковала	*атаковала	атакувала	1
ни	*ни	ни	1
карие	*карие	очі	1
боюсь	*боюсь		1
долги	*остави	наші	1
преддвериях	*преддвериях	силуру	1
переговоров	*переговоров	з	1
вернулся	*вернулся	заробивши	1
остальным	*остальным	інших	1
странное	*странное	назва	1
здешними	*здешними	складено	1
целый	*целый	тебе	1
читая	*читая	читаючи	1
клади	*клади	кладіть	1
латунь	*латунь	латунь	1
истории	*нашей	історії	1
тревожит	*тревожит	хвилює	1
потерялся	*потерялся	в	1
летает	*летает	.	1
избавься	*избавься	позбався	1
едет	*ловить	вихідні	1
невербальным	*невербальным	невербальним	1
молю	*молю	благаю	1
вегетарианец	*вегетарианец	вегетаріанець	1
танцовщица	*танцовщица	танцівниця	1
.	*млекопитающие	.	1
стеснительные	*стеснительные	і	1
высшего	*высшего	не	1
появились	*появились	’	1
забавную	*забавную	кумедну	1
прилипла	*жвачка	жуйка	1
спущусь	*спущусь	спущуся	1
угодно	*угодно	читати	1
дверцы	*дверцы	дверцята	1
ненавидит	*ненавидит	кішок	1
пальмы	*пальмы	пальми	1
скрылись	*скрылись	.	1
,	*мишек	плюшевих	1
любые	*любые	радий	1
покорен	*покорен	підкорений	1
попробуем	*попробуем	опробуємо	1
завтрашнего	*завтрашнего	електронної	1
накоплю	*накоплю	накопичую	1
какой	*какой	що	1
ваш	*ваш	подивитися	1
красивой	*красивой	прекрасна	1
прослушала	*прослушала	прослухала	1
неудачник	*неудачник	невдаха	1
поучи	*поучи	твого	1
обокрали	*обокрали	обікрали	1
починил	*починил	тут	1
джонсон	*джонсон	вчений	1
променял	*променял	проміняв	1
какова	*какова	яка	1
собственная	*собственная	життя	1
.	*вышло	.	1
уехала	*уехала	полетіла	1
мнение	*мнение	має	1
допотопными	*допотопными	про	1
плакала	*плакала	,	1
никакого	*никакого	ні	1
!	*нашим	!	1
уподобляйся	*уподобляйся	чим	1
—	*петровщина	—	1
уставшей	*уставшей	втомлена	1
годы	*годы	зраджувала	1
тролля	*тролля	троля	1
однажды	*однажды	якось	1
гитаре	*гитаре	грає	1
перелезали	*перелезали	перелазили	1
шуми	*шуми	будь	1
вредит	*вредит	дошкуляє	1
.	*сердит	,	1
ясное	*ясное	звісно	1
производится	*производится	виробляється	1
наших	*наших	іншого	1
ушли	*ушли	без	1
становится	*становится	гірше	1
обернулась	*обернулась	обернулася	1
грести	*грести	гребти	1
накоплю	*накоплю	на	1
развлекались	*развлекались	,	1
летать	*летать	страуси	1
выражаются	*выражаются	виражаються	1
булькает	*булькает	булькає	1
бедолага	*бедолага	бідаха	1
.	*коулом	.	1
плюшевая	*плюшевая	лишень	1
просил	*просил	просив	1
встаю	*встаю	восьмій	1
молодо	*молодо	і	1
юбки	*юбки	спідниці	1
чашечку	*чашечку	філіжанку	1
припарковать	*припарковать		1
беседуем	*беседуем	ми	1
римляне	*римляне	римляни	1
становились	*тоньше	тоншим	1
знамо	*знамо	відома	1
нобелевскую	*нобелевскую	нобелівську	1
помни	*помни	"пам'ятай	1
наслушались	*наслушались	?	1
эгоистичным	*эгоистичным	егоїстичним	1
никаких	*никаких	ніяких	1
уставший	*уставший	втомлений	1
фотографируйте	*фотографируйте	не	1
пощупал	*пощупал	лікар	1
к	*к	адаптується	1
запел	*запел	заспівав	1
вольно	*вольно	вільно	1
рассмеяться	*рассмеяться	розсміятися	1
обязан	*обязан	кожен	1
пожалеешь	*пожалеешь	шкодуватимеш	1
преградил	*преградил	заступив	1
думают	*вебмастеры	думають	1
необходимо	*необходимо		1
здесь	*здесь	побудовано	1
хмурый	*хмурый	похмурий	1
твёрже	*твёрже	за	1
глядя	*глядя	на	1
насекомое	*насекомое	комаху	1
нюнорска	*нюнорска	використовували	1
глупую	*глупую	таку	1
стричь	*стричь	нігті	1
чучело	*чучело	крокодила	1
рыжеватые	*рыжеватые	руденьке	1
почетные	*почетные	відвідувачі	1
наших	*дожили	.	1
оторвалась	*оторвалась	.	1
задавайте	*задавайте	ставте	1
пальм	*пальм	,	1
помните	*помните	"ви	1
поймали	*поймали	упіймали	1
настанет	*настанет	новий	1
встаёте	*встаёте	встаєте	1
едете	*едете	їдете	1
марко	*марко	марко	1
ломит	*ломит	ломить	1
хирургическая	*хирургическая	хірургічна	1
поучи	*поучи	навчи	1
стало	*аниме	з	1
давненько	*давненько	не	1
обыскался	*обыскался	обшукався	1
три	*три	дні	1
сандвичей	*сандвичей	канапок	1
поймает	*поймает	зловить	1
другая	*другая	інша	1
успокойся	*успокойся	розслабся	1
совершенству	*совершенству	досконалості	1
кое	*кое	може	1
красивых	*красивых	красивих	1
любовницу	*любовницу	коханку	1
зацветает	*зацветает	коли	1
ви	*ви	ви	1
футов	*футов	диаметрі	1
подстелил	*подстелил	підстелив	1
шёпотом	*шёпотом	пошепки	1
бедки	*бедки	.	1
бездянки	*бездянки	бездянці	1
угощайтесь	*угощайтесь	ласка	1
пробкой	*пробкой	дорожною	1
каникулах	*каникулах	канікулах	1
пальме	*пальме	міцніше	1
стыдно	*стыдно	соромно	1
поехать	*поехать	ту	1
штормовое	*штормовое	штормове	1
очевиден	*очевиден	очевидна	1
австралия	*австралия	австралія	1
какой	*какой	здоровезний	1
три	*три	після	1
сыро	*сыро	сиро	1
цену	*какую	яку	1
белоснежное	*белоснежное	білосніжне	1
постою	*постою	постою	1
довольны	*довольны	задоволені	1
зародилась	*зародилась	в	1
сменился	*сменился	змінився	1
опаздывают	*опаздывают	запізнюються	1
таинственные	*таинственные	загадкові	1
.	*косметика	косметика	1
мистер	*мистер	мілль	1
летает	*летает	величезного	1
путешествую	*путешествую	подорожую	1
всякий	*всякий	всякий	1
трубку	*трубку	люльку	1
выдумали	*выдумали	що	1
здесь	*здесь	?	1
плачь	*плачь	плач	1
простудился	*простудился	не	1
уехала	*уехала	поїхала	1
японцев	*японцев	багато	1
голосовать	*голосовать	голосувати	1
обязан	*обязан	"зобов'язаний	1
наслаждайтесь	*наслаждайтесь	насолоджуйтесь	1
эквадора	*эквадора	еквадору	1
про	*собственную	вигоду	1
плюшевых	*плюшевых	розкидував	1
полную	*полную	,	1
и	*стеснительные	ми	1
направляются	*сообщники	прямують	1
созрели	*созрели	достигли	1
что	*пообедал	щойно	1
лифтовой	*лифтовой	мінятимете	1
шокирован	*шокирован	печальною	1
задуматься	*задуматься	задуматися	1
нашему	*нашему		1
плаванье	*плаванье	плавання	1
коул	*коул	коул"	1
сибуе	*сибуе	сьомій	1
достаточных	*достаточных	підстав	1
к	*к	заборонено	1
сэндае	*сэндае	сендаї	1
мэйбл	*мэйбл	мейбл	1
рыбалкой	*рыбалкой	цікавлюся	1
полный	*полный	!	1
ваше	*ваше	мені	1
оглядывайся	*оглядывайся	озирайся	1
.	*оконце	.	1
выложился	*выложился	виклався	1
употреблять	*употреблять	чи	1
.	*вытерплю	.	1
поехать	*поехать	бостона	1
уехать	*уехать	поїхати	1
сыт	*сыт	ситий	1
передохли	*передохли	птиця	1
изучать	*изучать	починая	1
вордпресса	*вордпресса	вордпреса	1
передохнуть	*передохнуть	?	1
потащим	*потащим	потягнемо	1
возьмите	*возьмите	візміть	1
выяснилось	*выяснилось	виявилося	1
аспирин	*аспирин	аспірин	1
разлили	*разлили	розлили	1
выпадает	*выпадает	випадає	1
жгучей	*жгучей	смаги	1
другой	*другой	є	1
пошутил	*пошутил	пожартував	1
прямоугольна	*прямоугольна	цей	1
обеда	*до	до	1
невиновна	*невиновна	невинна	1
происшествие	*происшествие	.	1
причёской	*причёской	зачіскою	1
вечность	*вечность	цілу	1
далеки	*далеки	далекі	1
возле	*возле	був	1
мужчин	*мужчин	,	1
закурила	*закурила	закурила	1
покладисты	*покладисты	покладливими	1
сурок	*сурок	байбак	1
до	*до	відчиняти	1
.	*остальных	.	1
стеснительные	*порочно	і	1
красива	*красива	вродлива	1
неразговорчив	*неразговорчив	.	1
торопились	*торопились	поспішали	1
лентяй	*лентяй	ледар	1
старину	*старину	сулыкдымо	1
прошу	*прошу	пробачте	1
умоляю	*умоляю	благаю	1
пойдемте	*пойдемте	ходімо	1
фарфор	*фарфор	порцеляну	1
ме	*ме	ме	1
альпийские	*альпийские	альпійськи	1
заполнять	*заполнять	сторінку	1
диван	*диван	диван	1
африке	*африке	африці	1
укрыта	*укрыта	вкрита	1
перевозится	*перевозится	перевозиться	1
насущный	*наш	,	1
шкафу	*шкафу	начертить	1
шевелится	*шевелится	ворушиться	1
легкостью	*легкостью	легкістю	1
посольскую	*посольскую	схоже	1
замужем	*замужем	заміжня	1
звонил	*звонил	телефонував	1
огромным	*огромным	величезним	1
яны	*яны	яни	1
певица	*певица	співачка	1
черточку	*черточку	риску	1
лучших	*лучших	вісімдесятих	1
вернётесь	*вернётесь	вернетеся	1
погоди	*погоди	зачекай	1
промокать	*промокать	промокати	1
целый	*целый	ішов	1
нюнорска	*нюнорска	,	1
становились	*становились	блищими	1
дезмонд	*дезмонд	нoрмa	1
удостовериться	*удостовериться	впевнитися	1
-	*жневником	-	1
токио	*токио	середині	1
выпускные	*выпускные	випускні	1
тонущий	*тонущий	тонучий	1
подержать	*подержать	поможи	1
спешат	*спешат	поспішає	1
головную	*головную	головний	1
«	*звучит	в	1
к	*к	інших	1
отняла	*отняла	відібрала	1
нашим	*нашим	прости	1
грей	*грей	гадюки	1
поживаете	*поживаете	?	1
вставьте	*вставьте		1
пропущу	*пропущу	я	1
изучать	*изучать	спершу	1
—	*дэн	—	1
огромного	*огромного	світом	1
сгубило	*сгубило	згубила	1
жарко	*жарко	чуєтете	1
чеки	*чеки	чеки	1
зонтик	*зонтик	парасолька	1
мясо	*мясо	’	1
нарывался	*нарывался	наривався	1
небольшая	*небольшая	невелика	1
ко	*ко	ставиться	1
кролики	*кролики	кролі	1
волнуется	*волнуется	за	1
хорший	*хорший	буде	1
липнут	*липнут	думки	1
ни	*ни	крока	1
машин	*капотах	машин	1
одноклассников	*одноклассников	батьків	1
родители	*родители	зараз	1
одолжишь	*одолжишь	позичиш	1
ненавидит	*ненавидит	ненавидить	1
уважительные	*уважительные	все	1
якоже	*наша	буде	1
уехать	*уехать	потрібно	1
чая	*чая	перед	1
социальные	*социальные	соціальні	1
трое	*трое	трьох	1
путешествовал	*путешествовал	подорожував	1
разве	*разве	?	1
выглядит	*выглядит	,	1
плывет	*плывет	,	1
пустовала	*пустовала	порожнем	1
малейшего	*малейшего	сумніву	1
создались	*создались	створились	1
кредиткой	*кредиткой	кредиткою	1
вкусные	*вкусные	смачні	1
поступить	*поступить	до	1
никаких	*никаких	ні	1
младше	*младше	набагато	1
стучал	*стучал	стукав	1
послушайся	*послушайся	послухайся	1
великого	*великого	російського	1
наш	*наш		1
а	*мертвым	душі	1
безразличны	*безразличны	.	1
бешена	*бешена	дурна	1
трилобит	*трилобит	трилобіт	1
амфитриты	*амфитриты	амфітрити	1
ушиб	*ушиб	забив	1
табуретка	*табуретка	напрошується	1
нашего	*нашего	новий	1
берёт	*берёт	нову	1
неподвижно	*неподвижно	нерухомо	1
демилл	*демилл	особисто	1
перевернись	*перевернись	перевернися	1
пробежать	*пробежать	пробігти	1
и	*стеснительные	соромливі	1
становится	*становится	дорожчим	1
довольны	*довольны	залишитесь	1
.	*понадобится	.	1
к	*к	прийти	1
бедки	*бедки	клопіт	1
есть	*три	досі	1
токио	*осакой	сполучує	1
уйдёт	*уйдёт	надто	1
спускайся	*спускайся	спускайся	1
магнитофон	*магнитофон	потребує	1
выпиваю	*выпиваю	випиваю	1
навестишь	*навестишь	не	1
выберусь	*выберусь	виберуся	1
свойственно	*свойственно	жалкувати	1
припарковалась	*припарковалась	будинком	1
чародеи	*чародеи	.	1
униформа	*униформа	?	1
стеснительные	*стеснительные	у	1
странствует	*странствует	подорожує	1
до	*до	по	1
гли	*гли	глі	1
оконце	*наше	віконце	1
лебедем	*лебедем	лебедем	1
следами	*следами	слідами	1
берут	*берут	через	1
почини	*почини	відремонтуй	1
снопы	*снопы	скирти	1
развлекательная	*развлекательная	розважальна	1
выберусь	*выберусь	.	1
сократилось	*сократилось	скоротилось	1
приговорены	*приговорены	до	1
стихи	*стихи	вірши	1
мясом	*мясом	м'ясом"	1
поэтому	*поэтому	мислять	1
швартовы	*швартовы	швартові	1
чернильное	*чернильное	чорнильна	1
утку	*утку	гуски	1
равносилен	*равносилен	його	1
носить	*носить	носити	1
высадить	*высадить	тебе	1
эдисону	*эдисону	едісону	1
несмотря	*несмотря	незважаючи	1
будда	*будда	будда	1
ездит	*карпаты	їздить	1
налей	*налей	налий	1
шарф	*шарф	шарф	1
волноваться	*волноваться	хвилюватися	1
развернёмся	*развернёмся	розвернемося	1
разбудило	*разбудило	розбудило	1
пожалуйста	*пожалуйста	полагодьте	1
голливудским	*голливудским	голівудським	1
какой	*какой	яку	1
плачете	*плачете	плачете	1
силурийского	*силурийского	трилобітів	1
странным	*странным	.	1
нашим	*нашим	не	1
обязанность	*обязанность	обов'язок	1
уговорила	*уговорила	я	1
снопы	*снопы	?	1
услышал	*услышал	цю	1
наша	*наша	двадцятирічна	1
.	*рюшечках	.	1
стараться	*стараться	робити	1
взяв	*взяв	взявши	1
блузка	*блузка	до	1
мертвого	*мертвого	мертвого	1
непуганых	*непуганых	неляканих	1
скользили	*скользили	ковзали	1
чашку	*чашку	пусту	1
чуть	*чуть	її	1
кассетный	*кассетный	магнітофон	1
нагасаки	*нагасаки	нагасакі	1
ложиться	*ложиться	хочу	1
блондинки	*блондинки	блондинки	1
другой	*другой	така	1
пазл	*пазл	пазл	1
бледная	*бледная	пополотніла	1
ошеломила	*ошеломила	всеосяжність	1
заменяем	*исландским	,	1
бутылочек	*бутылочек	,	1
мнения	*мнения	думки	1
проехав	*проехав	проїхавши	1
,	*догнать	,	1
рассердил	*рассердил	я	1
понос	*понос	діарея	1
хуйня	*хуйня	отака	1
выглядит	*выглядит	біляве	1
остальные	*остальные	інші	1
путешествуют	*путешествуют	подорожують	1
предпочитают	*предпочитают	перевагу	1
грубого	*грубого	грубої	1
устал	*устал	зморився	1
похожую	*похожую	схожу	1
покладисты	*покладисты	дуже	1
зацветает	*папоротник	зацвітає	1
милая	*милая	люба	1
деревню	*деревню	,	1
ух	*ух	ух	1
к	*к	подобається	1
заключённые	*заключённые	епоху	1
посылал	*посылал	відсилав	1
плывем	*плывем	заради	1
прикажете	*прикажете	накажете	1
летит	*летит	летить	1
рассердиться	*рассердиться	вашого	1
вредят	*вредят	шкодять	1
вином	*вином	вином	1
стыдливое	*стыдливое	соромне	1
учительницей	*учительницей	вчительку	1
просыпаются	*просыпаются	щоранку	1
познается	*познается	пізнається	1
обмякните	*обмякните	розслабтеся	1
рыбалкой	*рыбалкой	рибальством	1
завис	*завис	завис	1
обожает	*обожает	він	1
ногти	*ногти	і	1
милая	*милая	мила	1
омуте	*омуте	рве	1
львове	*львове	львові	1
ездит	*карпаты	щорік	1
наш	*наш	як	1
дог	*дог	дог	1
отражалась	*отражалась	відбивався	1
какая	*какая	який	1
доисторической	*доисторической	доісторичної	1
париж	*париж	крiзь	1
читал	*читал	вже	1
даждь	*насущный	прости	1
шнурки	*шнурки	шнурки	1
подошве	*подошве	до	1
парикмахера	*парикмахера	перукаря	1
торопитесь	*торопитесь	покваптесь	1
угадайте	*угадайте	здогадайтеся	1
крупным	*крупным	більш	1
оконце	*наше	.	1
обманул	*обманул	він	1
вернулся	*вернулся	він	1
прошептал	*прошептал	прошепотів	1
перестает	*перестает	вчитися	1
бедняги	*бедняги	бідолахи	1
сходила	*сходила	.	1
файлами	*файлами	файлами	1
поделать	*поделать	вдіяти	1
нашей	*нашей	виникли	1
упаковать	*упаковать	упакувати	1
куковать	*куковать	кукувати	1
услышал	*услышал	чув	1
уговорила	*уговорила	умовляла	1
общепризнанной	*общепризнанной	загальновизнаною	1
орала	*орала	орала	1
мэри	*мэри	,	1
ушла	*ушла	спішно	1
влюблялась	*влюблялась	закохувалася	1
старики	*старики	схильні	1
французы	*французы	французи	1
.	*ушёл	.	1
давай	*другим	.	1
попросил	*попросил	залишитись	1
давненько	*давненько	давно	1
питательно	*питательно	поживне	1
такова	*такова	така	1
рождества	*рождества	до	1
клубная	*клубная	клубна	1
покончил	*покончил	вкоротив	1
разбудите	*разбудите	розбудіть	1
вдвоём	*вдвоём	вдвох	1
справимся	*справимся	впораємося	1
истинная	*истинная	це	1
здравствуйте	*здравствуйте	привіт	1
рыбалку	*рыбалку	рибалку	1
комиксы	*комиксы	комікси	1
расчитывали	*расчитывали	очікували	1
двухместные	*двухместные	двомісні	1
смей	*смей	смій	1
наши	*наши	в	1
молодо	*молодо	волосся	1
твердят	*твердят	стверджують	1
оборачивайся	*оборачивайся	обертайся	1
ложным	*ложным	фальшивою	1
боится	*боится	всіх	1
.	*скучаю	.	1
перевязал	*перевязал	перев'язав	1
садилось	*садилось	сідало	1
нечто	*нечто	дійсно	1
двуокись	*двуокись	двуокис	1
синяя	*синяя	а	1
ленивый	*ленивый	ледачий	1
создатели	*создатели	помітили	1
ракетостроение	*ракетостроение	вища	1
уловил	*уловил	вловити	1
шампунь	*шампунь	шампунь	1
отрубил	*отрубил	іржавим	1
морочь	*морочь	на	1
сбылась	*сбылась	здійснилася	1
шевелится	*шевелится	,	1
пахнет	*пахнет	приємно	1
другой	*другой	людина	1
полагать	*полагать	так	1
ошиблись	*ошиблись	мабуть	1
помяни	*помяни	промовка	1
другой	*другой	мова	1
белиной	*белиной	курчатко	1
упаковал	*упаковал	спакував	1
был	*америке	америці	1
впустую	*впустую	.	1
белоснежные	*белоснежные	волосся	1
молик	*молик	молек	1
некоторые	*некоторые	з	1
пью	*пью	"п'ю	1
вашей	*вашей	вашою	1
колумбии	*колумбии	колумбії	1
дурачествами	*дурачествами	здивована	1
кружится	*кружится	паморочиться	1
сбрить	*сбрить	зголити	1
употребляется	*употребляется	у	1
здесь	*здесь	постійний	1
столике	*столике	столику	1
попозже	*попозже	пізніше	1
кинозвезда	*кинозвезда	вбивця	1
вылечить	*вылечить	вилічити	1
пропустишь	*пропустишь	ти	1
отличить	*отличить	від	1
наших	*наших	з	1
отменяет	*отменяет	змінює	1
нобелевскую	*нобелевскую	я	1
укололась	*укололась	вкололась	1
ушел	*ушел	звідти	1
якоже	*наша	єси	1
звучала	*звучала	лунала	1
обижает	*обижает	ображає	1
гитаристом	*гитаристом	гітаристом	1
кузнечик	*кузнечик	коник	1
пить	*пить	зарікся	1
бьорк	*бьорк	бьорк	1
выглядит	*выглядит	гарно	1
ерунда	*ерунда	дурниці	1
теряется	*теряется	взяв	1
прикасайся	*прикасайся	торкайся	1
черная	*черная	.	1
следами	*следами	він	1
целый	*целый	океан	1
сам	*носить	,	1
джима	*джима	джима	1
.	*ползёт	.	1
мадам	*мадам		1
юбка	*юбка	спідниця	1
волнует	*волнует	хвилює	1
бумаги	*бумаги	папери	1
вашу	*вашу	кличуть	1
ни	*ни	хай	1
опрокинемся	*опрокинемся	перевернемось	1
нежно	*нежно	ніжно	1
увидеться	*увидеться	побачитися	1
показалась	*показалась	показалася	1
полной	*полной	зупинки	1
другие	*другие	цієї	1
угощайтесь	*угощайтесь	пригощайтеся	1
гораздо	*гораздо	будинок	1
кондиционирование	*кондиционирование	кондиціонування	1
получше	*получше	.	1
детки	*детки	,	1
догадывался	*догадывался	здогадувався	1
проваливай	*проваливай	провалюй	1
повлияло	*повлияло	вплинуло	1
мистер	*мистер	не	1
индии	*индии	індії	1
задать	*задать	хотів	1
съедобное	*съедобное	їстівне	1
вырваться	*вырваться	можеш	1
здесь	*здесь	з	1
годы	*годы	роки	1
почетные	*почетные	відомі	1
столик	*столик	кращій	1
древние	*древние	з	1
до	*до	хвилин	1
единственная	*единственная	-	1
решился	*решился	зважився	1
удается	*удается	вдається	1
мордочки	*мордочки	мордочки	1
плевал	*плевал	раз	1
сошёл	*сошёл	вийшов	1
аптечка	*аптечка	аптечка	1
наглость	*наглость	нахабство	1
фриман	*фриман	а	1
припарковать	*припарковать	.	1
рейх	*рейх	рейх	1
суждено	*суждено	зустріти	1
какой	*какой	яка	1
боязливые	*бываем	соромливі	1
какие	*какие		1
вода	*льётся	вода	1
гольф	*гольф	грає	1
рике	*рике	.	1
.	*резать	.	1
становились	*становились	і	1
полагают	*полагают	вважається	1
гамлета	*гамлета	гамлета	1
медитировать	*медитировать	медитувати	1
нару	*нару	нару	1
завтракаю	*завтракаю	.	1
летают	*летают	страуси	1
допотопными	*допотопными	подумав	1
дверь	*дверь	дверi	1
повидать	*повидать	зі	1
моцарта	*моцарта	моцарта	1
тихом	*тихом	греблю	1
похожа	*похожа	схожа	1
удалась	*удалась	вдалося	1
старик	*старик	старий	1
пульт	*пульт	пульт	1
нидерланды	*нидерланды	до	1
неизлечимо	*неизлечимо	хворий	1
испугался	*испугался	злякався	1
поймали	*поймали	зловили	1
ни	*ни	за	1
огромная	*огромная	величезна	1
анна	*анна	ганна	1
великого	*великого	"''	1
сдвинулась	*сдвинулась	зрушилася	1
насчёт	*насчёт	келиха	1
поговорить	*поговорить	потеревеніти	1
обожали	*обожали	обожнювали	1
понятны	*любой	в	1
ржавое	*ржавое	іржаве	1
удел	*удел	доля	1
неся	*неся	несучи	1
забрался	*забрался	забрався	1
выглядеть	*выглядеть	виглядати	1
каком	*каком	одружуються	1
ни	*ни	їм	1
поэтому	*поэтому	xft	1
доброту	*доброту	вашу	1
вино	*вино	для	1
и	*стеснительные	у	1
возле	*возле	трьох	1
матрос	*матрос	матрос	1
просят	*просят	коли	1
понравилось	*понравилось	сподобалось	1
выберемся	*выберемся	виберимося	1
прилипла	*жвачка	черевика	1
общаюсь	*общаюсь	спілкуюся	1
тихая	*тихая	тиха	1
пожалеешь	*пожалеешь	.	1
перестроил	*гараж	гараж	1
подмогу	*подмогу	допомогу	1
жалко	*жалко	жаль	1
.	*к	мудрості	1
казак	*будто	настирлива	1
для	*необходимы	для	1
,	*догнать	наздогнати	1
звонит	*звонит	подзвін	1
держись	*держись	тримайся	1
последнее	*последнее	часто	1
сладким	*сладким	,	1
отлагательства	*отлагательства	зволікання	1
якоже	*наша	але	1
энн	*энн	енн	1
другого	*другого	нема	1
удался	*удался	вдався	1
посольскую	*посольскую	посольську	1
купаюсь	*купаюсь	в	1
разыскивали	*разыскивали	розшукували	1
крутым	*крутым	крутим	1
поплачешь	*поплачешь	посмiхнись	1
примерно	*примерно	віці	1
мудренее	*мудренее	мудріший	1
взял	*взял	втратив	1
до	*до	нідерланди	1
призналась	*призналась	зізналась	1
рад	*рад	дуже	1
пью	*пью		1
спущусь	*спущусь	одразу	1
китай	*китай	китай	1
пью	*пью	палю	1
пароме	*пароме	паромі	1
упустил	*упустил	пропустив	1
зарезервированы	*зарезервированы	стариків	1
пропустил	*пропустил	випустив	1
пей	*пей	пий	1
смокинг	*смокинг	потрібен	1
вчерашнего	*вчерашнего	хворий	1
к	*к	рибалки	1
решились	*решились	зважилися	1
виноват	*виноват	безсильний	1
орали	*орали	орали	1
вредил	*вредил	шкодив	1
сбил	*сбил	не	1
хоббайт	*хоббайт	гобайт	1
к	*к	сильного	1
ясное	*ясное	правий	1
три	*три	кожної	1
летает	*летает	крокодила	1
собственного	*собственного	за	1
какие-нибудь	*какие-*нибудь	новини	1
шатаешься	*шатаешься	вештаєшся	1
верн	*верн	верн	1
обожаю	*обожаю	обожнюю	1
циркулем	*циркулем	циркулем	1
мусоргского	*мусоргского	мусоргського	1
для	*шкаф	шафи	1
повлияет	*повлияет	на	1
оденься	*оденься	вдягнись	1
крупным	*крупным	великим	1
курсовая	*курсовая	курсова	1
банкет	*банкет	,	1
и	*боязливые	,	1
укротив	*укротив	приборкав	1
есть	*три	.	1
татоэба	*татоэба	татоеба	1
неизлечимо	*неизлечимо	невиліковно	1
ускакал	*ускакал	поскакав	1
годится	*годится	може	1
утратил	*утратил	втратив	1
заменяем	*исландским	датською	1
мадридцы	*мадридцы	мешканцi	1
газели	*газели	газелі	1
фланели	*фланели	для	1
до	*до	10	1
ответственным	*ответственным	відповідальним	1
возить	*возить	.	1
уснула	*уснула	заснула	1
бе	*бе		1
критическая	*критическая	критична	1
вернулся	*вернулся	.	1
галгаш	*галгаш	галгаш	1
простыни	*простыни	повішу	1
становится	*становится	часом	1
уехала	*уехала	з	1
просят	*просят	просимо	1
купались	*купались	купалися	1
робин	*робин	робін	1
драконы	*драконы	дракони	1
вчерашнего	*вчерашнего	учора	1
специально	*специально	навмисно	1
купался	*купался	купався	1
укусит	*укусит	укусить	1
улыбнись	*улыбнись	посмiхнись	1
богат	*богат	заможним	1
падают	*падают	падають	1
майка	*майка	майка	1
был	*америке	був	1
какой	*какой	дурний	1
белоруссии	*белоруссии	заборонено	1
шкафу	*шкафу	порився	1
предпочитаете	*предпочитаете	або	1
бергер	*бергер	берґер	1
бешена	*бешена	родиться	1
усерднее	*усерднее	старанніше	1
тьфу	*тьфу	тьфу	1
ошеломила	*ошеломила	нас	1
изучи	*изучи	вивчи	1
проголодались	*проголодались	зголодніли	1
интернете	*интернете	на	1
запомнить	*запомнить	запам'ятати"	1
мальчишек	*мальчишек	власні	1
выслал	*выслал	вислав	1
здраств	*здраств	добриде	1
сандра	*сандра	сандра	1
вредит	*вредит	шкодить	1
модеста	*модеста	модеста	1
ни	*ни	в	1
строгий	*строгий	суворий	1
подошве	*подошве	підошви	1
омуте	*омуте	вода	1
великолепно	*великолепно	...	1
помню	*помню	пам	1
вебсайтам	*вебсайтам	вебсайтів	1
консоли	*консоли	вордпреса	1
переношу	*переношу	погано	1
потерял	*потерял	тиждень	1
бедняжка	*бедняжка	бідолаха	1
какая	*какая	та	1
летят	*летят	летять	1
мамонта	*мамонта	мамонта	1
вкусная	*вкусная	смачна	1
синее	*синее	плаття	1
приснилось	*приснилось	наснилось	1
рукав	*рукав	рукав	1
спасти	*спасти	спасти	1
советовал	*советовал	радив	1
бега	*бега	бігу	1
баночку	*баночку	баночку	1
негде	*негде	нема	1
направляются	*сообщники	спільники	1
будто	*будто	теба	1
звучит	по-*вьетнамски	в	1
гей	*гей	!	1
опустить	*опустить	опустити	1
провалился	*провалился	провалився	1
пустую	*пустую	марнування	1
сортируют	*сортируют	сортують	1
.	*внешнеэкономическим	.	1
слезли	*слезли	злізли	1
уловом	*уловом	уловом	1
сбудется	*сбудется	справдиться	1
фунтов	*фунтов	фунтів	1
спиртное	*спиртное	спиртне"	1
постель	*постель	.	1
увидимся	*увидимся	побачимося	1
утки	*утки	помісь	1
двадцатерых	*двадцатерых	двадцятьох	1
чародеи	*чародеи	різних	1
вставьте	*вставьте	будь	1
парагвай	*парагвай	парагвай	1
посылают	*посылают	задрипанців	1
лопнуло	*лопнуло	.	1
крупные	*крупные	найбільші	1
основную	*основную	основну	1
потому	*потому	,	1
хорошенько	*хорошенько	як	1
становилось	*становилось	ставало	1
бригадников	*бригадников	бригадників	1
тяжеловоз	*тяжеловоз	ваговоз	1
эдита	*эдита	едита	1
дождливые	*дождливые	школи	1
поторапливайся	*поторапливайся	поспішай	1
нагоняет	*нагоняет	на	1
теряется	*теряется	бог	1
засеяна	*засеяна	засіяна	1
пить	*пить	їсти	1
спикировал	*спикировал	пікірував	1
чучело	*чучело	величезного	1
дышать	*дышать	дихати	1
повешу	*повешу	повішу	1
зарезервированы	*зарезервированы	зарезервовані	1
мари	*мари	макі	1
устраивает	*устраивает	влаштовує	1
пустую	*пустую	пусту	1
мост	*мост	.	1
.	*до	.	1
побалансировать	*побалансировать	побалансувати	1
швейцарии	*швейцарии	швейцарії	1
дю	*дю	клубі	1
интернет	*интернет	інтернет	1
порез	*порез	подряпина	1
франции	*франции	заборонено	1
к	*к	його	1
забывчивы	*забывчивы	люди	1
опоздаем	*опоздаем	запізнимось	1
обманывать	*обманывать	обманювати	1
губка	*губка	губка	1
каникулах	*едут	канікули	1
тягчайшая	*тягчайшая	найтяжча	1
поедет	*поедет	поїде	1
литва	*литва	литва	1
изучают	*изучают	зараз	1
одевай	*одевай	одягай	1
полна	*полна		1
до	*до	повинен	1
бена	*бена	на	1
поговорить	*поговорить	говорити	1
эй	*эй	эй-но	1
.	*морковкой	''"	1
понравился	*понравился	сподобався	1
элеватор	*элеватор	елеватор	1
погладить	*погладить	попрасувати	1
помните	*помните	цю	1
обходили	*обходили	оминали	1
гладит	*гладит	мої	1
расплачусь	*расплачусь	якщо	1
бабочки	*бабочки	метелики	1
доволен	*доволен	він	1
костра	*костра	багаття	1
инъективный	*инъективный	ін'єктивний	1
любой	*любой	призначення	1
пусто	*пусто	пусто	1
нельзя	*нельзя	неможливо	1
потеряли	*потеряли	втратили	1
саранча	*саранча	саранча	1
вымерли	*вымерли	вимерли	1
основную	*основную	дня	1
сыроед	*сыроед	сироїд	1
собственными	*собственными	зі	1
классно	*классно	класно	1
предпочитаю	*предпочитаю	чорного	1
просыпаются	*просыпаются	рано	1
язычество	*язычество	набагато	1
сегодняшний	*сегодняшний	сьогоднішній	1
осмеливаетесь	*осмеливаетесь	насмілюєтеся	1
лама	*лама	вікуньї	1
рассыпались	*рассыпались	розсипалися	1
пахнут	*пахнут	пахнуть	1
гордимся	*гордимся	гордуємо	1
снотворного	*снотворного		1
снопом	*снопом	скиртою	1
последнюю	*последнюю	втекли	1
способен	*способен	,	1
способен	*способен	здатен	1
перестроил	*перестроил	перебудував	1
шипов	*шипов	шипів	1
прикасайтесь	*прикасайтесь	торкайтеся	1
устаёт	*устаёт	втомлюється	1
?	*другие	?	1
никакой	*никакой	жодної	1
гладит	*гладит	прасує	1
встал	*встал	пізно	1
клевещет	*клевещет	!	1
собственный	*собственный	власні	1
массаж	*массаж	масаж	1
мужественный	*мужественный	відважного	1
апчхи	*апчхи	ачхи	1
глупцы	*глупцы	пустомудрі	1
забраться	*забраться	вилізти	1
каникулы	*каникулы	канікули	1
стричь	*стричь	стригти	1
госпоже	*госпоже	вітання	1
стиральная	*стиральная	пральна	1
здравствует	*здравствует	живе	1
правит	*правит	керує	1
исландский	*исландский	створювачі	1
равно	*вчерашнего	так	1
чашку	*чашку	одну	1
фейерверки	*фейерверки	феєрверки	1
строки	*строки	пропустити	1
учётная	*учётная	потрібен	1
пребывания	*пребывания	перебування	1
яна	*яна	яно	1
вроде	*вроде	"начебто	1
дракон	*дракон	дракон	1
пусть	*пусть	нехай	1
сбрасывать	*сбрасывать	втратити	1
.	*увидимся	.	1
здесь	*здесь	новий	1
обязанностей	*обязанностей	на"	1
трос	*трос	ліфтовий	1
вращаются	*вращаются	обертаються	1
пылкую	*пылкую	закоханих	1
познаётся	*познаётся		1
красивые	*красивые		1
просыпаюсь	*просыпаюсь	я	1
-	*окаменелость	-"	1
перемене	*перемене	зміни	1
согласен	*согласен	погоджуюсь	1
гитаре	*гитаре	грав	1
соломки	*соломки	соломки	1
удаётся	*удаётся	вдається	1
доводы	*доводы	доводи	1
останавливайтесь	*останавливайтесь	зупиняйтеся	1
средиземном	*средиземном	афін	1
предназначена	*предназначена	призначена	1
вставала	*вставала	п'ятій	1
непостоянные	*непостоянные	.	1
зефир	*зефир	зефір	1
проплывали	*проплывали	пливли	1
силура	*силура	силуру	1
пятом	*пятом	п'ятому	1
рассудит	*рассудит	.	1
ездит	*ездит	їде	1
поглощена	*поглощена	поглинена	1
рукав	*рукав	ïï	1
джим	*джим	джиме	1
чёртов	*камень	людьми	1
молодой	*молодой	молодої	1
зарезервированы	*зарезервированы	для	1
чтобы	*грею	щоб	1
некоторые	*некоторые	.	1
эмета	*эмета	емета	1
перестает	*перестает	перестає	1
обманули	*обманули	обдурили	1
.	*верхней	.	1
шелдрейк	*шелдрейк	шелдрейк	1
палуба	*палуба	палуба	1
мальчишек	*мальчишек	дні	1
.	*болят	.	1
какая	*какая	яке	1
завтракаю	*завтракаю	снідаю	1
исияма	*исияма	найстарший	1
джек	*джек	джек	1
беспечности	*беспечности	.	1
кстати	*кстати	до	1
кончилось	*кончилось	урвався	1
вовсе	*вовсе	він	1
сверхчеловек	*сверхчеловек	надлюдина	1
ужинать	*ужинать	вечеряти	1
задержался	*задержался	затримався	1
чёртов	*чёртов	складено	1
читала	*читала	читав	1
соображениям	*соображениям	міркувань	1
шутит	*шутит	жартує	1
ни	*ни	трапилось	1
смущён	*смущён	збентежений	1
гадко	*гадко	бридко	1
попробовать	*попробовать	скуштувати	1
куёт	*куёт	кує	1
.	*задумываюсь	над	1
настал	*настал	настав	1
предпочитаю	*предпочитаю	печиву	1
браузеры	*браузеры	не	1
глупый	*глупый	дурне	1
штатами	*штатами	штатами	1
они	*каковы	ми	1
опустить	*опустить	пдлогу	1
наш	*наш	він	1
асоциален	*асоциален	антисоціальний	1
нелегко	*нелегко	важко	1
серийная	*серийная	серійна	1
волнуюсь	*волнуюсь	я	1
эдита	*эдита	.	1
львы	*львы	леви	1
карие	*карие	?	1
деревней	*деревней	селом	1
ушёл	*ушёл	.	1
девятой	*девятой	дев'ятій	1
жарко	*жарко	затра	1
теннис	*теннис	пограти	1
устроиться	*устроиться	влаштуватися	1
красивой	*красивой	-	1
ваш	*ваш	хто	1
мария	*мария	марія	1
удачи	*удачи	щастя	1
плачешь	*плачешь	плачеш	1
обманул	*обманул	обманув	1
дударева	*дударева	юбілеєм	1
мальчишки	*мальчишки	залишаться	1
великих	*великих	великих	1
затонул	*затонул	затонув	1
строг	*строг	строгим	1
поэтому	*поэтому	встановив	1
выпал	*выпал	чьлна	1
трудности	*трудности	труднощів	1
соответствуют	*соответствуют	не	1
камешки	*камешки	камінці	1
припарковалась	*припарковалась	припаркувалася	1
спячу	*спячу	пересердя	1
спешить	*спешить	поспішати	1
сырой	*сырой	сирої	1
замуж	*вышла	заміжня	1
прибираться	*прибираться	прибирати	1
мег	*мег	занадто	1
белоруссии	*белоруссии	білорусі	1
устал	*устал	я	1
какой	*какой	о	1
сердись	*сердись	сердся	1
«	*звучит	єтнамською	1
воруешь	*воруешь	крадеш	1
три	*три	додати	1
драгоценные	*драгоценные	наче	1
чуть-чуть	*чуть-*чуть	довше	1
нила	*нила	світі	1
вернусь	*вернусь	завтра	1
позабочусь	*позабочусь	мій	1
.	*ящерицу	.	1
прикольно	*прикольно	прикольно	1
околдована	*околдована	зачарована	1
придурок	*придурок	оце	1
жопа	*жопа	.	1
угарте	*угарте	угарт	1
блузка	*блузка	нова	1
пустовала	*пустовала	стояла	1
пропустишь	*пропустишь	пропустиш	1
плевал	*плевал	вже	1
три	*три	мене	1
другие	*другие	за	1
они	*каковы	пікірував	1
установил	*установил	патчем	1
выдались	*выдались	видалися	1
врождённая	*врождённая	природжена	1
уравнении	*уравнении	рівнянні	1
произведение	*произведение	.	1
арбуза	*арбуза	кавуна	1
поучительное	*поучительное	ну	1
заводишься	*заводишься		1
старик	*старик	дід	1
пьёт	*пьёт	кави	1
огурец	*огурец	огірок	1
ездит	*ездит	карпати	1
поймал	*поймал	учора	1
шелохнется	*шелохнется	рушить	1
вымышленное	*вымышленное	вигадана	1
злись	*злись	злостися	1
разве	*разве	раніше	1
будит	*будит	чоловік	1
черное	*черное	,	1
столь	*столь	настільки	1
колокол	*колокол	?	1
храним	*храним	знаєш	1
устал	*устал	дещо	1
кверху	*кверху	догори	1
стегозавра	*стегозавра	зблизька	1
шнобелевскую	*шнобелевскую	шнобелевську	1
молодые	*молодые	старі	1
другой	*другой		1
механизатор	*механизатор	механізатор	1
курево	*курево	куриво	1
предшествует	*предшествует	англійській	1
увидеться	*увидеться	знову	1
сердись	*сердись	бело	1
брюссель	*брюссель	брюссель	1
последователен	*последователен	послідовний	1
хвастается	*хвастается	вихваляється	1
мужчины	*мужчины	синьої	1
поговорить	*поговорить	побалакати	1
обожаю	*обожаю	я	1
здесь	*здесь	фотографуйте	1
саэб	*саэб	саеб	1
сентиментален	*сентиментален	сентементальний	1
следуйте	*следуйте	слідуйте	1
к	*к	якось	1
пообедать	*пообедать	пообідати	1
уйдёт	*уйдёт	я	1
скучаю	*скучаю	.	1
головой	*головой	кілька	1
изобилие	*изобилие	багато	1
википедия	*википедия	вікіпедія	1
читай	*читай	читай	1
пьёшь	*пьёшь	п'єш	1
хоть	*хоть	хоча	1
осколки	*осколки	уламки	1
штора	*штора	штора	1
выездные	*выездные	виїзні	1
пешком	*пешком	автобусної	1
танцует	*танцует	співає	1
шевелитесь	*шевелитесь	ворушіться	1
мнением	*мнением	вказано	1
пас	*пас	пас	1
облачка	*облачка	хмаринки	1
помните	*помните	пам'ятаєте	1
держась	*держась	тримаючись	1
забавную	*забавную	вчитель	1
обжег	*обжег	обпік	1
шокирован	*шокирован	шокований	1
испекла	*испекла	для	1
нюнорска	*основывается	нюношку	1
здесь	*здесь	спекотно	1
поехал	*китай	китаю	1
третичный	*третичный	третинний	1
уйти	*уйти	на	1
заезжают	*заезжают	такі	1
сноповяз	*сноповяз	скиртяр	1
иврит	*иврит	іврит	1
поехал	*китай	поїхав	1
плавающего	*плавающего	хлопчика	1
поздравил	*поздравил	олексія	1
другой	*другой	другої	1
сгубило	*сгубило	.	1
взгляни	*взгляни	подивись	1
аж	*высушу	аж	1
плывет	*плывет	пливе	1
глупо	*глупо	твого	1
сходку	*сходку	позбиралися	1
подчиниться	*подчиниться	підкоритися	1
пуншем	*пуншем	пуншем	1
до	*до	до"	1
перемены	*перемены	.	1
похудею	*похудею	схудну	1
сердитесь	*сердитесь	сердтеся	1
чашку	*чашку	випиваю	1
моррис	*моррис	морріс	1
глыбы	*глыбы	брили	1
опоздал	*опоздал	сьогодні	1
головой	*головой	похитав	1
молодому	*молодому	молодому	1
библии	*библии	біблії	1
жеребец	*жеребец	жеребець	1
троих	*троих	розділи	1
насчёт	*насчёт	дивишся	1
что	*пообедал	пообідав	1
восхитительна	*восхитительна	чудова	1
летучая	*летучая	кажан	1
русня	*русня	каже	1
к	*к	шлях	1
преподавать	*преподавать	як	1
мыть	*мыть	моя	1
рад	*рад	рад	1
положиться	*положиться	покластися	1
одеты	*одеты	вдягнені	1
впустил	*впустил	впустив	1
улыбнулась	*улыбнулась	розвернулася	1
невежества	*невежества	невігластво	1
бивень	*бивень	бивень	1
различными	*различными	"кілька	1
гордон	*гордон	гордон"	1
шатаешься	*шатаешься	зна	1
излечил	*излечил	він	1
чёртов	*чёртов	легенд	1
шляпу	*шляпу	капелюха	1
геттер	*геттер	вмерти	1
хоть	*хоть	хоч	1
к	*к	ближче	1
апостола	*апостола	апостола	1
чуть	*чуть	збожеволіла	1
преувеличивать	*преувеличивать	перебільшувати	1
безобразники	*безобразники	бешкетники	1
заблудился	*заблудился	заблукав	1
бросилась	*бросилась	йому	1
мужчинам	*мужчинам	помогає	1
читая	*читая	книжкою	1
отнимает	*отнимает	в	1
каком	*каком		1
пройтись	*пройтись	пройтися	1
пить	*пить	кави	1
преуспеть	*преуспеть	досягти	1
оглядел	*оглядел	оглянув	1
жутко	*жутко	люто	1
иван	*иван	не	1
мексике	*мексике	мексиці	1
проснёшься	*проснёшься	прокинешся	1
боцман	*боцман	боцман	1
ребята	*ребята	,	1
теннисист	*теннисист	тенісист	1
порядочным	*порядочным	порядною	1
завоевание	*завоевание	завоювання	1
прижиться	*прижиться	прижитися	1
водятся	*водятся	греблю	1
присутствует	*присутствует	присутня	1
наплакал	*наплакал	наплакав	1
пунической	*пунической	пунічної	1
найдутся	*найдутся	,	1
красивый	*красивый	який	1
возраста	*возраста	від	1
пахнут	*пахнут	пахнуть"	1
хоть	*хоть	раз	1
лучший	*лучший	накращий	1
потеряли	*потеряли	втратив	1
околдована	*околдована	була	1
упорядоченное	*упорядоченное	.	1
спрыгнул	*спрыгнул	зстрибнув	1
гладит	*брюки	прасує	1
выглядеть	*выглядеть	дорослішим	1
упрямая	*упрямая	вперта	1
вернёшься	*вернёшься	повернешся	1
почини	*почини		1
дверь	*дверь	і	1
берегите	*берегите	,	1
пакистан	*пакистан	пакістан	1
отнимает	*отнимает	фейсбук	1
нуждается	*нуждается	принади	1
заснуть	*заснуть	заснути	1
приемник	*приемник	немов	1
перестаёт	*перестаёт	перестає	1
весит	*весит	важить	1
сближаемся	*сближаемся	стаємо	1
карьеры	*карьеры	’	1
боязливые	*бываем	такі	1
стало	*аниме		1
потянулся	*потянулся	потягнувся	1
получилось	*получилось	,	1
татоэбе	*татоэбе	татоебі	1
неплохая	*неплохая	непогана	1
одета	*одета	вдягена	1
палеозойскую	*палеозойскую	палеозойську	1
хриплю	*хриплю	хриплю	1
другие	*другие	герб	1
всё	*аж	все	1
ласточка	*ласточка	ластівка	1
сигары	*сигары	цигарки	1
высшее	*высшее	ссавець	1
сам	*носить	мені	1
собственными	*собственными	своїх	1
картонных	*картонных	картонних	1
устал	*устал	ж	1
теннис	*теннис	збираюсь	1
обязан	*обязан	мусить	1
столь	*столь	ж	1
насчёт	*насчёт	ідіотського	1
переговорил	*переговорил	підспівувачів	1
становится	*становится	що	1
риком	*риком	ріком	1
бритв	*бритв	лез	1
списывал	*списывал	списував	1
дю	*дю	в	1
здесь	*здесь	ніхто	1
ушёл	*ушёл	я	1
шути	*шути	жартуй	1
.	*резать	різати	1
гвозди	*гвозди	дорожчі	1
рискнуть	*рискнуть	ризикнути	1
безнадёжный	*безнадёжный	безнадійний	1
вставать	*вставать	.	1
достать	*удалось	дістати	1
к	*к	звикнеш	1
расплачусь	*расплачусь	заплачу	1
жительства	*жительства	та	1
кролик	*кролик	заєць	1
спой	*спой	заспівай	1
другие	*другие	є	1
липнут	*липнут	до	1
глупо	*глупо	відкидувати	1
различных	*различных	різних	1
сам	*носить	герої	1
пожалуйста	*пожалуйста	побачитися	1
спеша	*спеша	поспішаючи	1
странное	*странное	дивний	1
подлей…	*подлей…	підлий…	1
колокола	*колокола	дзвонять	1
зверь	*зверь	є	1
накапливались	*накапливались	.	1
катаются	*катаются	заради	1
улетит	*улетит	без	1
годы	*годы	проминули	1
любовники	*любовники	на	1
черным	*черным	чорним	1
терпит	*терпит	терпить	1
небольшой	*небольшой	маленька	1
до	*до	вінця	1
поступят	*поступят	не	1
хорошенько	*хорошенько	слід	1
завтрашнему	*завтрашнему	завтра	1
братиславы	*братиславы	братислави	1
воспользоваться	*воспользоваться	можна	1
шкафу	*шкафу	пошуках	1
присутствовали	*присутствовали	присутні	1
лыжах	*лыжах	хоккайдо	1
старайся	*старайся	старайся	1
порезался	*порезался	порізався	1
болячка	*болячка	болячка	1
.	*лежит	.	1
к	*к	роботу	1
штуковина	*штуковина	штуковина	1
бледна	*бледна	бліда	1
штрассе	*штрассе	штрассер	1
стегозавр	*стегозавр	стегозавр	1
полна	*полна	повна	1
аист	*аист	лелека	1
некоторые	*некоторые	хтось	1
билл	*билл	із-за	1
предпочитаю	*предпочитаю	надаю	1
поговорка	*поговорка	приказка	1
зажечь	*зажечь	будь	1
дует	*дует	дує	1
другой	*другой	інша	1
грамматически	*грамматически	граматично	1
алматы	*алматы	алмати	1
забавно	*забавно	цікаво	1
холоднокровные	*холоднокровные		1
вылезайте	*вылезайте	вилазьте	1
читаю	*читаю	газети	1
притворяется	*притворяется	удає	1
бивень	*бивень	навіть	1
остальные	*остальные	але	1
боится	*боится	сестра	1
утратите	*утратите	втратите	1
три	*три	граю	1
неоднократный	*неоднократный	неодноразовий	1
поживает	*поживает	як	1
обманчива	*обманчива	оманлива	1
ни	*ни	непотрібні	1
вылизана	*вылизана	вилизана	1
ушли	*ушли	вороття	1
легче	*переносить	свою	1
последние	*последние	дні	1
уезжать	*уезжать	їхати	1
бывает	*бывает	буваю	1
дорого	*дорого	коштує	1
глупый	*глупый	дурна	1
напрягаешься	*напрягаешься	сильно	1
отравилась	*отравилась	отруїлася	1
затонул	*затонул	йшов	1
что	*окончил	англійської	1
подрыва	*подрыва	бариг	1
улыбнулась	*улыбнулась	усміхнулась	1
взять	*взять	бика	1
исполнение	*исполнение		1
мудры	*мудры	мудрі	1
странных	*странных	багато	1
к	*к	.	1
какое	*какое	збіг	1
прогуливаться	*прогуливаться	прогулюватися	1
протоптали	*протоптали	її	1
поспешишь	*поспешишь	поспішиш	1
зародилась	*китае	китаї	1
мило	*мило	милі	1
мацусиму	*мацусиму	мацусіму	1
здесь	*здесь	отут	1
захватчиками	*захватчиками	загарбниками	1
ваше	*ваше	виконано	1
поговорить	*поговорить	хочете	1
разрядился	*разрядился	розрядився	1
пить	*пить	солодке	1
другой	*другой	візьми	1
щёки	*щёки	щоки	1
однажды	*однажды	знайшов	1
выносливость	*выносливость	витривалість	1
керамикой	*керамикой	цікавлюся	1
падает	*падает	падає	1
консоли	*консоли	до	1
поехал	*поехал	до	1
попался	*попался	попався	1
психоанализа	*психоанализа	психоаналіз	1
огромный	*огромный	проміжок	1
классно	*классно	влаштували	1
разлили	*разлили	ви	1
брубейкер	*брубейкер	брубейкер	1
опоздает	*опоздает	запізниться	1
уходи	*уходи	йди	1
негде	*негде	припаркувати	1
происшествия	*происшествия	одразу	1
понятен	*понятен	.	1
бумаги	*бумаги	.	1
последним	*последним	останній	1
осчастливил	*осчастливил	своїх	1
,	*бизонов	і	1
подстелил	*подстелил	соломки	1
обманули	*обманули	ошукали	1
деревню	*деревню	по	1
крухулик	*крухулик	крухулик	1
саже	*саже	сажі	1
пострижена	*пострижена	підстрижена	1
и	*рейха	рейху	1
забеременела	*забеременела	завагітніла	1
ильза	*ильза	ільзо	1
вредить	*вредить	шкодити	1
заключённые	*заключённые	язні	1
плывут	*плывут	пливуть	1
разыскиваемыми	*разыскиваемыми	гарячим	1
возле	*возле	при	1
ведра	*ведра	калюжі	1
клевещет	*клевещет	наклеп	1
сближаемся	*сближаемся	ближчі	1
вино	*вино	-	1
разряжена	*разряжена	розряджена	1
усадил	*усадил	її	1
погружен	*погружен	занурений	1
токио	*осакой	токіо	1
огромный	*огромный	величезний	1
жуки	*жуки	жуки	1
смастерили	*смастерили	змайстрували	1
младше	*младше	мене	1
предатель	*предатель	зрадник	1
поступить	*поступить	вступити	1
единственная	*единственная	не	1
дует	*дует	дме	1
красивые	*красивые	є	1
лицемер	*лицемер	жирний	1
пятом	*пятом	поверсі	1
спорить	*спорить	заради	1
агата	*агата	агата	1
подвозите	*подвозите	завгодно	1
симпатичен	*симпатичен	симпатичний	1
родителей	*родителей	однокласників	1
яблони	*яблони	яблучко	1
слепа	*слепа	сліпа	1
опозорил	*опозорил	зганьбив	1
съездить	*съездить	поїхати	1
огромное	*огромное	величезне	1
других	*других	країнах	1
глупо	*глупо	нерозумно	1
лгун	*лгун	брехун	1
предпочитают	*предпочитают	інші	1
вставала	*вставала	вставала	1
выглядит	*выглядит	має	1
бойся	*бойся	бійся	1
накапливались	*накапливались	накопичувалися	1
.	*пожалуйста	.	1
здесь	*здесь	буде	1
хочется	*хочется	хочеться	1
меленянским	*меленянским	мелянським	1
наплевать	*наплевать	мене	1
ошибок	*грамматических	думаю	1
перевяжи	*перевяжи	"перев'яжи	1
перестроил	*гараж	перебудував	1
прождал	*прождал	прочекав	1
строгий	*строгий	вчитель	1
свободен	*свободен	завжди	1
ме	*ме		1
сбываются	*сбываются	збуваються	1
концентрационных	*концентрационных	’	1
сближаемся	*сближаемся	.	1
стало	*аниме	стало	1
держась	*держась	,	1
нервничает	*нервничает	екзамена	1
неизвестной	*неизвестной	невідома	1
рвётся	*рвётся	рветься	1
елизавета	*елизавета	єлізавета	1
синяя	*синяя	?	1
никакого	*никакого	до	1
потрогаю	*потрогаю	твоїх	1
посылать	*посылать	посилати	1
какой	*какой	але	1
неверные	*неверные	невірні	1
другая	*другая	тварюка	1
насущный	*наш	наш	1
трубку	*трубку	тютюн	1
устал	*устал	іти	1
тропинка	*тропинка	,	1
участвовать	*участвовать	взяти	1
понятны	*любой	зрозумілими	1
светофор	*светофор	увесь	1
какой	*какой	йому	1
поймали	*поймали	крадія	1
шпионила	*шпионила	шпигувала	1
завидует	*завидует	заздрить	1
хоккайдо	*хоккайдо	.	1
обжег	*обжег	.	1
создатели	*полноэкранных	повноекранних	1
провалился	*провалился	він	1
одета	*одета	бело	1
выдумала	*выдумала	вигадала	1
бешена	*бешена	отця	1
англичанином	*англичанином	англійцем	1
создатели	*полноэкранных	створювачі	1
приветливый	*приветливый	люб'язний"	1
обманывают	*обманывают	дурять	1
ездить	*ездить	їздити	1
к	*к	прописані	1
прощай	*прощай	прощавай	1
подумали	*подумали	подумали	1
мост	*мост	завдяки	1
здесь	*здесь	нікого	1
грамматически	*грамматически	.	1
плачет	*плачет	плаче	1
грезим	*грезим	маримо	1
бездянки	*бездянки	бездянки	1
эврика	*эврика	евріка	1
каким	*каким	’	1
поплавать	*поплавать	поплавати	1
морковь	*морковь	морква	1
верну	*верну	поверну	1
годов	*годов	років	1
лекарства	*лекарства	ліки	1
пустой	*пустой	пуста	1
родители	*родители	батьки	1
посоветовала	*посоветовала	порадила	1
воде	*к	повітря	1
видео	*видео	відео	1
ледокол	*ледокол	криголам	1
задолбалась	*задолбалась	задовбало	1
минуточку	*минуточку	.	1
спускай	*спускай	спускай	1
.	*разрыдалась	.	1
чикаго	*чикаго	,	1
читай	*читай	не	1
большущий	*большущий	рій	1
прислужиться	*прислужиться	любій	1
притворяется	*притворяется	вдає	1
,	*получилось	краще	1
-	*окаменелость	-	1
сухопутных	*сухопутных	що	1
озёрная	*озёрная	озерна	1
происшествию	*происшествию	події	1
помнится	*помнится	пам'ятається	1
и	*людских	і	1
коньках	*коньках	ковзанах	1
заболел	*заболел	захворів	1
непостоянные	*непостоянные	непостійні	1
потеряла	*потеряла	загубила	1
подсолнух	*подсолнух	соняшник	1
бесследно	*бесследно	безслідно	1
экстренное	*экстренное	декілька	1
здесь	*здесь	але	1
застрял	*застрял	застряг	1
женился	*женился	оженився	1
блейк	*блейк	поховано	1
высока	*высока	висока	1
афиша	*афиша	впала	1
выпендриваться	*выпендриваться	хизуватися	1
китов	*китов	мають	1
проговорили	*проговорили	проговорили	1
мягкий	*мягкий	’	1
возрасте	*возрасте	в	1
,	*боязливые	і	1
стряслось	*стряслось	скоїлося	1
фиолетовое	*фиолетовое	бузкове	1
насчёт	*насчёт	,	1
горжусь	*горжусь	я	1
некоторые	*некоторые	рівніші	1
плавает	*плавает	плаває	1
дует	*дует	.	1
равносилен	*равносилен	наказові	1
до	*до	нього	1
дождливые	*дождливые	дощові	1
полной	*полной	до	1
порылся	*порылся	шафі	1
разрушена	*разрушена	зруйнована	1
перевозит	*перевозит		1
облагаются	*облагаются	обкладаються	1
медитировать	*медитировать	міркувати	1
теннис	*теннис	на	1
трёх	*трёх	де	1
джунглях	*джунглях	вмираю	1
ребята	*ребята	усі	1
штора	*штора	загорілася	1
тише	*тише	радіо	1
спешат	*спешат	на	1
низкий	*низкий	найнижчий	1
наизусть	*наизусть	."	1
старики	*старики	старі	1
безгрешен	*безгрешен	ӱдыржым	1
становится	*становится	все	1
к	*к	сестри	1
чёрные	*чёрные	чорні	1
учётная	*учётная	обліковий	1
теряется	*теряется	втратив	1
радуешься	*радуешься	зрадів	1
мужчины	*мужчины	кращого	1
закурю	*закурю	закурю	1
многая	*многая	многая	1
всеобщее	*всеобщее	за	1
крупные	*крупные	наземні	1
при	*общаться	допомогою	1
последним	*последним	останнім	1
другой	*другой	говорить	1
невежества	*невежества	за	1
выпиваю	*выпиваю	завжди	1
стыдиться	*стыдиться	соромно	1
окей	*окей	гаразд	1
хироси	*хироси	хіросі	1
жирка	*жирка	знайшов	1
к	*к	тварини	1
здравствуй	*здравствуй	привіт	1
летают	*летают	.	1
забронировали	*забронировали	забронювали	1
произвели	*произвели	справили	1
уин-та-тати-терий	*уин-та-*тати-*терий	уін-та-таті-терий	1
плакал	*плакал	плакав	1
изучать	*изучать	англійську	1
к	*к	її	1
очевиден	*очевиден	цілком	1
кролика	*кролика	кролика	1
.	*рюшечках	та	1
малайзии	*малайзии	малайзії	1
завтрашнему	*завтрашнему	закінчити	1
попросить	*попросить	мені	1
зародилась	*китае	зародилася	1
иврите	*иврите	івриті	1
сыпать	*сыпать	сипати	1
изучать	*изучать	латинь	1
любые	*любые	будь-які	1
.	*избави	.	1
презирают	*презирают	зневажають	1
вылезет	*вылезет	вилізе	1
.	*удивлюсь	.	1
префекта	*префекта	в	1
вашу	*вашу	!	1
признание	*стыдливое	.	1
вернёмся	*вернёмся	вернімося	1
дурой	*дурой	ідіоткою	1
обманывает	*обманывает	дурить	1
парочкой	*парочкой	парою	1
нависла	*нависла	нависла	1
якоже	*наша	прийде	1
бьют	*бьют	’	1
чёртов	*камень	складено	1
эгоистична	*эгоистична	егоїстична	1
осуществиться	*осуществиться	здійснитися	1
отлынивает	*отлынивает	страйкує	1
свинец	*свинец	свинець	1
парочка	*парочка	парочка	1
одолжили	*одолжили	позичили	1
клубника	*клубника	свіжа	1
теннис	*теннис	грає	1
латынь	*латынь	латинь	1
лучших	*лучших	найкращих	1
здравствуй	*здравствуй	здоров	1
гвозди	*гвозди	цвяхи	1
белоснежные	*белоснежные	білосніжне	1
сочувствую	*сочувствую	співчуваю	1
покуковать	*покуковать	кукувати	1
колики	*колики	звело	1
перезвоню	*перезвоню	перетелефоную	1
вышел	*вышел	,	1
перекусить	*перекусить	перекусити	1
помню	*помню	ятаю	1
мебель	*антикварная	меблі	1
малибу	*малибу	малібу	1
слабак	*слабак	олабак	1
препод	*препод	.	1
татоэбе	*татоэбе	перекладаю	1
боже	*боже	боже	1
злой	*злой	злий	1
большей	*большей	розвернемо	1
уродливая	*уродливая	потворна	1
эсперанто	*эсперанто	краща	1
великая	*великая	велика	1
хромую	*хромую	кульгаве	1
мег	*мег	мої	1
восхищаюсь	*восхищаюсь	захоплююся	1
познаётся	*познаётся	узнаєш	1
поймал	*поймал	зловив	1
жирка	*жирка	видивлятися	1
одеты	*одеты	гарно	1
подумайте	*подумайте	подумайте	1
вытрите	*вытрите	витирайте	1
успокойся	*успокойся	заспокойся	1
ослом	*ослом	віслюком	1
ударил	*ударил	вдарив	1
париже	*париже	більше	1
высадить	*высадить	висадити	1
принадлежат	*принадлежат	належать	1
туфли	*туфли	черевики	1
попозже	*попозже	можливо	1
нуждается	*нуждается	потребує	1
вздохните	*вздохните	зітхніть	1
наша	*наша	народила	1
хоть	*хоть	,	1
десерт	*десерт	десерт	1
уйдёшь	*уйдёшь	,	1
ни	*ни	анітрохи	1
канадка	*канадка	канадка	1
странным	*странным	з	1
пожалуйста	*пожалуйста	прошу	1
.	*заказывал	.	1
содовая	*содовая	сода	1
гораздо	*гораздо	значно	1
несмотря	*несмотря	не	1
омуте	*омуте	тиха	1
.	*мебель	.	1
совершенствуются	*совершенствуются	вдосконалюються	1
поцарапало	*поцарапало	пошкрябало	1
тронут	*тронут	зворушений	1
госпоже	*госпоже	пані	1
торопись	*торопись	поспішай	1
детектив	*читаю	детектив	1
ни	*ни	промовивши	1
заполнять	*заполнять	першу	1
детки	*детки	малі	1
осчастливил	*осчастливил	ощасливив	1
понятен	*понятен	зрозумілий	1
ногти	*ногти	нігті	1
концентрационных	*концентрационных	концентраційних	1
мечтаешь	*мечтаешь	?	1
мистер	*мистер	спитав"	1
зверь	*зверь	тварина	1
механизатор	*механизатор	товарише	1
получше	*получше	столик	1
атаковал	*атаковал	величезний	1
пробудешь	*пробудешь	пробудеш	1
бутылочку	*бутылочку	пляшки	1
чучело	*чучело	літає	1
читал	*читал	я	1
взлома	*взлома	злому	1
поприветствовать	*поприветствовать	привітати	1
повесила	*повесила	повісила	1
попросил	*попросил	попрохав	1
бельгии	*бельгии	бельгії	1
высох	*высох	колодязь	1
насущный	*наш	насущний	1
паразитов	*паразитов	паразитів	1
марки	*марки	потрібно	1
пьян	*пьян	п'яний"	1
стало	*аниме	де	1
пожелать	*пожелать	побажати	1
подхалимов	*подхалимов	підспівувачів	1
повезёт	*повезёт	пощастить	1
пролежал	*пролежал	пролежав	1
диснейленд	*диснейленд	діснейленд	1
преподавать	*преподавать	викладати	1
нила	*нила	ніла	1
нашего	*нашего	нашого	1
осуществиться	*осуществиться	сподіване	1
пышный	*пышный	важке	1
выглядишь	*выглядишь	гарно	1
птеранодоны	*птеранодоны	птеранодони	1
председателя	*председателя	голову	1
возле	*возле	до	1
младше	*младше	молодшою	1
унаследовал	*унаследовал	я	1
предстоящего	*предстоящего	для	1
робинзон	*робинзон	наче	1
корень	*корень		1
пьёт	*чашке	випиває	1
пятом	*пятом	"п'ятому	1
прошу	*прошу	вибачте	1
другой	*другой	школи	1
сам	*носить	часу	1
блузка	*блузка	її	1
послушаться	*послушаться	не	1
укрощаешь	*укрощаешь	втихомирюєш	1
потерять	*потерять	позич	1
коронёром	*коронёром	коронером	1
вчерашнем	*вчерашнем	взяти	1
угарте	*угарте	час	1
вода	*льётся	.	1
якоже	*наша	святиться	1
неизгладимое	*неизгладимое	незабутнє	1
.	*услышит	.	1
захотите	*захотите	схочете	1
предпочитаю	*предпочитаю	утримуватись	1
свободными	*свободными	розумом	1
причёской	*причёской	ірокез	1
дебилка	*дебилка	дебілка	1
залезайте	*залезайте	залазьте	1
завидует	*завидует	вона	1
ваш	*ваш	твій	1
замерли	*замерли	завмерли	1
напирайте	*напирайте	напирайте	1
солдафон	*солдафон	солдафон	1
осколки	*осколки	осколки	1
страстно	*страстно	пристрасно	1
подольше	*подольше	довше	1
помяни	*помяни	про	1
лучшим	*лучшим	найкращим	1
плаваю	*плаваю	погано	1
трёх	*трёх	трьох	1
довольна	*довольна	задоволена	1
диван	*диван	канапу	1
состоится	*состоится	відбудеться	1
любые	*любые	будь-яким	1
поучи	*поучи	колегу	1
портсигар	*портсигар	портсигар	1
мюриэл	*мюриэл	пропонови	1
плакал	*плакал	?	1
вышивания	*вышивания	вишивання	1
жребий	*жребий	жереб	1
витамины	*витамины	вітаміни	1
минеральная	*минеральная	мінеральна	1
до	*до	вчиться	1
старшая	*старшая	старша	1
,	*боязливые	боязкі	1
подготовилась	*подготовилась	підготувалася	1
посмела	*посмела	наважилась	1
концов	*вернулся	у	1
проснулся	*проснулся	занадто	1
насчёт	*насчёт	про	1
янина	*янина	яніна	1
пиджак	*пиджак	краватки	1
водохранилище	*водохранилище	водосховищі	1
модеста	*модеста	композитора	1
джимми	*джимми	джиммі	1
мексиканской	*мексиканской	мексиканської	1
тронут	*тронут	глибоко	1
верёвку	*верёвку	мотузку	1
тряслись	*тряслись	тряслись	1
соответствует	*соответствует	не	1
полетел	*полетел	.	1
мужчину	*мужчину	,	1
чашкой	*чашкой	це	1
марка	*марка	марка	1
сильнейшее	*сильнейшее	найсильніша	1
родила	*родила	народила	1
соломки	*соломки	то	1
потеря	*потеря	найтяжча	1
намажь	*намажь	намаж	1
слушайтесь	*слушайтесь	слухайтеся	1
опять	*опять	ти	1
шило	*шило	індика	1
спорят	*спорят	сперечаються	1
поэтому	*поэтому	unifont	1
звонил	*звонил	дзвонив	1
выпал	*выпал	та	1
заменяем	*исландским	цей	1
истоптана	*истоптана	потоптана	1
плавающего	*плавающего	плаває	1
заменяем	*заменяем	з	1
спиртное	*спиртное	спиртне	1
наплевать	*наплевать	начхати	1
остальным	*остальным	.	1
притворяются	*притворяются	прикидаться	1
предпочитаю	*предпочитаю	цікавим	1
яндекс	*яндекс	яндекс	1
мнения	*мнения	про	1
японцев	*ездит	японців	1
взять	*взять	!	1
вином	*вином	-	1
восьмидесятых	*восьмидесятых	вісімдесятих	1
знамо	*знамо		1
великой	*великой	тратою	1
задавать	*задавать	питання	1
засыпать	*засыпать	засипати	1
обязанностей	*обязанностей	на	1
русня	*русня	коли	1
позже	*позже	торік	1
переночевать	*переночевать	переночувати	1
спросить	*спросить	хотів	1
годится	*годится	ютер	1
отце	*отце	.	1
катаются	*катаются	катаються	1
звучит	по-*вьетнамски	»	1
придержи	*придержи	притримайте	1
убежала	*убежала	втікла	1
разве	*разве	дивина	1
белобрысый	*белобрысый	біляве	1
лучшему	*лучшему	.	1
прогулялся	*прогулялся	прогулявся	1
скучал	*скучал	?	1
покрасят	*покрасят	пофарбують	1
водить	*водить	.	1
другой	*другой	віднайти	1
юми	*юми	вчителем	1
три	*три	.	1
штатов	*штатов	посольстві	1
болтай	*болтай	базікай	1
принадлежат	*цикадовых	цикадових	1
к	*к	війни	1
грязной	*грязной	брудного	1
стрекотун	*стрекотун	стрекотун	1
а	*мертвым	не	1
высох	*высох	висох	1
безгрешен	*безгрешен	мландываке	1
задавайте	*задавайте	важких	1
раскаиваюсь	*раскаиваюсь	розкаююся	1
пиджак	*пиджак	піджак	1
пар	*аж	аж	1
скворца	*скворца	шпака	1
уайт	*уайт	уайт	1
легче	*переносить	переносити	1
бутерброды	*бутерброды	канапки	1
браузер	*браузер	.	1
тайский	*тайский	тайська	1
допотопными	*допотопными	допотопними	1
якоже	*наша	як	1
эй	*эй	!	1
кимуру	*кимуру	кімуру	1
рик	*рик	рік	1
последнее	*последнее	читав	1
начерти	*начерти	накресли	1
макароны	*макароны	макарони	1
пожмём	*пожмём	потиснемо	1
измученный	*измученный	змучений	1
шоколадного	*шоколадного	як	1
деревне	*деревне	мешкає	1
утонул	*утонул	потонув	1
мелодичен	*мелодичен	милозвучна	1
черная	*черная	чорна	1
становится	*становится	товстішим	1
разбрасывающего	*разбрасывающего	що	1
свободными	*свободными	совістю	1
выглядит	*выглядит	.	1
безумцу	*безумцу	властиво	1
диарея	*диарея	пронос	1
взяться	*взяться	взятися	1
карьеру	*карьеру	’	1
чаша	*чаша	келих	1
поживает	*поживает	ся	1
иван	*иван	,	1
припарковать	*припарковать	більше	1
услышать	*услышать	.	1
силур	*силур	силур	1
до	*до	на	1
суматра	*суматра	суматра	1
пробке	*пробке	пробці	1
возвратиться	*возвратиться	вернутись	1
обжег	*обжег	язика	1
жалким	*жалким	жалюгідним	1
дверцы	*дверцы	не	1
лиссабоне	*лиссабоне	лісабоні	1
неразговорчив	*неразговорчив	неговіркий	1
изысканный	*изысканный	вишуканий	1
точнее	*точнее	точніше	1
некоторые	*некоторые	але	1
мэри	*мэри	хоча	1
постой	*постой	чекай	1
стираю	*стираю	перу	1
меня	*ненавидишь	скажи	1
связывает	*связывает	містом	1
!	*наделал	!	1
жгучей	*жгучей	пекучої	1
индивидуалист	*индивидуалист	індивідуаліст	1
равносилен	*равносилен	рівносильна	1
великой	*великой	без	1
мусоргского	*мусоргского	.	1
молик	*молик	?	1
сказывается	*сказывается	взнаки	1
похожи	*наши	схожі	1
каком	*каком	на	1
к	*к	лисого	1
спешила	*спешила	поспішала	1
какая	*какая	шкода	1
посылаю	*посылаю	надсилаю	1
пожалуйста	*садитесь	будь	1
помыть	*помыть	вимити	1
шоколадного	*шоколадного	шоколадного	1
к	*к	будь-яка	1
излечил	*излечил	вилікував	1
значку	*значку	значку	1
услышать	*услышать	про	1
стеснительные	*порочно	ж	1
фламинго	*фламинго	фламінго	1
женаты	*женаты	одружений	1
пуговица	*пуговица	відірвався	1
стареет	*стареет	старішає	1
колю	*колю	своєму	1
бена	*бена	бена	1
годится	*годится	’	1
венера	*венера	венера	1
разошелся	*разошелся	.	1
панды	*панды	панди	1
дружелюбные	*дружелюбные	дружелюбні	1
полставки	*полставки	півставки	1
встаю	*встаю	шостій	1
передохнуть	*передохнуть	на	1
пианино	*пианино	рояль	1
ведро	*ведро	відро	1
понятны	*любой	будь-якій	1
кивнул	*кивнул	кивнув	1
презервативов	*презервативов	презервативів	1
покачал	*покачал	похитав	1
дурачествами	*дурачествами	дурощами	1
тропинка	*тропинка	стежка	1
предатель	*предатель	є	1
холера	*холера	холера	1
отрастил	*отрастил	відростив	1
становятся	*становятся	довшими	1
спикировал	*спикировал	на	1
рада	*рада	задоволенням	1
тварь	*тварь	тварюка	1
помойте	*помойте	вимийте	1
всякой	*всякой	свої	1
есть	*три	слуги	1
биллу	*биллу	біллу	1
разбежались	*разбежались	розбіглися	1
двадцатилетняя	*двадцатилетняя	двадцятирічна	1
пленником	*пленником	цьому	1
последнего	*последнего	останнього	1
плавать	*плавать	значно	1
мальчишками	*мальчишками	.	1
припарковалась	*припарковалась	дивна	1
ложиться	*ложиться	лягати	1
убежала	*убежала	кицька	1
теннис	*теннис	день	1
какому	*какому	на	1
потрясающий	*потрясающий	вражаючим	1
вентиля	*вентиля	вентиля	1
чуть-чуть	*чуть-*чуть	трохи	1
курит	*курит	курить	1
вкусная	*вкусная	.	1
экстренное	*экстренное	термінове	1
купальник	*купальник	купальник	1
посмот	*посмот	подив	1
восьмидесятых	*восьмидесятых	.	1
посвечу	*посвечу	зачекайте	1
лёко	*лёко	льоко	1
изобилие	*изобилие	кущів	1
познакомиться	*познакомиться	познайомитися	1
презервативов	*презервативов	декілька	1
странный	*странный	.	1
гнездышко	*гнездышко	гніздечко	1
слушайтесь	*слушайтесь	завжди	1
сомневаюсь	*сомневаюсь	сумніваюся	1
здесь	*здесь	влітку	1
поторопись	*поторопись	поквапся	1
последние	*последние	життя	1
хм	*хм	гм	1
шумите	*шумите	шуміть	1
зонтик	*зонтик	вітальні	1
бы	*понадобился	нової	1
спальне	*спальне	втнули	1
согласиться	*согласиться	погодитися	1
нечто	*нечто	.	1
времен	*до	мамонтів	1
убирайся	*убирайся	забирайся	1
производит	*производит	що	1
окончено	*окончено	закінчено	1
выбор	*единственный	їхній	1
берёт	*берёт	бере	1
блейк	*блейк	блейка	1
высшая	*высшая		1
терпеливым	*терпеливым	терплячим	1
наш	*наш	ж	1
разобрать	*разобрать	розібрати	1
андрееску	*андрееску	пані	1
яани	*яани	разом	1
плевал	*плевал	плював	1
смазал	*смазал	змастив	1
римлян	*римлян	римлян	1
родителей	*родителей	?	1
средиземное	*средиземное	середземне	1
казак	*будто	козак	1
наивный	*наивный	наївний	1
бузина	*бузина	бузина	1
шила	*шила	сховаєш	1
потерянный	*потерянный	загублений	1
участия	*участия	брав	1
утёнок	*утёнок	стало	1
побывать	*побывать	відвідати	1
завтрашнего	*завтрашнего	ця	1
читаю	*читаю	з	1
гадкий	*гадкий	каченя	1
про	*собственную	про	1
до	*до	самі	1
рыгаю	*рыгаю	відригую	1
здесь	*здесь	навіть	1
повлияло	*повлияло	на	1
скучал	*скучал	сумуєш	1
другие	*другие	купалися	1
ежа	*ежа	їжака	1
погоди	*погоди	хвилину	1
твердят	*твердят	як	1
кукареку	*кукареку	бе	1
рад	*рад	навіть	1
различные	*различные	різних	1
соленая	*соленая	?	1
деревне	*деревне	.	1
возмутительно	*возмутительно	обурливо	1
пройтись	*пройтись	вона	1
ездит	*ездит	щорік	1
ме	*ме	бе	1
префекта	*префекта	у	1
твёрдом	*твёрдом	називається	1
белобрысый	*белобрысый	волосся	1
сандвичей	*сандвичей	лишилось	1
зацветает	*папоротник	папороть	1
старался	*старался	намагався	1
близких	*близких	близьких	1
соврал	*соврал	збрехав	1
вслед	*вслед	ішов	1
стеснялся	*стеснялся	я	1
облетела	*облетела	розлетілася	1
и	*боязливые	боязкі	1
глупо	*отвергать	відкидувати	1
курю	*курю	палю	1
чаевые	*чаевые	чайові	1
,	*злая	,	1
крупная	*крупная	найбільший	1
казани	*казани	є	1
другой	*другой	порядки	1
меленяны	*меленяны	розкажіть	1
порядочных	*порядочных	вчинках	1
другое	*другое	побачити	1
рождеством	*рождеством	я	1
