уже	уже	вже	81
со	з	зі	52
школу	школу	школи	36
с	з	із	29
нет	нi	ні	23
тебе	тобі	тебе	19
из	з	із	18
английский	англійський	англійську	17
добрый	добрий	доброго	16
тебе	тобі	тобою	16
же	ж	же	15
любите	любите	любіть	14
человек	людей	людина	14
нам	нам	нас	14
вечер	вечір	вечора	13
мне	мені	мене	13
том	том	тому	12
был	був	була	12
из	з	зі	11
отец	тато	батько	11
язык	мова	мову	11
,	,	,"	10
бела	біла	бела	10
снова	снова	знов	10
не	не	"не	10
цветы	цвіти	квіти	10
это	це	цей	10
зачем	нащо	навіщо	10
да	так	та	10
тем	тем	тим	9
уж	уже	вже	9
тома	тому	тома	9
часы	години	годинник	8
зовут	звуть	звати	8
утро	ранок	ранку	8
всё	все	усе	8
года	року	роки	8
всех	всіх	усіх	8
это	це	ця	8
было	було	була	8
английский	англійський	англійська	8
учитель	учитель	вчитель	8
него	його	нього	8
китайский	китайський	китайську	8
свой	свій	свою	8
дома	дому	вдома	7
был	був	було	7
то	то	те	7
книгу	книзі	книгу	7
аэропорт	аеропорт	аеропорту	7
иди	йди	іди	7
дождя	дощу	дощ	6
будем	будьмо	будемо	6
такое	таке	такий	6
пассажиры	поважати	пасажири	6
столе	стілі	столі	6
доброе	добре	доброго	6
японию	японію	японії	6
несколько	кілька	декілька	6
меня	мене	мені	6
идти	йти	іти	6
это	це	те	6
весь	весь	увесь	6
море	море	морі	6
стола	стіла	столу	6
остаётся	лишається	залишається	6
все	всі	все	6
английского	англійського	англійської	5
одно	одне	один	5
извините	вибачите	вибачте	5
со	з	із	5
еда	їда	їжа	5
большой	великої	великий	5
своё	своє	свою	5
руку	руці	руку	5
шесть	шість	шостій	5
кровати	ліжка	ліжку	5
своё	своє	свій	5
бы	би	чи	5
одного	одного	однієї	5
посмотрите	подивитеся	подивіться	5
заплатить	сплатити	заплатити	5
рассказал	розказав	розповів	5
снова	снова	знову	5
с	з	зі	5
минуту	хвилю	хвилину	5
дня	дня	дні	5
книги	книги	книжки	5
играю	граюся	граю	5
на	на	за	4
девочка	дівча	дівчинка	4
реку	ріку	річку	4
берегу	берегу	берега	4
свет	світ	світло	4
музыку	музиці	музику	4
утром	ранком	ранку	4
собой	собою	собі	4
языках	мовах	мовами	4
осторожен	обережний	обережним	4
такой	такий	така	4
бы	би	якби	4
я	я	як	4
была	була	було	4
таком	такім	такому	4
это	це	цю	4
шести	шести	шість	4
себе	собі	себе	4
рис	ріс	рис	4
продаются	продають	продаються	4
будущем	майбутнім	майбутньому	4
комнату	кімнату	кімнати	4
все	всі	усі	4
выше	вище	вищий	4
играть	гратися	грати	4
если	якщо	якби	4
утра	ранки	ранку	4
учиться	навчатися	вчитися	4
человека	людину	людини	4
нем	ньому	нього	4
италию	італію	італії	4
всему	всьому	усьому	4
доллара	долара	долари	4
оставаться	лишатися	залишатися	4
пойдем	підімо	підемо	4
английском	англійськім	англійській	4
по	по	до	4
улучшить	поліпшити	покращити	4
подарок	дарунок	подарунок	4
слишком	забагато	багато	4
поезде	поїзді	потязі	4
помешали	завадили	заважали	4
ради	ради	заради	4
части	частини	частині	4
ребёнку	дитині	дитини	4
давай	давай	давайте	4
свободе	свободі	свободу	4
немецкий	німецький	німецьку	4
вчера	вчора	учора	4
вы	ви	ти	4
ты	ти	ты	3
большая	велика	великий	3
ценное	цінне	цінний	3
час	година	годину	3
извините	вибачите	пробачте	3
девушки	нi	не	3
вопросы	питання	запитання	3
официант	офіціант	офіціанте	3
всё	все	весь	3
прекрасную	прекрасну	прекрасного	3
всём	всьому	усьому	3
опасность	небезпеку	небезпечність	3
случилось	сталося	трапилося	3
твой	твій	твою	3
книгу	цюкнигу	книгу	3
оставайся	лишайся	залишайся	3
пациенте	пацієнті	пацієнта	3
зоопарк	зоопарк	зоопарку	3
пойдём	підімо	підемо	3
ты	ти	"ти	3
европейский	європейський	європейського	3
чём-то	чомусь	чому	3
внезапно	раптово	раптом	3
будет	буде	будуть	3
большая	велика	велику	3
слишком	занадто	забагато	3
таким	таким	така	3
так	так	такий	3
шага	кроку	кроки	3
заметил	замітив	помітив	3
двое	двоє	двох	3
почувствовала	почула	відчула	3
красная	вона	червона	3
дочери	дочки	дочок	3
сразу	зразу	відразу	3
японскому	японському	японської	3
года	року	тому	3
еду	їду	їжу	3
доброго	доброго	добраніч	3
прошлом	минулім	минулому	3
умный	розумний	розумним	3
битве	битві	битви	3
люблю	люблю	полюбляю	3
года	пору	року	3
английское	англійське	англійську	3
вошли	увійшли	зайшли	3
английском	англійськім	англійською	3
лондон	лондона	лондону	3
построил	збудував	побудував	3
забудем	забудьмо	забудемо	3
неудачу	невдачу	невдачі	3
оружие	зброя	зброю	3
врачу	лікарю	лікаря	3
раз	раз	разу	3
на	направду	насправді	3
университет	університет	університету	3
коллекция	колекція	колекцію	3
этом	цім	цому	3
этих	цих	цим	3
старая	стара	старий	3
этом	цім	цим	3
нас	наc	нас	3
не	це	не	3
кофе	кавами	кава	3
жёлтая	жовта	жовті	3
подарков	дарунків	подарунки	3
всего	всього	усього	3
он	він	вона	3
убийстве	убивстві	вбивстві	3
едва	ледь	ледве	3
что-то	щось	чогось	3
обычно	зазвичай	звичайно	3
киеве	києву	києві	3
две	дві	двох	3
своём	своєму	своє	3
капитан	капітан	капітане	3
птицах	птахах	птахів	3
одиннадцать	одинадцятеро	одинадцята	3
полотенце	рушник	рушника	3
заплатили	сплатили	заплатили	3
дочерью	дочкою	донькою	3
не	не	це	3
своих	своїх	твоїх	3
коню	коню	коневі	3
свою	свою	свій	3
верна	вірна	верна	3
девушке	дівчині	дівчиною	3
господин	пан	пане	3
загрязнен	забруднений	забруднене	3
пассажира	пасажира	пасажири	3
две	дві	два	3
играл	грався	грав	3
комната	цякімната	кімната	3
с	з	за	3
чужой	чужий	чужого	3
два	два	дві	3
тому	тому	того	3
достаточно	достатньо	достатнього	3
всем	всім	усім	3
будущем	майбутнім	майбутнє	3
не	не	на	3
ты	ти	ви	3
идёт	йде	іде	3
иногда	іноді	інколи	3
минут	хвиль	хвилин	2
японской	японській	японської	2
колледж	коледж	коледжу	2
новость	новина	новину	2
ждали	чекали	чекають	2
может	мене	може	2
рой	рий	рій	2
нём	ньому	нього	2
старым	старим	старою	2
приятное	приємне	приємніше	2
границу	кордон	закордон	2
рассказывал	розказував	розповідав	2
папа	тато	батько	2
таким	таким	такою	2
почтовый	поштовий	поштова	2
таким	таким	таке	2
прекратил	припинив	припинило	2
неправильного	неправильного	неправильне	2
вагона	вагона	вагону	2
песню	цюпісню	пісню	2
холода	холоду	холоди	2
кофе	кави	кава	2
тома	томи	тома	2
дух	духа	дух	2
он	він	"він	2
горные	гірничі	гірські	2
комната	кімната	кімнаті	2
одиннадцать	одинадцятьох	одинадцять	2
фотографиям	фотографіям	фотографій	2
начнём	почнемо	розпочнемо	2
покойной	покійної	покійну	2
момоти	момоти	момоті	2
видам	видам	видів	2
началась	почалася	почалося	2
день	кавами	кави	2
заполнена	заповнена	наповнена	2
присоединиться	приєднатися	приєднатись	2
эфиопию	ефіопію	ефіопії	2
испанию	іспанію	іспанії	2
войне	війні	війни	2
нашего	новим	новий	2
повсюду	повсюди	всюди	2
остановились	зупинилися	зупинився	2
меня	мене	тебе	2
французским	французьким	французською	2
тёмную	темну	темний	2
перерыв	хвиль	хвилин	2
уверена	упевнена	впевнена	2
челюсти	щелепи	щелепі	2
вам	вам	вами	2
днём	жити	миті	2
это	це	"це	2
прав	прав	правий	2
шума	шуму	шум	2
внимание	увага	увагу	2
тёмные	темні	темне	2
языку	мові	мови	2
четырёх	чотирьох	чотирма	2
тёмная	темна	темний	2
светлого	світлого	світлої	2
надеюсь	сподіваюся	сподіваюсь	2
ребёнка	дитини	дитину	2
рай	рай	раю	2
месяце	місяці	місяця	2
большой	великий	велике	2
святой	святої	святий	2
друг	друг	друга	2
пришёл	прийшов	прибув	2
встретимся	зустріньмося	зустрінемось	2
запишите	запишіть	запишите	2
рака	рака	раку	2
английскому	англійському	англійскої	2
не	не	ні	2
входите	входьте	заходьте	2
одной	одної	однієї	2
не	не	нема	2
вооружён	озброєний	озброєнний	2
минуту	хвилю	хвилинку	2
дуба	дубу	дуба	2
словах	словах	словами	2
берег	берег	берега	2
ты	ти	чи	2
темноте	темряві	темряви	2
доброй	доброю	доброї	2
убил	убив	вбив	2
сыну	сину	синові	2
внимание	увагу	уваги	2
аризону	аризону	арізоні	2
вечером	вечором	вечора	2
мне	подобається	подобатися	2
слишком	занадто	надто	2
сколько	скількираз	скільки	2
книгой	книгою	книжкою	2
рассказала	розказала	розповіла	2
парк	парк	парку	2
серьезное	серйозне	серйозна	2
часов	годин	година	2
краже	крадіжці	крадіжку	2
свежими	свіжими	свіжим	2
запрещено	заборонене	заборонено	2
вопрос	питання	запитання	2
отличается	відзначається	відрізняється	2
нету	нема	немає	2
внешности	зовнішності	зовнішістю	2
поезда	поїзда	потяга	2
деревенская	сільська	сільське	2
едой	їдою	їжею	2
сложено	складене	складено	2
серьёзное	серйозне	серйозну	2
села	села	сіла	2
жива	жива	живою	2
.	.	."	2
результате	результаті	результат	2
хорошем	хорошім	хорошому	2
смеяться	сміятися	насміхатися	2
родную	рідну	рідного	2
нравилось	подобалося	подобалась	2
нос	ніс	носа	2
мама	мама	мамо	2
иностранный	іноземний	іноземну	2
на	на	не	2
уверены	упевнені	впевнені	2
восточной	східної	східною	2
музей	музей	музею	2
счастью	щастю	щастя	2
летом	літом	літа	2
целую	цілую	цілу	2
японском	японськім	японському	2
французский	французький	французьку	2
людях	людях	людей	2
подарок	дарунок	подарунком	2
японский	японський	японську	2
французский	французький	французька	2
многому	багатьом	багато	2
полезное	корисне	корисна	2
такой	такий	такою	2
закрыть	закрити	замкнути	2
очень	сильне	сильно	2
трудная	скрутна	складна	2
алфавит	абетка	абетку	2
совет	раду	пораду	2
девочками	дівчатами	дівчата	2
старый	старий	старе	2
своим	своїм	своє	2
кофе	кави	каву	2
японский	японський	японська	2
плохом	поганім	поганому	2
науке	науці	науку	2
учить	навчати	вивчати	2
мэру	меру	мера	2
украинском	українськім	українській	2
веков	віка	віків	2
я	я	"я	2
пропуск	пропуск	перепустку	2
остаться	лишитися	залишитися	2
математике	математику	математики	2
велосипед	велосипед	велосипеда	2
первому	першому	першим	2
расскажи	розказажи	розкажи	2
публичном	публічнім	публічному	2
за	за	на	2
не	не	ще	2
смертью	смертю	смерть	2
заметили	замітили	помітили	2
детстве	дитинстві	дитинство	2
человеке	людині	людину	2
животных	тваринах	тварин	2
молоком	молоком	молоко	2
сравните	порівняєте	порівняйте	2
прошлым	минулим	минулого	2
белорусских	білоруських	білоруськів	2
религии	релігії	релігію	2
голосу	голосу	голосом	2
вы	ви	"ви	2
нам	нам	наші	2
плохой	поганої	погану	2
касается	торкається	стосується	2
нравиться	подобатися	подобається	2
новогодний	новорічний	новорічним	2
жалуется	жаліється	жалівся	2
слабо	слабо	слабко	2
вошёл	увійшов	ввійшов	2
километров	кілометрів	километрів	2
чём	чому	чого	2
поворачивается	повертається	повертає	2
телефона	телефону	телефоні	2
папа	тато	татко	2
учитель	учитель	вчителька	2
еде	їді	їжі	2
книгу	книзі	книжку	2
можете	можете	зможете	2
переведут	переведуть	перекладуть	2
хозяйству	господі	господарству	2
сдала	здала	склала	2
осталась	лишилася	лишалася	2
большом	великім	великому	2
учителях	учителях	вчителів	2
позор	ганьбу	ганьба	2
добрый	добрий	добридень	2
учит	навчає	вивчає	2
обеда	обіду	обід	2
были	були	біли	2
чародеи	різного	різних	2
на	на	"на	2
тоннель	тунель	тонель	2
вещество	речовину	речовина	2
началось	почалося	почалася	2
уберите	приберіть	прибери	2
верят	вірять	вірить	2
интересуюсь	цікавлю	цікавлюся	2
новою	новою	нову	2
останусь	лишуся	залишуся	2
вкусах	смаках	смаки	2
обвинён	звинувачений	обвинуватили	2
скале	скалі	скелі	2
брось	кинь	покинь	2
убила	убила	вбила	2
перчаток	нову	нових	2
построен	збудований	побудовано	2
дочери	дочки	доньки	2
прописанное	прописане	прописані	2
любят	люблять	полюбляють	2
летних	літніх	літні	2
верхом	верхом	верхи	2
реке	ріці	річці	2
можешь	можеш	можете	2
автобус	автобус	автобусу	2
расскажу	розказажу	розкажу	2
эксперимент	експеримент	експеремент	2
маленькой	маленькій	маленькому	2
стен	стін	стіни	2
осознают	усвідомлять	усвідомлюють	2
шутками	жартами	жартів	2
книга	книга	книжка	2
короткое	коротке	короткий	2
решать	вирішувати	вирішити	2
майор	майор	майоре	2
вопросов	питань	запитань	2
этом	цім	цій	2
краской	барвою	фарбою	2
учителю	учителю	вчителю	2
добавить	додати	добавити	2
собаке	собаці	собаку	2
тебя	тебе	теба	2
интересное	цікаве	цікава	2
новый	новий	нову	2
а	а	та	2
подарков	дарунків	подарунків	2
господа	пани	панове	2
сумку	сумку	сумки	2
приглашена	запрошена	запросили	2
осталось	лишилося	залишилось	2
честной	чесній	чесної	2
химическое	хімічне	хімічна	2
найти	знайти	віднайти	2
уверен	упевнений	впевнений	2
церковь	церкву	церкви	2
кодами	кодами	кодом	2
своей	своїй	своєму	2
в	що	до	2
на	на	та	2
природе	природі	природи	2
посмотреть	подивитися	подивитись	2
всему	всьому	усього	2
номере	номер	номері	2
обоим	обом	обох	2
японию	японію	японіі	2
руле	кермі	керма	2
давно	давно	довго	2
такое	таке	такого	2
чувствуете	відчуваєте	почуваєте	2
учебное	навчальне	навчальний	2
большие	великі	великих	2
ногу	нозі	ногу	2
привлечь	залучити	зацікавити	2
мы	ми	ви	2
самый	самий	самим	2
скоростью	швидкістю	швидкості	2
применяется	застосовує	застосовується	2
длинные	довгі	довге	2
большие	великі	великий	2
случится	станеться	трапиться	2
реки	ріки	річки	2
вырасту	вирту	виросту	2
правильном	правильнім	правильному	2
немного	трохи	трошики	2
подождите	почекайте	почекай	2
идите	йдіть	ідіть	2
допустил	допустив	припустився	2
растут	зростають	ростуть	2
вошёл	увійшов	зайшов	2
столичном	столичнім	столичному	2
обед	обід	обіду	2
жди	чекай	очікуй	2
юрист	юрист	юристом	2
приготовила	налаштувала	приготувала	2
дитя	дитя	дитина	2
инструкциям	інструкціям	інструкціями	2
меньше	менше	менша	2
остался	лишився	залишився	2
больше	більше	більш	2
языке	мові	мовою	2
подождёшь	почекаєш	почекаєте	2
сравнению	порівнянню	порівнянні	2
учу	навчаю	вивчаю	2
недели	тижня	тижні	2
было	було	вуло	2
легенде	легенді	легендою	2
меняется	міняє	міняється	2
выбрал	вибрав	обрав	2
почте	пошті	пошти	2
пожарное	пожежне	пожежного	2
паутине	павутинню	павутиння	2
актрисе	актрисі	актрисою	2
старом	старім	старому	2
закончился	закінчився	скінчилася	2
прямо	прямо	просто	2
?	?	?"	2
подождите	почекайте	зачекайте	2
слишком	забагато	занадто	2
заставил	змусив	примусив	2
младенца	немовляти	немовля	2
рекомендуется	рекомендує	рекомендується	2
грех	сміх	гріх	2
формой	формою	формі	2
то	то	та	2
союз	союз	союзу	2
белом	білім	біле	2
ухе	усі	вусі	2
вынудили	вимусили	примусили	2
прошлом	минулім	минулого	2
рака	рака	рак	2
шло	йшло	було	2
королевском	королівськім	королівському	2
национальности	національності	національністю	2
вспомнили	пригадали	згадали	2
сделано	зроблене	зроблено	2
острый	гострий	гостра	2
меняет	міняє	змінює	2
добудь	здобудь	добудь	2
голоса	голоси	голосу	2
были	були	бути	2
десяти	десяти	десятої	2
немного	трохи	трошки	2
голова	голова	голові	2
саду	саду	саді	2
встреча	рівне	рівно	2
квалифицированный	кваліфікований	кваліфікованим	2
колодец	криниця	криницю	2
маленькую	маленьку	маленьке	2
заставили	змусили	примусили	2
важная	важлива	важливою	2
деньгами	грішми	грошима	2
это	це	ці	2
я	одяг	одягу	2
экземпляром	екземпляром	екземпляр	2
рту	роту	роті	2
нужен	потрібний	потрібна	2
телу	тілу	тіла	2
живи	живи	жити	2
сразу	зразу	одразу	2
сказать	сказати	казати	2
корейский	корейський	корейську	2
часы	годинники	годинник	2
упадке	занепаді	занепад	2
экономическим	економічним	економічних	2
спокоен	спокійний	спокійним	2
такой	такий	таким	2
большой	великої	великою	2
ошибку	помилку	помилки	2
выход	вихід	виходу	2
мире	мирі	мир	2
больше	більше	більша	2
виды	види	видів	2
честный	чесний	чесна	2
отдыха	спочинку	відпочинку	2
берегам	берегам	берегах	2
пожилом	літнім	літню	2
длине	довжині	довжиною	2
рукой	рукою	руку	2
шёл	йшов	ішов	2
рыбаку	рибаку	рибалки	2
твои	твої	твоїх	2
курения	куріння	паління	2
собрались	зібралися	збиралися	2
врачом	лікарем	лікаря	2
плохого	поганого	погане	2
человека	людини	людину	2
использует	використає	використовує	2
воздержаться	утриматися	утриматись	2
белой	білої	білою	2
южной	південної	південну	2
польский	польський	польский	2
вести	поводитися	поводитись	2
моё	моє	моя	2
лес	ліс	лісу	2
мечта	мрія	мрію	2
задачу	задачу	завдання	2
статей	цікавий	цікавих	1
чувствами	їїпочуттями	почуттями	1
.	пенсіонер	пенсiонер	1
менять	міняти	змінювати	1
встречаемся	зустрічаємося	зустрінемося	1
благодаря	дякуючи	дякую	1
причина	причина	причину	1
зарезервированы	цімісця	місця	1
новой	нової	новою	1
держит	тримає	тримав	1
закончился	закінчився	зкінчивсь	1
умерли	померли	вмерли	1
теорию	цютеорію	теорію	1
будок	буд	будок	1
подаёте	подаєте	надаєте	1
корабль	сировина	сировину	1
чувств	йогопочуттів	почуттів	1
программу	цюпрограму	програму	1
секрет	мійсекрет	секрет	1
прекрасна	прекрасна	прекрасним	1
бог	бога	бог	1
ты	що	якщо	1
нужна	потрібна	потрібен	1
переведите	переведіть	перекладіть	1
заходите	заходите	заходьте	1
твоя	потрібна	потрібні	1
нагоняет	цямузика	музики	1
автомобиля	свогоавтомобіля	автомобіля	1
а	що	ще	1
что	що	то	1
цветов	цвітів	квітів	1
собираетесь	збираєтеся	збираєтесь	1
язык	мова	мовою	1
голоден	голодний	зголоднів	1
священником	священиком	священником	1
английский	англійський	англійської	1
держитесь	тримаєте	тримайтеся	1
язык	мову	вимову	1
волосы	моїволосся	волосся	1
вспомнила	пригадала	згадала	1
пользоваться	користуватися	користуватись	1
сена	сіна	сена	1
такой	такій	таку	1
сигареты	моїсигарети	сигарети	1
своевременно	своєчасно	вчасно	1
дороге	дорозі	дорогою	1
.	літак	літаку	1
родной	рідної	рідна	1
смотри	дивися	дивись	1
облака	хмари	хмарини	1
том	том	тома	1
сильному	сильному	сильного	1
рядом	поруч	поряд	1
позвоните	зателефонуєте	зателефонуйте	1
знала	знала	знає	1
ходил	ходив	ходила	1
том	том	томе	1
сайтам	сайтам	сайтів	1
года	року	пору	1
учёных	учених	вчених	1
и	і	ні	1
мы	сталі	стали	1
бесплатно	безплатно	безкоштовно	1
косметика	продає	продається	1
поезде	поїзді	поїхав	1
приятен	приємний	приємним	1
сном	соном	сном	1
языка	французький	французької	1
зимой	зимою	взимку	1
книга	цякнига	книга	1
умеет	вміє	уміє	1
кормил	годував	годувала	1
хватало	вистачало	висточало	1
летом	літом	влітку	1
приглашён	запрошений	запросили	1
спасибо	спасибі	опасибі	1
видел	бачив	побачив	1
опасности	небезпеки	небезпеці	1
честная	чесна	чесний	1
товарищ	товариш	товарише	1
игрушка	цяіграшка	іграшка	1
отца	тата	батька	1
конфликт	конфлікт	конфлікт"	1
найти	знайти	знайшли	1
человек	цейлюдина	людина	1
посмотри	подивися	подивись	1
туалетной	туалетної	туалетного	1
вкусная	цявода	вода	1
осталась	лишилася	лишилась	1
так	так	таке	1
осталось	лишилося	залишилося	1
учёным	ученим	вченим	1
отцом	татом	батьком	1
заплатят	сплатять	заплатять	1
ранят	поранять	ранять	1
нет	фраза	фразі	1
комнате	кімнаті	кімнату	1
украинский	український	українська	1
газету	газету	газети	1
он	він	віку	1
планету	цюпланету	планету	1
сложнее	складнішийий	складніше	1
нам	нам	наш	1
учёный	учений	вчений	1
комитет	мінський	міський	1
сделана	зроблена	вироблена	1
я	чув	почув	1
.	телефонний	телефону	1
пост	пост	посаду	1
теории	важливий	важливіша	1
меняются	міняють	змінюються	1
дорогу	дорозі	дорогу	1
сыну	сину	сина	1
правдивыми	правдивими	правдиві	1
часов	годин	годинників	1
слушай	слухай	послухай	1
взрослому	дорослому	дорослої	1
своё	своє	свого	1
том	том	томъ	1
кузнецу	ковалю	ковалеві	1
вмешиваться	втручатися	втручатись	1
водой	водою	води	1
десять	десять	десятій	1
этот	такий	самий	1
уступить	вступити	поступитися	1
делать	робити	любить	1
есть	їсти	поїсти	1
нравится	подобається	подобаться	1
показываем	показуємо	показують	1
услугу	послузі	послугу	1
снег	сніг	снігом	1
телефону	телефону	телефоном	1
улица	цявулиця	вулиця	1
вам	вам	вас	1
сказал	сказав	казав	1
выгнал	вигнав	прогнав	1
козыря	козиря	козирів	1
перейти	перейти	переходити	1
работы	поліпшенні	покращення	1
те	одні	один	1
разрешить	дозволити	розв'язати	1
ещё	що	ще	1
помог	допоміг	допомогла	1
соединяет	поєднує	сполучує	1
лукашенко	лукашенка	лукашенко	1
дала	дала	надала	1
французского	французького	французької	1
эффектов	побічний	побічних	1
убийцы	убивці	вбивця	1
гомоморфизм	гомоморфізм	гомоморфізм"	1
япония	японія	японію	1
слез	сліз	зліз	1
предупреждён	попередлений	попереджений	1
наполнить	наповнити	заповнити	1
особенный	особливий	особлива	1
продал	продав	продала	1
хотят	хочуть	почути	1
девочка	дівча	дівчина	1
отсюда	звідси	звідки	1
затраты	затрати	витрати	1
работники	працівники	працівними	1
скромность	йогоскромність	скромність	1
чувствовал	відчував	почував	1
месяца	місяця	місяці	1
я	кави	каву"	1
биологию	біологію	біології	1
при	допомоги	допомогою	1
доверять	довіряти	вірити	1
постоянная	постійна	постійний	1
разрешите	дозволите	дозвольте	1
будущее	майбутнішій	майбутнє	1
рыбы	риби	рибини	1
внимательны	уважні	уважними	1
сестра	моясестра	сестра	1
тупой	тупої	тупий	1
выбрать	вибрати	обрати	1
образованы	утворені	освічені	1
повернулась	повернулася	розвернулася	1
болот	марне	марно	1
можем	можемо	зможемо	1
была	була	бувала	1
делать	робити	зробити	1
месте	місці	місті	1
книг	книг	книжок	1
раза	разу	рази	1
невозможно	неможливо	"неможливо	1
помощи	допомоги	допомогою	1
продаётся	продає	продається	1
изящна	важливішийий	важливіше	1
этому	цьому	цього	1
уже	магазин¹	магазині	1
прошли	пройшли	проминули	1
отказываться	відмовлятися	відмовлятись	1
сад	сад	садок	1
французский	рідний	рідною	1
причинить	завдати	завдавати	1
оценено	оцінене	оцінено	1
людских	сліз	сльоз	1
настроения	настрої	настрою	1
полудня	півдня	опівдня	1
воде	порі	воді	1
шутки	жарти	жарту	1
эти	цігроші	гроші	1
бостон	бостон	бостона	1
доктор	доктор	докторе	1
входи	входь	заходь	1
часов	годин	годині	1
датский	данський	датський	1
высказываний	висловлень	висловлювань	1
качество	якість	кількість	1
галстуку	краватці	краватки	1
замка	замка	замка́	1
сюжеты	всісюжети	сюжети	1
вещи	новий	нові	1
голодны	голодні	голодний	1
номерами	номерами	номером	1
ходите	ходіть	ходите	1
заплатит	сплатить	заплатить	1
арабский	арабський	арабська	1
ему	йому	йому"	1
фразу	цюфразу	фразу	1
,	освіту	освіта	1
книгу	книгу	книжку	1
два	два	двох	1
она	вона	вечора	1
карту	карту	картку	1
сами	сами	самі	1
тяжёлому	тяжкому	тяжкої	1
заставляла	змушувала	примушувала	1
длинные	довгі	задовге	1
к	означати	означає	1
идет	йде	іде	1
двадцатого	двадцятоговіки	двадцятого	1
историей	цієюісторією	історією	1
обвинения	цізвинувачення	звинувачення	1
подруги	дочки	доньки	1
куском	шматом	шматком	1
шага	кроку	крока	1
эта	біла	бела	1
отец	тато	ватько	1
закончится	закінчиться	скінчиться	1
холоднее	холоднішийий	холодніше	1
включено	включене	включено	1
прогулка	твояпрогулянка	прогулянка	1
рыбу	рибу	риби	1
деревья	цідерева	дерева	1
вы	ви	чи	1
минуте	хвилі	хвилині	1
.	кількості	кількість	1
чему	чому	чого	1
перевёл	перевів	переклав	1
улицу	цювулицю	вулицю	1
нет	нi	не	1
студию	студію	студії	1
помогает	допомагає	помогає	1
свету	світу	світом	1
проблеме	проблема	проблемі	1
чувствуешь	відчуваєш	почуваєшся	1
маленький	маленький	маленькою	1
задания	всізавдання	завдання	1
тяжёлой	тяжкій	тяжкої	1
довольно	досить	достатньо	1
могу	можу	зможу	1
красной	червоною	червоним	1
том	том	тім	1
темноты	темряви	темрявою	1
самого	самого	свого	1
объявлен	оголошений	оголошено	1
тратой	витратою	тратою	1
машин	старий	старих	1
не	сильне	сильно	1
счетом	ліком	лічбою	1
могут	можуть	можут	1
прошлом	минулім	минуле	1
ну	ну	ні	1
французской	французької	французьку	1
он	він	вiн	1
помочь	допомогти	допоможу	1
тянутся	точаться	тягнуться	1
крепкое	міцне	міцну	1
кроме	окрім	крім	1
примеры	приміри	приклади	1
уже	майбутнішій	майбутнє	1
велосипед	мійвелосипед	велосипед	1
ужин	готовий	готова	1
равносилен	йогорада	порада	1
сеть	сіть	сітка	1
нужен	потрібний	потрібен	1
жёлтый	жовтий	жовта	1
сравнивают	порівнюють	порівнють	1
поездка	поїздка	поїдзка	1
не	не	наше	1
так	так	така	1
нам	нам	нашим	1
наступала	наставала	наступала	1
адаптируется	адаптує	адаптується	1
прячусь	ховаю	ховаюсь	1
посещение	відвідання	відвідування	1
должен	повинен	винен	1
узнают	дізнаються	довідуються	1
эта	ця	цю	1
сестры	нi	не	1
этот	цей	це	1
помните	цюгру	ігру	1
пройду	пройду	пройти	1
ним	ним	цим	1
пиву	пиву	пива	1
вынужден	вимушений	змушений	1
прекратите	припините	припиніть	1
сигарет	сигарет	цигарок	1
болеет	боліє	хворіє	1
минский	мінський	міський	1
женщиной	жінкою	жінка	1
.	великі	завеликі	1
сестра	їїсестра	сестра	1
что	що	щоб	1
маленькой	маленької	маленькою	1
дома	доми	вдома	1
матч	зливи	зливу	1
мальчик	цейхлопчик	хлопчик	1
опоздание	запізнення	спізнення	1
казахский	казахський	казахська	1
недавно	недавно	нещодавно	1
приятелю	приятелю	приятелеві	1
официальный	офіційний	офіційна	1
бы	що	щоб	1
бесконечна	нескінченна	нескінченний	1
поцелуй	поцілунок	поцілуй	1
гордость	зір	зірок	1
важный	важливий	важлива	1
стал	став	стало	1
улиток	петриків	равликів	1
сегодня	сьогодні	сьогоднi	1
никто	ніхто	нікого	1
часов	годин	години	1
дорожной	дорожньої	дорожною	1
дают	дають	пускають	1
алмаза	діаманта	діамант	1
холодное	холодне	холодна	1
поможет	допоможе	допоможуть	1
свиней	свиней	свинях	1
чёрта	риса	біса	1
поддержать	підтримати	підтримувати	1
сестру	їїсестру	сестру	1
эксперимента	експерименту	експеримента	1
подруга	мояподруга	подруга	1
господа	пани	пані	1
она	вона	воно	1
помощь	йогодопомогу	допомогу	1
центра	центра	центру	1
игры	гри	ігри	1
в	писало	писали	1
усыновить	усиновити	всиновити	1
правонарушение	першеправопорушення	правопорушення	1
длинный	довгий	найдовший	1
технологии	цієїтехнології	технологіі	1
семейству	сімейству	сімейства	1
нет	нi	на	1
большой	великої	велика	1
прислушавшись	прислухавшись	послухавши	1
река	цяріка	ріка	1
остановилось	зупинилося	зупинилась	1
международного	міжнародного	міжнародної	1
мочь	могти	хотіти	1
уж	уже	дуже	1
возникал	виникав	виникало	1
комнате	кімната	кімнаті	1
разговариваешь	розмовляєш	розмовляеш	1
радиоактивное	радіоактивне	радіоактивна	1
начинаются	починаються	розпочинаються	1
запрещён	заборонений	заборонено	1
закрывать	закривати	зачиняти	1
ночном	нічнім	нічному	1
лишь	лише	лишень	1
открытыми	відкритими	відкритим	1
усилия	моїзусилля	зусилля	1
итальянский	італійський	італійську	1
ради	ради	люди	1
уши	уха	вуха	1
спрячешь	заховаєш	сховаєш	1
тьма	тьма	пітьма	1
голоса	голосу	голоси	1
любят	люблять	полюблять	1
иностранным	іноземним	іноземних	1
то	то	бо	1
правду	правду	правди	1
помощью	з	за	1
комментарии	коментарі	коментарям	1
подарила	дарувала	подарувала	1
выбрали	вибрали	обирали	1
заплатил	сплатив	заплатив	1
существование	своєіснування	існування	1
высокое	високе	висока	1
об	о	що	1
минуту	хвилю	хвилини	1
интересуется	цікавить	цікавиться	1
при	бороди	бороду	1
французском	французькім	французькою	1
океану	океану	океаном	1
половина	половина	половину	1
убийство	убивство	вбивство	1
приедет	приїде	прибуде	1
французском	французькім	французькій	1
лет	провів	років	1
опасен	небезпечний	небезпечним	1
новость	цяновина	новина	1
получила	отримала	одержала	1
кофе	кави	каві	1
ухо	ухо	вухо	1
порвано	їїсукня	сукня	1
камера	цякамера	камера	1
доброй	добрій	добраніч	1
болото	уха	вуха	1
перейдём	перейдімо	перейдемо	1
столу	стілу	столу	1
плакал	тоймомент	момент	1
и	засіб	засоб	1
деньгам	грошям	грошам	1
ест	їсть	їсти	1
боится	моясестра	сестра	1
учителя	учителі	вчителі	1
японского	японського	японської	1
.	божевільний	божевільним	1
золото	золото	залізо	1
ничего	нічого	ничого	1
правил	правил	правив	1
открылась	відкрилася	відчинились	1
прекрасна	прекрасна	прекрасне	1
бы	би	аби	1
ноге	нозі	ногу	1
работу	цюроботу	роботу	1
выпил	випив	випити	1
фотографии	фотографії	фотографувати	1
столом	стілом	столом	1
песня	їїпісня	пісня	1
горная	гірнича	гірська	1
тропе	стежці	стежкою	1
когда	коли	почали	1
вещи	різне	різні	1
такой	такий	гладкий	1
двадцать	двадцятьох	двадцять	1
будет	це	те	1
ответ	відповідь	відповіді	1
всей	всієї	усієї	1
сна	сону	сну	1
русской	руської	російської	1
пошёл	пішов	пішла	1
останетесь	лишитеся	залишитесь	1
угрожать	погрожувати	загрожувати	1
зародилась	цятрадиція	традиція	1
считается	вважає	вважається	1
бела	біла	бело	1
расписанию	розпису	розкладу	1
плохое	погане	поганий	1
общий	спільний	спільна	1
живёт	живе	живуть	1
том	човна	чьлна	1
вошла	увійшла	зайшла	1
длинная	довга	найдовша	1
мои	моїгодини	полагодили	1
многим	багатьма	багатьом	1
не	більше	більш	1
выжили	вижили	вижило	1
городок	рідний	рідного	1
учителем	учителем	вчителем	1
отказываюсь	відмовляюся	відмовляюсь	1
японский	рідний	рідна	1
танец	танок	танець	1
практике	практику	практиці	1
.	освіта	освіту	1
говорили	тобі	тебе	1
ключ	ключ	ключа	1
атаку	цюатаку	атаку	1
невозможна	неможлива	неможливе	1
момента	став	стала	1
подадут	подадуть	подаватимуть	1
посетит	відвідає	відвідає"	1
не	це	те	1
сына	сина	вигнав	1
толстый	товстий	товста	1
знают	знають	знатимуть	1
всерьёз	всерйоз	серйозно	1
диалог	діалог	діалоги	1
английский	англійський	англійскій	1
горячие	гарячі	гаряче	1
одного	одного	одної	1
встретитесь	зустрінетеся	зустрінетесь	1
эмоции	емоції	емоцій	1
делает	робить	чинить	1
признал	визнав	зізнався	1
выучить	вивчити	вчити	1
чувствуешь	відчуваєш	почуваєш	1
специализируюсь	спеціалізуюся	спеціалізуюсь	1
ожидают	очікують	чекають	1
не	не	неба	1
ходила	ходила	ходив	1
о	о	що	1
разобрался	розібрався	розбирався	1
обвинение	звинувачення	обвинувачення	1
кто	хто	хтозна	1
дочь	дочка	донька	1
.	дорога	дорозі	1
нестерпимой	нестерпної	нестерпний	1
язык	англійський	англійською	1
сих	мене	мені	1
ничего	лишається	залишається	1
проблема	цяпроблема	проблема	1
.	здивувати	здивувала	1
прибудут	прибудуть	прийдуть	1
горячий	гарячий	гаряча	1
люди	люди	людей	1
починить	моїгодини	полагодити	1
фермеры	фермери	феремери	1
табаком	тютюном	тютюн	1
реки	ріки	рік	1
минуту	хвилі	хвилину	1
насилие	насилля	насильство	1
сколько	скільки	окільки	1
сложная	складна	складне	1
долго	довго	"довго	1
останься	лишись	залишися	1
работают	працюють	працює	1
траву	цютраву	траву	1
норма	норма	нормо	1
дочь	дівча	дівчинку	1
долгое	довге	довгий	1
начнется	почнеться	розпочнеться	1
нам	нам	на	1
перевожу	переводжу	перекладаю	1
оно	воно	вона	1
прибытия	йогоприбуття	прибуття	1
отличием	відміною	відзнакою	1
страус	струсь	страус	1
странице	сторінці	сторінці"	1
адрес	їїадресу	адресу	1
простой	простій	простим	1
продолжился	продовжився	продовжилася	1
тихо	тихо	тиша	1
продолжала	продовжувала	продовжила	1
рану	рану	рану"	1
миновать	минати	минути	1
сайтам	іноземний	іноземних	1
врагу	ворогу	ворогові	1
гарантия	гарантія	гарантією	1
тебя	тебе	"тебе	1
глухой	глухої	глухий	1
сказала	сказала	наказала	1
проблему	цюпроблему	проблему	1
рациональны	раціональні	раціональними	1
поздравляю	здоровлю	поздоровляю	1
кто-то	хтось	"хтось	1
почувствовал	почув	відчув	1
отношение	ставлення	ставитися	1
прости	вибач	пробач	1
уха	уха	вуха	1
останутся	лишаться	залишаться	1
кто	хто	ніхто	1
денег	грошей	гроші	1
этот	такий	така	1
венгерский	угорський	угорська	1
мы	всі	все	1
что	що	бо	1
совет	наказу	наказові	1
полицейский	поліцай	поліцейський	1
.	сина	синів	1
вы	всі	все	1
вора	злодія	крадія	1
оставайтесь	лишайтеся	залишайтеся	1
сильно	сильне	сильно	1
наступайте	настайте	наступайте	1
окрестности	околиці	околицю	1
мире	вісті	вести	1
любовь	любові	любов	1
большое	велике	величезне	1
перелезали	цідерева	дерева	1
брошен	кинутий	кинуто	1
похоронен	похований	поховано	1
его	його	нього	1
меня	мене	мене"	1
первое	перше	перший	1
пирог	пиріг	пирога	1
землетрясения	землетрусу	землетруси	1
чей	чий	чия	1
одна	одна	одною	1
верят	вірять	довіряють	1
учителя	учителя	вчителя	1
минский	мінський	мінська	1
правда	правда	справді	1
птицы	птаха	птахи	1
яркий	яскравий	найяскравіший	1
чтобы	хороший	хороші	1
любовь	любов	любові	1
рекомендуете	рекомендуватимете	рекомендуєте	1
бы	би	ти	1
отказал	відмовив	відказав	1
смотрят	доглядають	заглядають	1
сплошные	суцільні	оуцільні	1
применяют	застосовують	використовують	1
был	був	буде	1
курс	курсу	курс	1
всегда	завжди	завджи	1
недоволен	незадоволений	невдоволений	1
были	були	було	1
просто	просто	простий	1
родится	народиться	родиться	1
загорелась	зайнялася	загорілася	1
английский	англійський	"англійську	1
гладит	моясестра	сестра	1
здесь	нову	новий	1
соленая	цявода	вода	1
сама	сама	сам	1
я	початки	початок	1
twitter	twitter	twitter'i"	1
такая	така	отака	1
запись	запис	"запис	1
качественные	якісні	якісний	1
ресторан	цейресторан	ресторан	1
кошка	кішка	кицька	1
минуту	хвилі	хвилини	1
обучаться	навчати	навчатися	1
чувствовала	відчувала	почувалася	1
хватает	вистачає	вистачало	1
шкаф	новий	нової	1
выбери	вибери	обери	1
воскресенье	неділі	неділю	1
всю	всю	все	1
твоих	твоїх	своїх	1
заново	заново	знову	1
надеемся	сподіваємося	сподіваємось	1
начнётся	почнеться	розпочнеться	1
её	що	ще	1
нравился	подобався	сподобався	1
выбирая	вибираючи	обираючи	1
грозил	погрожував	загрожував	1
девочки	дівчати	дівчата	1
ядерного	ядерного	ядерної	1
голые	голі	гола	1
тонко	тонке	тонко	1
не	гірше	гірша	1
безопасности	безпеки	безпеці	1
сегодня	сьогодні	оьогодні	1
задание	домашній	домашнє	1
короткими	короткими	коротким	1
считают	вважають	вважаємо	1
поезда	поїзда	поїзди	1
простой	простій	простий	1
фотография	мояфотографія	фотографія	1
отличную	відмінну	відмінне	1
немецком	німецькім	німецькою	1
играем	граємося	граємо	1
ночи	пізній	пізньої	1
упал	впав	упав	1
оставалось	лишалося	залишалося	1
как	як	якби	1
приготовил	налаштував	приготував	1
проходите	проходите	проходьте	1
огонь	вогонь	вогню	1
ключом	ключем	ключом	1
начнем	почнемо	почнімо	1
почини	години	годинник	1
что	що	ще	1
закончились	закінчилися	закінчились	1
могу	можу	можна	1
персидский	перський	перська	1
время	пора	покаже	1
композитора	руського	російського	1
не	не	де	1
открывать	відкривати	відчиняти	1
удовлетворить	задовольнити	задовільнити	1
автобусе	автобусі	автобусом	1
больной	хворою	хворий	1
река	ріка	річка	1
нужен	потрібний	потрібним	1
слишком	запізно	пізно	1
–	зробити	робити	1
.	собаці	собаку	1
твоей	твоєї	твою	1
страшно	страшно	страшенно	1
временное	тимчасове	тимчасова	1
ушли	цігроші	гроші	1
останусь	лишуся	залишусь	1
сесть	сісти	всістися	1
смейтесь	сміяйтеся	смійтеся	1
родного	рідного	власного	1
открыть	відкрити	відчинити	1
плачем	плачем	плачемо	1
при	прі	при	1
лист	листя	лист	1
держите	тримаєте	тримайте	1
мозга	мозку	мозок	1
нет	яхта	яхті	1
на	на	нема	1
я	початку	спочатку	1
песенном	пісеннім	пісенному	1
эту	зустріну	зустріч	1
не	не	не"	1
``	``	``"	1
папа	тато	тату	1
делаешь	робиш	робитимеш	1
слышишь	чуєш	чуєте	1
велосипед	йоговелосипед	велосипед	1
почему	це	не	1
скорость	значуще	значно	1
дочери	їїдочки	дочки	1
прекрасной	прекрасної	прекрасним	1
усилий	їїзусиль	зусиль	1
учёные	учені	вчені	1
всех	всі	всіх	1
поменял	поміняв	проміняв	1
написано	написане	написано	1
страсть	мояпристрасть	пристрасть	1
деньги	гроші	грошей	1
кладбища	цвинтарі	цвинтаря	1
не	не	ну	1
езды	хвиль	хвилин	1
убийца	убивця	вбивця	1
ценные	цінні	цінний	1
!	тяжка	важка	1
оперы	опери	"опери	1
вспомнил	пригадав	згадав	1
удивило	здивувало	здивувала	1
мостик	місток	мостик	1
норма	норма	нoрмa	1
минский	мінський	міська	1
пока	поки	доки	1
японии	японії	японію	1
вспоминать	пригадувати	згадувати	1
.	води	воду	1
мальчик	хлопчик	хлопець	1
театр	театр	театру	1
прячется	ховає	ховається	1
уважение	повага	повагу	1
вокзала	хвиль	хвилин	1
голландского	голландського	голландської	1
оставаться	лишатися	залишатися"	1
повернись	повернися	повернись	1
девушка	цядівчина	дівчина	1
любят	люблять	любить	1
ощущал	відчував	почував	1
бегает	моясестра	сестра	1
один	один	наодинці	1
ангела	ангела	янгола	1
французского	французького	французьку	1
audley	audley	auldey	1
деньгами	грішми	грошами	1
экономично	економічно	економно	1
остались	лишилися	лишились	1
бессильный	безсилий	безсильний	1
своим	своїм	свого	1
должны	скляний	скляних	1
иди	йди	ди	1
кратко	коротке	коротко	1
стояла	стояла	стояв	1
зимой	зимою	узимку	1
вы	готелі	готелю	1
мари	їїзавдання	завдання	1
внимания	уваги	увагу	1
думаете	думаєте	гадаєте	1
советов	рад	порад	1
загадку	цюзагадку	загадку	1
занимаюсь	займаюся	займаюсь	1
много	багато	небагато	1
приготовим	налаштуємо	приготуємо	1
идти	йти	піти	1
откуда	звідки	звідкіля	1
французским	французьким	французькою	1
вообще	взагалі	узагалі	1
пиццу	поділи	розділи	1
бесплатная	безплатна	безкоштовна	1
это	це	не	1
небу	небу	небом	1
встрече	зустрічі	зустріч	1
сажает	саджає	садить	1
делается	робить	робиться	1
