теннис	*теннис	теніс	14
взять	*взять	взяти	14
файоло	*файоло	файоло	12
мистер	*мистер	містер	12
поехал	*поехал	поїхав	12
пить	*пить	пити	11
рано	*рано	рано	11
плавать	*плавать	плавати	11
эсперанто	*эсперанто	есперанто	11
наши	*наши	наші	11
дезмонд	*дезмонд	десмонд	10
меленянах	*меленянах	меленянах	10
ласло	*ласло	лазло	10
читать	*читать	читати	10
дверь	*дверь	двері	9
ваших	*ваших	ваших	9
домой	*домой	додому	9
вернусь	*вернусь	повернуся	9
изучать	*изучать	вивчати	9
поехать	*поехать	поїхати	9
боится	*боится	боїться	9
вернулся	*вернулся	повернувся	9
последний	*последний	останній	8
рад	*рад	радий	8
скучаю	*скучаю	сумую	8
жирка	*жирка	жирку	8
ваши	*ваши	ваші	8
нашем	*нашем	нашому	8
женился	*женился	одружився	7
геттер	*геттер	геттер	7
выглядишь	*выглядишь	виглядаєш	7
робинзон	*робинзон	робінзон	7
касабланке	*касабланке	касабланці	7
нашей	*нашей	нашої	7
нью-йорке	*нью-*йорке	нью-йорку	7
боюсь	*боюсь	боюся	7
америке	*америке	америці	7
японец	*японец	японець	6
чашку	*чашку	чашку	6
мадам	*мадам	мадам	6
ненавижу	*ненавижу	ненавиджу	6
читаю	*читаю	читаю	6
наша	*наша	наша	6
вернётся	*вернётся	повернеться	6
петр	*петр	петре	6
сэм	*сэм	семе	6
завтрашнего	*завтрашнего	завтрашнього	6
жирка	*жирка	жирко	6
комары	*комары	комарі	6
попробуй	*попробуй	спробуй	6
помню	*помню	пам'ятаю	6
взял	*взял	взяв	6
интернете	*интернете	інтернеті	6
тони	*тони	тоні	6
проснулся	*проснулся	прокинувся	6
ваш	*ваш	ваш	6
нашим	*нашим	нашим	6
похожи	*похожи	схожі	6
поговорить	*поговорить	поговорити	6
столько	*столько	стільки	6
плакала	*плакала	плакала	5
изучить	*изучить	вивчити	5
троих	*троих	трьох	5
вышел	*вышел	вийшов	5
шкафу	*шкафу	шафі	5
наше	*наше	наше	5
подумать	*подумать	подумати	5
водить	*водить	водити	5
украли	*украли	вкрали	5
бывает	*бывает	буває	5
вашего	*вашего	вашого	5
старше	*старше	старіший	5
возьми	*возьми	візьми	5
эй	*эй	гей	5
доволен	*доволен	задоволений	5
первобытный	*первобытный	первісна	5
понтон	*понтон	понтон	5
гордон	*гордон	гордон	5
америки	*америки	америки	5
придурок	*придурок	придурок	5
вернется	*вернется	повернеться	5
обожает	*обожает	обожнює	5
бездянка	*бездянка	бездянка	5
встаю	*встаю	встаю	5
незнакомец	*незнакомец	незнайомець	5
мег	*мег	мег	5
джим	*джим	джим	5
поймал	*поймал	спіймав	5
магнитофон	*магнитофон	магнітофон	4
яблочный	*яблочный	яблучний	4
марки	*марки	марки	4
дочитал	*дочитал	дочитав	4
лыжах	*лыжах	лижах	4
гитаре	*гитаре	гітарі	4
валентино	*валентино	валентино	4
пальто	*пальто	пальто	4
пианино	*пианино	піаніно	4
ланд	*ланд	лунд	4
нидерланды	*нидерланды	нідерланди	4
жарко	*жарко	спекотно	4
рено	*рено	рено	4
франция	*франция	франція	4
сладкий	*сладкий	солодкий	4
сэр	*сэр	сер	4
ударила	*ударила	вдарила	4
потерялся	*потерялся	загубився	4
рыбалку	*рыбалку	рибалити	4
вашу	*вашу	вашу	4
футов	*футов	футів	4
свитер	*свитер	светр	4
блажеи	*блажеи	блажеї	4
вышла	*вышла	вийшла	4
бейсбол	*бейсбол	бейсбол	4
гольф	*гольф	гольф	4
несла	*несла	несла	4
шейфер	*шейфер	шефер	4
нэнси	*нэнси	ненсі	4
бэтти	*бэтти	бетті	4
плакать	*плакать	плакати	4
выглядит	*выглядит	виглядає	4
кен	*кен	кен	4
кейт	*кейт	кейт	4
сфотографировать	*сфотографировать	сфотографувати	4
головы	*головы	голови	4
мюриэл	*мюриэл	мюріел	4
воспользоваться	*воспользоваться	скористатися	4
двери	*двери	двері	4
старше	*старше	старший	4
ехать	*ехать	їхати	4
гордится	*гордится	пишається	4
братиславе	*братиславе	братиславі	4
франков	*франков	франків	4
лежит	*лежит	лежить	4
танцевала	*танцевала	танцювала	4
ричард	*ричард	річард	4
трубку	*трубку	слухавку	4
угодно	*угодно	завгодно	4
ваше	*ваше	ваше	4
париж	*париж	париж	4
петя	*петя	пєтя	4
львове	*львове	львів	4
хотелось	*хотелось	хотілося	4
клади	*клади	клади	4
хоккайдо	*хоккайдо	хоккайдо	4
светится	*светится	світиться	4
шоколадное	*шоколадное	шоколадне	4
бетти	*бетти	бетті	4
мухи	*мухи	мухи	4
лучший	*лучший	найкращий	4
волнуйся	*волнуйся	хвилюйся	4
жениться	*жениться	одружитися	4
коротка	*коротка	коротке	4
арти	*арти	арті	3
водоросли	*водоросли	водорості	3
беле	*беле	белі	3
кататься	*кататься	кататися	3
просыпаетесь	*просыпаетесь	прокидаєшся	3
одолжить	*одолжить	позичити	3
тратишь	*тратишь	витрачаєш	3
ближайшая	*ближайшая	найближча	3
влюбился	*влюбился	закохався	3
напрокат	*напрокат	напрокат	3
вставать	*вставать	вставати	3
мокрое	*мокрое	мокрого	3
необходимо	*необходимо	необхідно	3
поплаваем	*поплаваем	поплаваємо	3
новоявленный	*новоявленный	новоспечена	3
тихом	*тихом	тихому	3
казани	*казани	казані	3
улыбнулась	*улыбнулась	посміхнулася	3
грязные	*грязные	брудне	3
успеть	*успеть	встигнути	3
буханку	*буханку	буханця	3
белиной	*белиной	белиної	3
мари	*мари	марі	3
простудился	*простудился	застудився	3
менее	*менее	менш	3
замужем	*замужем	одружена	3
деном	*деном	деном	3
последнюю	*последнюю	останню	3
удалось	*удалось	вдалося	3
клином	*клином	клином	3
встаёт	*встаёт	встає	3
вырастила	*вырастила	виростила	3
наполеона	*наполеона	наполеона	3
пташки	*пташки	пташки	3
белу	*белу	белу	3
майк	*майк	майк	3
вечность	*вечность	вічність	3
австралии	*австралии	австралії	3
украл	*украл	вкрав	3
плыть	*плыть	плисти	3
долькой	*долькой	долькою	3
болит	*болит	болить	3
альто	*альто	альто	3
приемник	*приемник	приймач	3
двоичная	*двоичная	двоїчне	3
феррари	*феррари	феррарі	3
купаться	*купаться	купатись	3
буй	*буй	буй	3
ванной	*ванной	ванній	3
нашей	*нашей	нашій	3
иван	*иван	іван	3
анджей	*анджей	анджей	3
наш	*наш	наша	3
кобыла	*кобыла	кобила	3
мост	*мост	міст	3
пикник	*пикник	пікнік	3
наверстать	*наверстать	надолужити	3
ржаветь	*ржаветь	ржавіти	3
уладьте	*уладьте	владнайте	3
грозовыми	*грозовыми	горобині	3
сани	*сани	сани	3
поспать	*поспать	поспати	3
гусеница	*гусеница	гусениця	3
простые	*простые	прості	3
полной	*полной	повної	3
танцевал	*танцевал	танцював	3
перезвоню	*перезвоню	передзвоню	3
летать	*летать	літати	3
опиум	*опиум	опіум	3
танцует	*танцует	танцює	3
похолодает	*похолодает	похолодає	3
бывал	*бывал	бував	3
синим	*синим	синіх	3
приложиться	*приложиться	прикластися	3
голову	*голову	голову	3
ваш	*ваш	ваша	3
презирать	*презирать	зневажати	3
джейн	*джейн	джейн	3
колумб	*колумб	колумб	3
тише	*тише	тихіше	3
просить	*просить	просити	3
потребуется	*потребуется	знадобиться	3
домовладелец	*домовладелец	домовласник	3
ах	*ах	ах	3
женат	*женат	одружений	3
таневич	*таневич	танєвич	3
потеряла	*потеряла	втратила	3
целый	*целый	цілий	3
парижа	*парижа	парижа	3
зубную	*зубную	зубну	3
кимоно	*кимоно	кімоно	3
светит	*светит	світить	3
покататься	*покататься	проїхатися	3
атласе	*атласе	атласі	3
всякое	*всякое	всяке	3
красивая	*красивая	красива	3
узбекскую	*узбекскую	узбецьку	3
мороженое	*мороженое	морозиво	3
диалект	*диалект	діалект	3
устроитесь	*устроитесь	приживетесь	3
полного	*полного	повного	3
отключил	*отключил	відключив	3
прошу	*прошу	перепрошую	3
дворовый	*дворовый	дворовий	3
просыпаются	*просыпаются	прокидаються	3
касабланки	*касабланки	касабланки	3
антенны	*антенны	антени	3
спальни	*спальни	спальні	3
синее	*синее	синє	3
сумерках	*сумерках	сутінках	3
командный	*командный	командний	3
лиллиэн	*лиллиэн	лілліен	3
мило	*мило	міло	3
испекла	*испекла	приготувала	3
выпал	*выпал	випав	3
пропустить	*пропустить	пропустити	3
зацветёт	*зацветёт	заквітне	3
люси	*люси	люсі	3
меряет	*меряет	міряє	3
клубе	*клубе	клубі	3
геттер	*геттер	ґеттер	3
пахнет	*пахнет	пахне	3
тернии	*тернии	терни	3
проник	*проник	проникнув	3
читал	*читал	читав	3
вкусно	*вкусно	смачно	3
слепая	*слепая	сліпа	3
билл	*билл	біл	3
буди	*буди	буди	3
празднуется	*празднуется	святкується	3
зелёной	*зелёной	зеленою	3
понадобится	*понадобится	знадобиться	3
сербии	*сербии	сербії	3
коул	*коул	коул	3
врун	*врун	брехун	3
сноповяза	*сноповяза	скиртяра	3
виноват	*виноват	винен	3
непрактичности	*непрактичности	непрактичності	3
похож	*похож	схожий	3
выпорхнет	*выпорхнет	випорхне	3
яна	*яна	яна	3
гилис	*гилис	джилліс	3
пожениться	*пожениться	одружитися	3
наших	*наших	наших	3
горит	*горит	горить	3
чёрного	*чёрного	чорного	3
смокинг	*смокинг	смокінг	3
плывем	*плывем	пливемо	3
несчастную	*несчастную	нещасне	3
сандаю	*сандаю	сандаю	3
отправляется	*отправляется	відправляється	3
гулять	*гулять	гуляти	3
испекла	*испекла	спекла	3
проще	*проще	простіше	3
сыграй	*сыграй	зіграй	3
америку	*америку	америки	3
ближайшем	*ближайшем	найближчому	3
ошибся	*ошибся	помилився	3
ездит	*ездит	їздить	3
вашему	*вашему	вашому	3
генеалогическое	*генеалогическое	генеалогічне	3
волнуюсь	*волнуюсь	хвилююся	3
ледников	*ледников	льодовиків	3
юми	*юми	юмі	3
бездянке	*бездянке	бездянці	3
различить	*различить	розрізнити	2
носороги	*носороги	носороги	2
иву	*иву	вербу	2
ожеребилась	*ожеребилась	ожеребилася	2
красивы	*красивы	красиві	2
ароматом	*ароматом	пахощами	2
ирвинг	*ирвинг	івінґ	2
трилобита	*трилобита	трилобіта	2
пальме	*пальме	пальмі	2
язычество	*язычество	язичництво	2
вылечил	*вылечил	вилікував	2
вертится	*вертится	крутиться	2
тратьте	*тратьте	втрачайте	2
прямом	*прямом	повному	2
мамонты	*мамонты	мамонти	2
впадала	*впадала	впадала	2
познаются	*познаются	пізнаються	2
провалился	*провалился	провалилася	2
поклонница	*поклонница	шанувальниця	2
годится	*годится	годиться	2
стараются	*стараются	стараються	2
молод	*молод	молодий	2
шип	*шип	шип	2
красивые	*красивые	красиві	2
хедда	*хедда	гедда	2
фаршад	*фаршад	фаршад	2
рукав	*рукав	притримував	2
пышный	*пышный	пишний	2
прилипла	*прилипла	черевика	2
вымыть	*вымыть	вимити	2
раздражительный	*раздражительный	роздратованою	2
залезешь	*залезешь	залізеш	2
наше	*наше	наша	2
жирке	*жирке	жиркові	2
удалить	*удалить	видалити	2
перерезать	*перерезать	перерізувати	2
облачно	*облачно	хмарно	2
подвинуть	*подвинуть	посунути	2
спорили	*спорили	сперечалися	2
хоппер	*хоппер	хоппер	2
черный	*черный	чорний	2
неверных	*неверных	невірні	2
вышли	*вышли	вийшли	2
китая	*китая	китаю	2
маркс	*маркс	маркс	2
ичиро	*ичиро	ічіро	2
силурийского	*силурийского	силурійського	2
клин	*клин	клин	2
никакого	*никакого	ніякого	2
шваба	*шваба	шваба	2
беларуси	*беларуси	білорусі	2
практичность	*практичность	практичність	2
паста	*паста	паста	2
злиться	*злиться	гніватися	2
керамикой	*керамикой	керамікою	2
переносили	*переносили	переносили	2
батут	*батут	батут	2
хуй	*хуй	хуй	2
ракетку	*ракетку	ракетку	2
путин	*путин	путін	2
доисторической	*доисторической	доісторичній	2
ранние	*ранние	ранні	2
голливудский	*голливудский	голівудська	2
удачи	*удачи	вдачі	2
порвано	*порвано	розірвана	2
искупаться	*искупаться	купатись	2
прыгай	*прыгай	отрибай	2
покрыт	*покрыт	покрита	2
оглянись	*оглянись	подивись	2
караоке	*караоке	караоке	2
джонсон	*джонсон	джонсон	2
нептун	*нептун	нептун	2
спешу	*спешу	поспішаю	2
безумцу	*безумцу	безумцеві	2
берите	*берите	беріть	2
подскользнитесь	*подскользнитесь	посковзніться	2
эстонской	*эстонской	естонській	2
лихо	*лихо	лихо	2
оран	*оран	орана	2
выкрутить	*выкрутить	викрутити	2
возница	*возница	візник	2
черепаху	*черепаху	черепаху	2
одевайтесь	*одевайтесь	вдягайтесь	2
грааль	*грааль	грааль	2
ёко	*ёко	йоко	2
окунуть	*окунуть	скупати	2
саша	*саша	саша	2
одета	*одета	одягнена	2
будит	*будит	будить	2
жирки	*жирки	жирка	2
весили	*весили	важили	2
выхлопными	*выхлопными	вихлопними	2
склонен	*склонен	схильний	2
поговорим	*поговорим	поговоримо	2
марсель	*марсель	марселя	2
баскетбол	*баскетбол	баскетбол	2
топор	*топор	сокира	2
евангелина	*евангелина	євангеліна	2
мистером	*мистером	містером	2
расслабиться	*расслабиться	розслабитися	2
телевизорные	*телевизорные	телевізійні	2
сияющими	*сияющими	сяючими	2
братиславу	*братиславу	братиславу	2
мыть	*мыть	мити	2
нюнорска	*нюнорска	нюношку	2
венецию	*венецию	венеції	2
выглядят	*выглядят	виглядає	2
фред	*фред	фред	2
танака	*танака	танака	2
комары	*комары	комари	2
теннисную	*теннисную	тенісну	2
танабата	*танабата	танабата	2
исписал	*исписал	списав	2
наливай	*наливай	наливай	2
леплю	*леплю	ліплю	2
весёлого	*весёлого	веселого	2
шапку	*шапку	шапку	2
петра	*петра	петра	2
кассетный	*кассетный	касетний	2
горько	*горько	гірко	2
терплю	*терплю	переношу	2
древние	*древние	давні	2
апельсины	*апельсины	апельсини	2
ваше	*ваше	вашу	2
пообедали	*пообедали	пообідали	2
транслитерацию	*транслитерацию	транслітерацію	2
берн	*берн	берн	2
промокли	*промокли	намокли	2
мавр	*мавр	мавр	2
младшей	*младшей	молодшою	2
фоторобот	*фоторобот	фоторобот	2
бледным	*бледным	блідим	2
отрубил	*отрубил	відрубав	2
булочной	*булочной	хлібному	2
нравы	*нравы	наших	2
уподобляйся	*уподобляйся	уподібнюйся	2
грабли	*грабли	граблі	2
мачете	*мачете	мачете	2
кругосветное	*кругосветное	навколосвітню	2
избавиться	*избавиться	позбутися	2
отче	*отче	отче	2
закурить	*закурить	закурити	2
поменяетесь	*поменяетесь	поміняєтесь	2
особа	*особа	особою	2
техас	*техас	техас	2
типичный	*типичный	типовий	2
томатным	*томатным	томатним	2
трёх	*трёх	трьома	2
нашу	*нашу	нашу	2
недомогание	*недомогание	нездужання	2
разрушили	*разрушили	зруйнували	2
исправишь	*исправишь	виправиш	2
нептуна	*нептуна	нептуна	2
ошибиться	*ошибиться	помилитися	2
мертвый	*мертвый	мертвий	2
ильзу	*ильзу	ільзу	2
вернитесь	*вернитесь	повертайтесь	2
припев	*припев	приспів	2
джуди	*джуди	джуді	2
небольшой	*небольшой	невеличку	2
пота	*пота	поту	2
радостный	*радостный	радісний	2
гей	*гей	ґей	2
лошади	*лошади	ненадовго	2
девятичасовой	*девятичасовой	десятигодинний	2
отцвели	*отцвели	відцвіли	2
банное	*банное	банний	2
мороженых	*мороженых	морозива	2
чудесное	*чудесное	чудове	2
окончил	*окончил	закінчив	2
растерялся	*растерялся	розгубився	2
токийский	*токийский	токійський	2
обое	*обое	обоє	2
задаёт	*задаёт	задає	2
понтона	*понтона	понтону	2
починить	*починить	полагодити	2
хорхе	*хорхе	хорхе	2
соленая	*соленая	солона	2
мия	*мия	мія	2
шнайдером	*шнайдером	шнайдером	2
настанет	*настанет	настане	2
бирюза	*бирюза	бірюза	2
тайфун	*тайфун	тайфун	2
товарного	*товарного	товарного	2
полная	*полная	повна	2
нашему	*нашему	нашій	2
опоздаешь	*опоздаешь	спізнишся	2
протоптали	*протоптали	протоптали	2
вашу	*вашу	ваших	2
тратят	*тратят	марнують	2
сладко	*сладко	солодко	2
анжелика	*анжелика	анжеліка	2
неспокойно	*неспокойно	неспоійно	2
нарита	*нарита	наріта	2
грина	*грина	гріна	2
москве	*москве	москви	2
убираться	*убираться	прибирати	2
пробежал	*пробежал	пробіг	2
кодировка	*кодировка	кодування	2
будите	*будите	будіть	2
необходим	*необходим	необхідний	2
караулить	*караулить	чатувати	2
карл	*карл	карл	2
поменялась	*поменялась	помінялася	2
неразглашении	*неразглашении	нерозголошення	2
грабитель	*грабитель	грабіжник	2
нара	*нара	нара	2
обследован	*обследован	досліджено	2
висит	*висит	висить	2
понадобиться	*понадобиться	знадобитися	2
пришей	*пришей	приший	2
тряпкой	*тряпкой	слимаком	2
фриман	*фриман	фріман	2
шуми	*шуми	шуми	2
гилис	*гилис	гілліс	2
мадмуазель	*мадмуазель	мадемуазель	2
дастин	*дастин	дастін	2
уехал	*уехал	поїхав	2
утрачено	*утрачено	втрачений	2
ручья	*ручья	струмка	2
префекта	*префекта	префекта	2
взял	*взял	узяв	2
джунглях	*джунглях	джунглях	2
установили	*установили	встановили	2
антоним	*антоним	антонім	2
присутствовало	*присутствовало	присутньо	2
хуйня	*хуйня	хуйня	2
наклонилась	*наклонилась	нахилилася	2
специально	*специально	спеціально	2
барс	*барс	барс	2
паша	*паша	павло	2
красива	*красива	красива	2
поиграем	*поиграем	пограймо	2
меленянах	*меленянах	меленяни	2
переспал	*переспал	переспав	2
бибер	*бибер	бібер	2
кончается	*кончается	закінчується	2
платон	*платон	платон	2
ванг	*ванг	ванг	2
нижней	*нижней	нижній	2
ужарил	*ужарил	вдарив	2
потеряешь	*потеряешь	втеряєш	2
тушкан	*тушкан	тушкан	2
поделилась	*поделилась	поділилася	2
повезло	*повезло	пощастило	2
выйдешь	*выйдешь	вийдеш	2
прощай	*прощай	бувай	2
лифтовой	*лифтовой	ліфтовий	2
монро	*монро	монро	2
понтону	*понтону	понтону	2
нидо	*нидо	нідо	2
признался	*признался	зізнався	2
ильза	*ильза	ільза	2
уныла	*уныла	нудна	2
ибрагим	*ибрагим	ібрагім	2
ненавидела	*ненавидела	ненавиділа	2
прошу	*прошу	прошу	2
перец	*перец	перець	2
шерман	*шерман	шерман	2
атаковал	*атаковал	атакував	2
джозеф	*джозеф	джозеф	2
затаив	*затаив	затамувавши	2
гилисом	*гилисом	джиллісом	2
щётку	*щётку	щітку	2
блажей	*блажей	блажей	2
сиськи	*сиськи	цицьок	2
джордж	*джордж	джордж	2
разбивает	*разбивает	розбиває	2
покореженное	*покореженное	понівечене	2
обязательно	*обязательно	"обов'язково	2
становились	*становились	ставали	2
сеньора	*сеньора	сеньйора	2
шанхайский	*шанхайский	шанхайський	2
наручные	*наручные	наручний	2
твиттер	*твиттер	твітер	2
успел	*успел	встиг	2
сенная	*сенная	сінна	2
переговоров	*переговоров	перемовин	2
средиземном	*средиземном	середземному	2
блевотины	*блевотины	блювотиння	2
смеешь	*смеешь	смієш	2
застегни	*застегни	застібни	2
христофор	*христофор	христофор	2
поступил	*поступил	вступив	2
прогулялись	*прогулялись	прогулялися	2
утки	*утки	качки	2
режут	*режут	ріжуть	2
маркони	*маркони	марконі	2
афины	*афины	афін	2
годится	*годится	користним	2
классно	*классно	смачно	2
встал	*встал	встав	2
блейн	*блейн	блейн	2
уходит	*уходит	виходить	2
звонила	*звонила	телефонувала	2
проложил	*проложил	проклала	2
пиклз	*пиклз	піклз	2
нудным	*нудным	нудним	2
паразитирую	*паразитирую	паразитую	2
линда	*линда	лінда	2
привидения	*привидения	привидів	2
измерь	*измерь	зміряй	2
мэрилин	*мэрилин	мерілін	2
исияма	*исияма	ісіяма	2
шестидесятилетний	*шестидесятилетний	шестидесятирічний	2
маток	*маток	маток	2
полную	*полную	наповнену	2
фал	*фал	фал	2
каникул	*каникул	канікули	2
готовься	*готовься	готуйся	2
поженились	*поженились	одружилися	2
машинистом	*машинистом	машиністом	2
ваших	*ваших	вашу	2
заводишься	*заводишься	заводишся	2
водил	*водил	водив	2
коелодонт	*коелодонт	коелодонт	2
угощайся	*угощайся	пригощайся	2
болтай	*болтай	хитай	2
дориана	*дориана	доріана	2
шекспире	*шекспире	шекспіра	2
пани	*пани	пані	2
последняя	*последняя	останній	2
непрактичное	*непрактичное	непрактична	2
джека	*джека	джека	2
гадкий	*гадкий	гидке	2
побрил	*побрил	поголив	2
холоднокровные	*холоднокровные	холоднокровні	2
носит	*носит	носить	2
бить	*бить	бити	2
блейн	*блейн	блейне	2
вежливым	*вежливым	ввічливий	2
великим	*великим	великим	2
египтяне	*египтяне	єгиптяни	2
блокнота	*блокнота	блокноти	2
джеймс	*джеймс	джеймс	2
унаследовал	*унаследовал	успадкував	2
кошечку	*кошечку	кошеня	2
воевала	*воевала	воювала	2
больший	*больший	більший	2
древо	*древо	дерево	2
мономорфизм	*мономорфизм	мономорфізм	2
помоне	*помоне	помоні	2
анкару	*анкару	анкару	2
пойдемте	*пойдемте	пливемо	2
женда	*женда	жендо	2
зеландии	*зеландии	зеландії	2
ножницы	*ножницы	ножиці	2
опаздывал	*опаздывал	запізнювався	2
бегает	*бегает	бігає	2
капельки	*капельки	краплини	2
темнеет	*темнеет	темніє	2
кэти	*кэти	кеті	2
нездоровая	*нездоровая	нездорова	2
нил	*нил	нил	2
понравилась	*понравилась	сподобалась	2
джойс	*джойс	джойс	2
микробам	*микробам	мікробам	2
потеплее	*потеплее	тепліше	2
сбил	*сбил	збило	2
ошиблись	*ошиблись	помилились	2
трусов	*трусов	боягузів	2
медикаменты	*медикаменты	медикаменти	2
жюля	*жюля	жюля	2
сверкнула	*сверкнула	блиснула	2
дима	*дима	діма	2
успокоиться	*успокоиться	запокоїтись	2
адама	*адама	адама	2
твёрже	*твёрже	твердішого	2
сзади	*сзади	позаду	2
женятся	*женятся	одружуються	2
миннесоте	*миннесоте	мінесоті	2
фрак	*фрак	фрак	2
плитках	*плитках	плиткам	2
левую	*левую	ліву	2
метла	*метла	мітла	2
меленяны	*меленяны	меленяни	2
рябое	*рябое	рабоє	2
апартаменты	*апартаменты	апартаменти	2
постучал	*постучал	постукав	2
обязательно	*обязательно	обов'язково	2
заплакала	*заплакала	заплакала	2
несчастный	*несчастный	нещасний	2
лос-анджелес	*лос-*анджелес	лос-анжелеса	2
потеряно	*потеряно	втрачено	2
проглотить	*проглотить	проковтнути	2
пелёнках	*пелёнках	пелюшках	2
возьму	*возьму	візьму	2
споём	*споём	заспіваємо	2
поиграть	*поиграть	погратись	2
лилли	*лилли	ліллі	2
выпрашивать	*выпрашивать	випрошувати	2
соусом	*соусом	соусом	2
шкафах	*шкафах	шафі	2
униформа	*униформа	уніформа	2
подумай	*подумай	подумай	2
меленяны	*меленяны	меленян	2
кюрасао	*кюрасао	кюрасао	2
иве	*иве	вербі	2
сибуе	*сибуе	сібуя	2
руми	*руми	румі	2
пощупал	*пощупал	пощупав	2
противоположность	*противоположность	протилежність	2
ржавым	*ржавым	іржавим	2
джеком	*джеком	джека	2
танцевать	*танцевать	танцювати	2
приемнике	*приемнике	приймач	2
батьку	*батьку	батька	2
америки	*америки	америку	2
компактную	*компактную	компактну	2
полной	*полной	повній	2
банкет	*банкет	бенкет	2
ваша	*ваша	ваш	2
джерри	*джерри	джері	2
чертят	*чертят	черкають	2
жрать	*жрать	жерти	2
величайших	*величайших	найвидатніших	2
познакомился	*познакомился	познайомився	2
запакуй	*запакуй	запакуйте	2
никакого	*никакого	жодного	2
камина	*камина	каміна	2
ручей	*ручей	струмок	2
настроек	*настроек	налаштувань	2
сара	*сара	сара	2
поклялся	*поклялся	присягнув	2
боюсь	*боюсь	боюсь	2
банан	*банан	банан	2
грей	*грей	грій	2
грей	*грей	ґрей	2
сойти	*сойти	вийти	2
спросить	*спросить	спитати	2
мародеры	*мародеры	мародери	2
починил	*починил	поремонтував	2
варьируется	*варьируется	коливається	2
марок	*марок	марок	2
львов	*львов	львова	2
доживёт	*доживёт	доживе	2
станислав	*станислав	станіслав	2
советолог	*советолог	радянолог	2
уснуть	*уснуть	заснути	2
угарте	*угарте	угарте	2
кенгуру	*кенгуру	кенгуру	2
жутко	*жутко	сумую	2
богдан	*богдан	богдан	2
мочить	*мочить	мочити	2
мороженное	*мороженное	морозиво	2
неразумно	*неразумно	нерозумно	2
автобусной	*автобусной	автобусної	2
справится	*справится	впорається	2
карл	*карл	карле	2
забронировала	*забронировала	забронювала	2
кена	*кена	кена	2
дударева	*дударева	дударева	2
вашингтон	*вашингтон	вашингтон	2
малейшего	*малейшего	найменшого	2
купаюсь	*купаюсь	купаюся	2
поехала	*поехала	поїхала	2
минутку	*минутку	хвилинку	2
мексикой	*мексикой	мексикою	2
дядька	*дядька	дядько	2
ледниковом	*ледниковом	льодовиковому	2
мери	*мери	мері	2
полна	*полна	повен	2
летают	*летают	літають	2
запирается	*запирается	замикається	2
саша	*саша	сашко	2
закурить	*закурить	запалити	2
ехать	*ехать	поїхати	2
поступят	*поступят	вступлять	2
юбки	*юбки	спіднички	2
брать	*брать	брати	2
америку	*америку	америку	2
телёнок	*телёнок	телятко	2
блузка	*блузка	блуза	2
зрелая	*зрелая	зріла	2
антикватис	*антикватис	антікватіс	2
протрезел	*протрезел	протверезів	2
пауков	*пауков	павуків	2
кожная	*кожная	шкырний	2
выбивают	*выбивают	вишибають	2
париж	*париж	парижу	2
починил	*починил	полагодив	2
читает	*читает	читає	2
попробуем	*попробуем	спробуємо	2
пью	*пью	п'ю	2
нью-йорка	*нью-*йорка	нью-йорка	2
гей	*гей	голубий	2
размножаться	*размножаться	розмножуватися	2
брунцвик	*брунцвик	брунцвік	2
молодой	*молодой	молодий	2
грея	*грея	грея	2
социальная	*социальная	соціальна	2
ругайся	*ругайся	лайся	2
бездарь	*бездарь	нездара	2
липла	*липла	липув	2
зародилась	*зародилась	зародилася	2
большущий	*большущий	величезний	2
волнуется	*волнуется	хвилюється	2
ричард	*ричард	річарде	2
возницы	*возницы	візника	2
синий	*синий	синій	2
придти	*придти	прийти	2
возлюби	*возлюби	полюби	2
выйти	*выйти	вийти	2
вместо	*вместо	замість	2
бе	*бе	бе	2
одноклассников	*одноклассников	однокласників	2
поужинаете	*поужинаете	повечеряєте	2
низине	*низине	низині	2
польше	*польше	польщі	2
приметы	*приметы	прикмети	2
разбуди	*разбуди	розбуди	2
последнее	*последнее	останнім	2
ясное	*ясное	ясна	2
помине	*помине	промовка	2
сортирах	*сортирах	сортирах	2
ни	*ни	ані	2
дурость	*дурость	дурня	2
толерантным	*толерантным	толерантним	2
японцы	*японцы	японці	2
джил	*джил	джил	2
пареной	*пареной	простого	2
джастин	*джастин	джастін	2
поливает	*поливает	поливає	2
помолчи	*помолчи	помовчи	2
японка	*японка	японка	2
несчастных	*несчастных	нещасних	2
старательно	*старательно	старанно	2
математическая	*математическая	математична	2
берлине	*берлине	берліні	2
вернулся	*вернулся	вернувся	2
несчастные	*несчастные	нещасні	2
дешевле	*дешевле	дешевший	2
лиза	*лиза	ліза	2
поехали	*поехали	поїхали	2
черешня	*черешня	черешня	2
советолог	*советолог	совєтолог	2
богата	*богата	багата	2
попросил	*попросил	попросив	2
джинсам	*джинсам	джинсів	2
пари	*пари	парі	2
зелёный	*зелёный	зелений	2
потрясающе	*потрясающе	потрясно	2
форматировать	*форматировать	форматувати	2
познакомились	*познакомились	познайомилися	2
подвозите	*подвозите	підвозите	2
выколи	*выколи	виколи	2
гналась	*гналась	гналася	2
доберусь	*доберусь	доберуся	2
спорить	*спорить	сперечатись	2
сломались	*сломались	зламався	2
ближнего	*ближнего	ближнього	2
примерно	*примерно	приблизно	2
задавать	*задавать	ставити	2
высмеивать	*высмеивать	висміювати	2
аккаунт	*аккаунт	акаунт	2
крестный	*крестный	хресний	2
неверным	*неверным	невірним	2
покрасили	*покрасили	пофарбували	2
подружились	*подружились	потоваришували	2
карфаген	*карфаген	карфаген	2
спальне	*спальне	спальні	2
оденемся	*оденемся	одягнутись	2
львов	*львов	львів	2
спится	*спится	спиться	2
свободными	*свободными	вільними	2
бабушка	*бабушка	бабуся	2
руа	*руа	руа	2
жарко	*жарко	жарко	2
буддизм	*буддизм	буддизм	2
чая	*чая	чаю	2
катя	*катя	катя	2
моста	*моста	мосту	2
рассвело	*рассвело	розвиднілося	2
формалистской	*формалистской	формалістичною	2
амазонка	*амазонка	амазонка	2
смит	*смит	сміт	2
наилучший	*наилучший	найкращий	2
пересказываю	*пересказываю	переказую	2
просыпаюсь	*просыпаюсь	прокидаюся	2
скучать	*скучать	скучатиму	2
омуте	*омуте	болоті	2
побуду	*побуду	побуду	2
приготовимся	*приготовимся	приготуємось	2
укрыта	*укрыта	накрита	2
мицкевича	*мицкевича	міцкевича	2
просим	*просим	просимо	2
московиц	*московиц	московиц	2
барахлит	*барахлит	барахлить	2
симпатичная	*симпатичная	симпатична	2
ружьё	*ружьё	рушницю	2
микроскопом	*микроскопом	мікроскопом	2
убежала	*убежала	втекла	2
сверчок	*сверчок	цвіркун	2
дышу	*дышу	дишу	2
лимон	*лимон	лимон	2
спеть	*спеть	заспівати	2
потрясающая	*потрясающая	потрясна	2
солнцезащитные	*солнцезащитные	сонцезахисні	2
мексиканский	*мексиканский	мексиканський	2
хоббитов	*хоббитов	гобітів	2
задирает	*задирает	задирає	2
сыпь	*сыпь	висип	2
жрёт	*жрёт	жере	2
всюду	*всюду	всюди	2
утку	*утку	качку	2
помнишь	*помнишь	пам'ятаєш	2
ванильных	*ванильных	ванільних	2
порносайт	*порносайт	порносайт	2
сердится	*сердится	сердиться	2
успокоиться	*успокоиться	заспокоїтись	2
непростой	*непростой	непростий	2
мистер	*мистер	містере	2
порожнее	*порожнее	порожнє	2
шутить	*шутить	кепкувати	2
старалась	*старалась	намагалася	2
небогатых	*небогатых	небегатих	2
чаю	*чаю	чаю	2
стюардессе	*стюардессе	стюардесою	2
посмешищем	*посмешищем	посміховиськом	2
отправилась	*отправилась	відправилася	2
курить	*курить	тереторії	2
сленг	*сленг	сленг	2
оденься	*оденься	вдягнися	2
пустого	*пустого	пустого	2
трубкой	*трубкой	люлькою	2
скучаю	*скучаю	скучаю	2
мокрая	*мокрая	мокрий	2
дуная	*дуная	дунаю	2
придумывал	*придумывал	придумував	2
стеснялся	*стеснялся	соромився	2
доброту	*доброту	доброту	2
вернись	*вернись	повернись	2
пейджер	*пейджер	пейджер	2
порылся	*порылся	порився	2
сексуален	*сексуален	сексуальний	2
бездонный	*бездонный	бездонну	2
трилобитов	*трилобитов	трилобітів	2
таиланде	*таиланде	тайланді	2
достаточных	*достаточных	достатніх	2
дарёному	*дарёному	дарованому	2
курить	*курить	мусить	1
ника	*ника	ніка	1
китае	*китае	китаї	1
прощенья	*прощенья	пробачення	1
хмурый	*хмурый	смутний	1
итальянцы	*итальянцы	італійці	1
подготовиться	*подготовиться	готуватися	1
утраченным	*утраченным	втраченим	1
парамаунта	*парамаунта	парамаунту	1
пародию	*пародию	пародію	1
часты	*часты	часто	1
сфотографирую	*сфотографирую	сфотографую	1
трос	*трос	трос	1
поедем	*поедем	поїдемо	1
лежат	*лежат	лежать	1
билл	*билл	білл	1
противились	*противились	противилися	1
вставьте	*вставьте	вставте	1
несет	*несет	несе	1
бригадирши	*бригадирши	бригадниці	1
заснул	*заснул	заснув	1
звонят	*звонят	дзвонять	1
танцевали	*танцевали	танцювали	1
красивая	*красивая	вродлива	1
здешними	*здешними	тутейшими	1
знамо	*знамо	звісно	1
злость	*злость	злість	1
неверен	*неверен	невірна	1
фотокамеру	*фотокамеру	фотокамеру	1
следить	*следить	стежити	1
постарше	*постарше	старшій	1
немцев	*немцев	німців	1
подвёз	*подвёз	підвезе	1
младше	*младше	молодший	1
богат	*богат	багатим	1
вырезать	*вырезать	вирізати	1
великой	*великой	величезною	1
головой	*головой	головою	1
иррациональный	*иррациональный	іраціональна	1
сырая	*сырая	сира	1
меленянское	*меленянское	меленянське	1
повидать	*повидать	побачитися	1
нашей	*нашей	нашою	1
домохозяйка	*домохозяйка	домогосподарка	1
стегозавра	*стегозавра	стегозавра	1
прогрессирует	*прогрессирует	прогресує	1
поговорить	*поговорить	полюблять	1
сноповязом	*сноповязом	скиртяром	1
клубника	*клубника	полуниця	1
интригует	*интригует	інтригує	1
форду	*форду	форду	1
участия	*участия	участі	1
голландца	*голландца	голландця	1
вырваться	*вырваться	вирватися	1
романтик	*романтик	романтик	1
атомов	*атомов	атомів	1
соловей	*соловей	соловей	1
вернётесь	*вернётесь	повернетеся	1
продавщица	*продавщица	продавець	1
лежал	*лежал	лежав	1
трое	*трое	троє	1
месье	*месье	мосьє	1
виделись	*виделись	бачилися	1
локтем	*локтем	ліктем	1
фирменные	*фирменные	фірмовий	1
нашу	*нашу	наш	1
улетит	*улетит	злетить	1
путает	*путает	плутає	1
отчаянно	*отчаянно	відчайдушно	1
хваталку	*хваталку	хваталку	1
промок	*промок	промок	1
кролики	*кролики	крілики	1
мост	*мост	новий	1
лицемер	*лицемер	лицемір	1
ошеломила	*ошеломила	приголомшила	1
посчитай	*посчитай	порахуй	1
чихаю	*чихаю	чихаю	1
эй	*эй	ей	1
целительница	*целительница	цілительниця	1
добраться	*добраться	дістатися	1
рыдала	*рыдала	ридала	1
конкурирует	*конкурирует	конкурує	1
плаваю	*плаваю	плаваю	1
патчем	*патчем	патчем	1
вернулись	*вернулись	повернулися	1
прислужиться	*прислужиться	прислужитись	1
бананом	*бананом	бананом	1
молодая	*молодая	молода	1
бабушка	*бабушка	бабусю	1
опаздывать	*опаздывать	запізнюватися	1
увидятся	*увидятся	побачаться	1
ни	*ни	анi	1
поймал	*поймал	упіймав	1
послушаться	*послушаться	послухатися	1
запомни	*запомни	"запам'ятай	1
верилось	*верилось	вірилося	1
табуретка	*табуретка	табуретка	1
зацветает	*зацветает	зацвітає	1
очнитесь	*очнитесь	прокиньтеся	1
чудесна	*чудесна	чудова	1
помню	*помню	пам'ятаю"	1
радостней	*радостней	радісніший	1
синяя	*синяя	синя	1
лезь	*лезь	лізь	1
столик	*столик	столик	1
догадываться	*догадываться	здогадуватися	1
вашей	*вашей	вашого	1
тает	*тает	тане	1
веранду	*веранду	веранду	1
гожусь	*гожусь	годжуся	1
карбоновое	*карбоновое	карбонову	1
ни	*ни	жодне	1
сладко	*сладко	солодко"	1
посвечу	*посвечу	посвічу	1
жопа	*жопа	дупа	1
нездоров	*нездоров	нездоровий	1
утихнет	*утихнет	вщухне	1
водятся	*водятся	плодяться	1
джордан	*джордан	джордан	1
расслабьтесь	*расслабьтесь	розслабтеся	1
шопена	*шопена	шопена	1
плыви	*плыви	пливи	1
посчастливилось	*посчастливилось	пощастило	1
ящер	*ящер	ящір	1
модеста	*модеста	мусоргського	1
снотворного	*снотворного	снодійного	1
всякой	*всякой	всякій	1
дорого	*дорого	дорого	1
угарте	*угарте	угарт"	1
ян	*ян	ян	1
погулять	*погулять	погуляти	1
целыми	*целыми	цілоденно	1
присутствовал	*присутствовал	присутнім	1
плакал	*плакал	плакала	1
ставили	*ставили	ставили	1
женда	*женда	женда	1
диджей	*диджей	діджей	1
брился	*брился	голився	1
прокисло	*прокисло	скисло	1
берегись	*берегись	обережно	1
берут	*берут	беруть	1
европейцы	*европейцы	європейці	1
молодо	*молодо	молодо	1
крис	*крис	кріс	1
камнем	*камнем	каменем	1
чародеи	*чародеи	чарівники	1
псарь	*псарь	підпанки	1
повзрослел	*повзрослел	подорослішав	1
роксолана	*роксолана	роксолана	1
наше	*наше	нашу	1
виделись	*виделись	бачились	1
бывшего	*бывшего	колишнього	1
воздвигли	*воздвигли	спорудили	1
словио	*словио	словіо	1
понкьелли	*понкьелли	понк'єллі	1
плюшевая	*плюшевая	плюшева	1
улыбнись	*улыбнись	посміхнися	1
анна	*анна	анна	1
прощайте	*прощайте	тримайтесь	1
пьёшь	*пьёшь	"п'єш	1
пломбы	*пломбы	пломби	1
простыни	*простыни	простирадла	1
субботниках	*субботниках	суботниках	1
заполнять	*заполнять	заповнювати	1
целый	*целый	цілу	1
похвалы	*похвалы	похвали	1
попросить	*попросить	попросити	1
великих	*великих	велика	1
всяком	*всяком	усякому	1
сладким	*сладким	солодким	1
встревожилась	*встревожилась	занепокоїлася	1
фотогеничен	*фотогеничен	фотогенічний	1
тошнило	*тошнило	нудило	1
пиццу	*пиццу	піццу	1
выклюет	*выклюет	виклює	1
рад	*рад	радітиму	1
бери	*бери	бери	1
мейзнер	*мейзнер	мейзнер	1
поцеловать	*поцеловать	поцілувати	1
касабланку	*касабланку	касабланку	1
чаю	*чаю	чашку	1
тряслась	*тряслась	тремтіла	1
незнакомцев	*незнакомцев	незнайомців	1
петр	*петр	петр	1
искупаться	*искупаться	скупатись	1
сэм	*сэм	сем	1
обманут	*обманут	збрешуть	1
диарея	*диарея	діарея	1
погас	*погас	згас	1
пригородный	*пригородный	приміський	1
перегораживайте	*перегораживайте	загороджуйте	1
злить	*злить	злити	1
пылкую	*пылкую	палке	1
одухотворено	*одухотворено	одухотворене	1
подумают	*подумают	подумали	1
вините	*вините	звинувачуйте	1
пальм	*пальм	пальм	1
выйдет	*выйдет	вийде	1
вернуться	*вернуться	повернутися	1
вставай	*вставай	вставай	1
докладывали	*докладывали	докладали	1
опоздаете	*опоздаете	пропустите	1
аой	*аой	аой	1
пунктуальный	*пунктуальный	пунктуальний	1
зарегистрироваться	*зарегистрироваться	зареєструватися	1
шило	*шило	бика	1
траходон	*траходон	траходон	1
рассердить	*рассердить	розсердити	1
чашку	*чашку	чашечку	1
потерявши	*потерявши	втеряєш	1
диваном	*диваном	канапою	1
стёрт	*стёрт	стертий	1
какао	*какао	какао	1
спели	*спели	заспівали	1
дебил	*дебил	дебіл	1
старика	*старика	старого	1
вытащил	*вытащил	витягнув	1
мамонт	*мамонт	мамонт	1
окончен	*окончен	закінчено	1
уганды	*уганды	уганди	1
поймана	*поймана	спіймана	1
идиотка	*идиотка	ідіотка	1
патронов	*патронов	патронів	1
летают	*летают	летають	1
тодзи	*тодзи	тодзі	1
пробуждает	*пробуждает	пробуджує	1
пьёте	*пьёте	"п'єте	1
переписали	*переписали	переписали	1
порисовать	*порисовать	помалювати	1
вполне	*вполне	впевнений	1
тварь	*тварь	тварюко	1
изменчива	*изменчива	мінлива	1
перекуют	*перекуют	перекують	1
дохнут	*дохнут	дохнуть	1
свяжите	*свяжите	"зв'яжіть	1
перекатился	*перекатился	перекотився	1
закоулок	*закоулок	закуток	1
нечто	*нечто	варте	1
большей	*большей	більшої	1
покончил	*покончил	покінчив	1
орест	*орест	орест	1
дурацкого	*дурацкого	ідіотського	1
боялась	*боялась	боялася	1
садитесь	*садитесь	сідайте	1
искупаемся	*искупаемся	скупатись	1
пить	*пить	вживати	1
бизон	*бизон	бізон	1
берт	*берт	берт	1
тараканы	*тараканы	таргани	1
мистере	*мистере	містера	1
арбуз	*арбуз	кавун	1
квантовая	*квантовая	квантова	1
богаты	*богаты	багаті	1
пьёте	*пьёте	п'єте	1
пекин	*пекин	пекін	1
спускайся	*спускайся	опускайся	1
порвала	*порвала	порвала	1
блузку	*блузку	блузку	1
переношу	*переношу	переношу	1
вылепил	*вылепил	виліпив	1
кишки	*кишки	кишки	1
евгений	*евгений	євген	1
йокогама	*йокогама	йокогама	1
чернильных	*чернильных	чорнильних	1
буерак	*буерак	байрак	1
переодеться	*переодеться	перевдягнутися	1
убирать	*убирать	прибирати	1
скобки	*скобки	дужки	1
вежливой	*вежливой	ввічливою	1
будильник	*будильник	будильник	1
полетел	*полетел	полетів	1
суров	*суров	суровий	1
мезозойскую	*мезозойскую	мезозойську	1
окончится	*окончится	закінчиться	1
вытерпеть	*вытерпеть	стерпіти	1
обопрись	*обопрись	обіпрись	1
весенняя	*весенняя	весняна	1
обиделся	*обиделся	образився	1
черное	*черное	чорне	1
закричала	*закричала	закричала	1
мост	*мост	мосту	1
чек	*чек	чек	1
тадеуш	*тадеуш	тадеуш	1
орет	*орет	волає	1
пробкой	*пробкой	пробкою	1
бездействующим	*бездействующим	бездіяльним	1
польша	*польша	польща	1
вольнодумцем	*вольнодумцем	вільнодумцем	1
воздвиг	*воздвиг	спорудив	1
арабы	*арабы	араби	1
напрягаешься	*напрягаешься	напружуєшся	1
согласиться	*согласиться	погодитись	1
кружевом	*кружевом	мереживом	1
редьку	*редьку	редьку	1
к	*к	ди	1
синей	*синей	фланелі	1
пробрался	*пробрался	прокрався	1
вернитесь	*вернитесь	поверніться	1
снился	*снился	снився	1
корень	*корень	корінь	1
яблони	*яблони	яблуньки	1
свари	*свари	звари	1
гладить	*гладить	прасувати	1
босс	*босс	босе	1
чашкой	*чашкой	чашкою	1
ива	*ива	верба	1
бэтмана	*бэтмана	бетмена	1
пчёл	*пчёл	бджіл	1
морковку	*морковку	морквину	1
файтак	*файтак	файтак	1
поцарапал	*поцарапал	подряпав	1
незачёт	*незачёт	незалік	1
поумнел	*поумнел	помудрішала	1
поспешил	*поспешил	поквапився	1
развязались	*развязались	розв'язалися"	1
попробую	*попробую	спробую	1
непредвиденный	*непредвиденный	непередбачений	1
иностранки	*иностранки	іноземки	1
мяч	*мяч	яч	1
передумал	*передумал	передумав	1
финляндии	*финляндии	фінляндії	1
сводит	*сводит	зводить	1
ошиблась	*ошиблась	помилилася	1
выпьем	*выпьем	випиймо	1
ведра	*ведра	відра	1
отмоется	*отмоется	відмиється	1
китов	*китов	китів	1
гнилое	*гнилое	гниле	1
подевался	*подевался	подівся	1
дори	*дори	дорі	1
сломался	*сломался	зламався	1
всякого	*всякого	усякої	1
камень	*камень	камінь	1
шипы	*шипы	шипи	1
последняя	*последняя	остання	1
немцы	*немцы	німці	1
ларри	*ларри	ларрі	1
посторонней	*посторонней	сторонньої	1
обязан	*обязан	зобов'язаний	1
синхронного	*синхронного	сінхронного	1
стареет	*стареет	старіє	1
гавайях	*гавайях	гавайях	1
иероглифы	*иероглифы	ієрогліфи	1
сытый	*сытый	ситий	1
прилипла	*прилипла	прилипла	1
пиццу	*пиццу	піцу	1
чёрный	*чёрный	чорний	1
просыпаешься	*просыпаешься	прокидаєшся	1
синано	*синано	сінано	1
твёрдом	*твёрдом	твердому	1
задала	*задала	декілька	1
лузер	*лузер	лузер	1
чикаго	*чикаго	чікаго	1
насмешишь	*насмешишь	насмішиш	1
соломинка	*соломинка	ооломинка	1
драгоценные	*драгоценные	дорогоцінне	1
сдастся	*сдастся	здається	1
горечь	*горечь	гіркоту	1
вытерла	*вытерла	витерла	1
разозлился	*разозлился	розлютився	1
потрогаю	*потрогаю	доторкнутися	1
развлекались	*развлекались	розважалися	1
кэнсукэ	*кэнсукэ	кенсуке	1
передвинь	*передвинь	пересунь	1
тафтс	*тафтс	тафтс	1
спроси	*спроси	спитай	1
разведётся	*разведётся	розлучиться	1
новообращённый	*новообращённый	новозверений	1
тягаться	*тягаться	змагатися	1
звонить	*звонить	дзвонити	1
липнут	*липнут	липнуть	1
уборная	*уборная	прибиральня	1
кристин	*кристин	кристін	1
прекратится	*прекратится	припиниться	1
направляетесь	*направляетесь	направляєтеся	1
барабана	*барабана	барабана	1
ивонн	*ивонн	івон	1
младший	*младший	молодший	1
ловить	*ловить	рибалити	1
молодые	*молодые	молоді	1
медный	*медный	мідний	1
андрееску	*андрееску	адреєску	1
здравствуйте	*здравствуйте	драстуйте	1
спелое	*спелое	стигле	1
стружке	*стружке	стружці	1
завидую	*завидую	заздрю	1
стрела	*стрела	стріла	1
верблюды	*верблюды	верблюди	1
злюсь	*злюсь	злюся	1
смыло	*смыло	змило	1
засранцев	*засранцев	задрипанців	1
сладостей	*сладостей	солодощів	1
богат	*богат	багатий	1
покрасил	*покрасил	пофарбував	1
посторонним	*посторонним	стороннім	1
камень	*камень	камінчик	1
одноклассники	*одноклассники	однокласники	1
возьмите	*возьмите	візьміть	1
переливать	*переливать	переливати	1
атаковала	*атаковала	атакувала	1
ни	*ни	ни	1
читая	*читая	читаючи	1
клади	*клади	кладіть	1
латунь	*латунь	латунь	1
избавься	*избавься	позбався	1
невербальным	*невербальным	невербальним	1
вегетарианец	*вегетарианец	вегетаріанець	1
танцовщица	*танцовщица	танцівниця	1
спущусь	*спущусь	спущуся	1
дверцы	*дверцы	дверцята	1
пальмы	*пальмы	пальми	1
покорен	*покорен	підкорений	1
попробуем	*попробуем	опробуємо	1
накоплю	*накоплю	накопичую	1
красивой	*красивой	прекрасна	1
прослушала	*прослушала	прослухала	1
неудачник	*неудачник	невдаха	1
обокрали	*обокрали	обікрали	1
променял	*променял	проміняв	1
уехала	*уехала	полетіла	1
тролля	*тролля	троля	1
перелезали	*перелезали	перелазили	1
ясное	*ясное	звісно	1
наших	*наших	іншого	1
обернулась	*обернулась	обернулася	1
грести	*грести	гребти	1
выражаются	*выражаются	виражаються	1
булькает	*булькает	булькає	1
бедолага	*бедолага	бідаха	1
просил	*просил	просив	1
чашечку	*чашечку	філіжанку	1
римляне	*римляне	римляни	1
нобелевскую	*нобелевскую	нобелівську	1
помни	*помни	"пам'ятай	1
эгоистичным	*эгоистичным	егоїстичним	1
никаких	*никаких	ніяких	1
уставший	*уставший	втомлений	1
рассмеяться	*рассмеяться	розсміятися	1
пожалеешь	*пожалеешь	шкодуватимеш	1
хмурый	*хмурый	похмурий	1
рыжеватые	*рыжеватые	руденьке	1
поймали	*поймали	упіймали	1
встаёте	*встаёте	встаєте	1
едете	*едете	їдете	1
марко	*марко	марко	1
ломит	*ломит	ломить	1
хирургическая	*хирургическая	хірургічна	1
обыскался	*обыскался	обшукався	1
успокойся	*успокойся	розслабся	1
красивых	*красивых	красивих	1
ви	*ви	ви	1
подстелил	*подстелил	підстелив	1
бездянки	*бездянки	бездянці	1
пробкой	*пробкой	дорожною	1
каникулах	*каникулах	канікулах	1
стыдно	*стыдно	соромно	1
штормовое	*штормовое	штормове	1
очевиден	*очевиден	очевидна	1
австралия	*австралия	австралія	1
сыро	*сыро	сиро	1
белоснежное	*белоснежное	білосніжне	1
постою	*постою	постою	1
довольны	*довольны	задоволені	1
сменился	*сменился	змінився	1
всякий	*всякий	всякий	1
трубку	*трубку	люльку	1
плачь	*плачь	плач	1
уехала	*уехала	поїхала	1
голосовать	*голосовать	голосувати	1
обязан	*обязан	"зобов'язаний	1
наслаждайтесь	*наслаждайтесь	насолоджуйтесь	1
эквадора	*эквадора	еквадору	1
созрели	*созрели	достигли	1
задуматься	*задуматься	задуматися	1
плаванье	*плаванье	плавання	1
коул	*коул	коул"	1
рыбалкой	*рыбалкой	цікавлюся	1
оглядывайся	*оглядывайся	озирайся	1
выложился	*выложился	виклався	1
уехать	*уехать	поїхати	1
сыт	*сыт	ситий	1
вордпресса	*вордпресса	вордпреса	1
потащим	*потащим	потягнемо	1
возьмите	*возьмите	візміть	1
аспирин	*аспирин	аспірин	1
разлили	*разлили	розлили	1
выпадает	*выпадает	випадає	1
пошутил	*пошутил	пожартував	1
невиновна	*невиновна	невинна	1
причёской	*причёской	зачіскою	1
далеки	*далеки	далекі	1
закурила	*закурила	закурила	1
покладисты	*покладисты	покладливими	1
красива	*красива	вродлива	1
лентяй	*лентяй	ледар	1
прошу	*прошу	пробачте	1
ме	*ме	ме	1
альпийские	*альпийские	альпійськи	1
диван	*диван	диван	1
африке	*африке	африці	1
укрыта	*укрыта	вкрита	1
перевозится	*перевозится	перевозиться	1
шевелится	*шевелится	ворушиться	1
легкостью	*легкостью	легкістю	1
замужем	*замужем	заміжня	1
яны	*яны	яни	1
вернётесь	*вернётесь	вернетеся	1
промокать	*промокать	промокати	1
выпускные	*выпускные	випускні	1
тонущий	*тонущий	тонучий	1
спешат	*спешат	поспішає	1
головную	*головную	головний	1
сгубило	*сгубило	згубила	1
чеки	*чеки	чеки	1
нарывался	*нарывался	наривався	1
небольшая	*небольшая	невелика	1
кролики	*кролики	кролі	1
ненавидит	*ненавидит	ненавидить	1
социальные	*социальные	соціальні	1
трое	*трое	трьох	1
создались	*создались	створились	1
кредиткой	*кредиткой	кредиткою	1
стучал	*стучал	стукав	1
послушайся	*послушайся	послухайся	1
бешена	*бешена	дурна	1
трилобит	*трилобит	трилобіт	1
амфитриты	*амфитриты	амфітрити	1
перевернись	*перевернись	перевернися	1
пробежать	*пробежать	пробігти	1
спускайся	*спускайся	спускайся	1
выпиваю	*выпиваю	випиваю	1
выберусь	*выберусь	виберуся	1
лебедем	*лебедем	лебедем	1
развлекательная	*развлекательная	розважальна	1
сократилось	*сократилось	скоротилось	1
стихи	*стихи	вірши	1
мясом	*мясом	м'ясом"	1
швартовы	*швартовы	швартові	1
чернильное	*чернильное	чорнильна	1
утку	*утку	гуски	1
носить	*носить	носити	1
эдисону	*эдисону	едісону	1
будда	*будда	будда	1
налей	*налей	налий	1
шарф	*шарф	шарф	1
волноваться	*волноваться	хвилюватися	1
развернёмся	*развернёмся	розвернемося	1
разбудило	*разбудило	розбудило	1
пожалуйста	*пожалуйста	полагодьте	1
голливудским	*голливудским	голівудським	1
плачете	*плачете	плачете	1
взяв	*взяв	взявши	1
мертвого	*мертвого	мертвого	1
непуганых	*непуганых	неляканих	1
скользили	*скользили	ковзали	1
чашку	*чашку	пусту	1
нагасаки	*нагасаки	нагасакі	1
блондинки	*блондинки	блондинки	1
пазл	*пазл	пазл	1
проехав	*проехав	проїхавши	1
грубого	*грубого	грубої	1
похожую	*похожую	схожу	1
ух	*ух	ух	1
прикажете	*прикажете	накажете	1
летит	*летит	летить	1
вредят	*вредят	шкодять	1
вином	*вином	вином	1
учительницей	*учительницей	вчительку	1
познается	*познается	пізнається	1
рыбалкой	*рыбалкой	рибальством	1
завис	*завис	завис	1
львове	*львове	львові	1
дог	*дог	дог	1
доисторической	*доисторической	доісторичної	1
шнурки	*шнурки	шнурки	1
парикмахера	*парикмахера	перукаря	1
торопитесь	*торопитесь	покваптесь	1
угадайте	*угадайте	здогадайтеся	1
прошептал	*прошептал	прошепотів	1
бедняги	*бедняги	бідолахи	1
файлами	*файлами	файлами	1
упаковать	*упаковать	упакувати	1
куковать	*куковать	кукувати	1
уговорила	*уговорила	умовляла	1
общепризнанной	*общепризнанной	загальновизнаною	1
орала	*орала	орала	1
влюблялась	*влюблялась	закохувалася	1
французы	*французы	французи	1
клубная	*клубная	клубна	1
покончил	*покончил	вкоротив	1
разбудите	*разбудите	розбудіть	1
вдвоём	*вдвоём	вдвох	1
справимся	*справимся	впораємося	1
рыбалку	*рыбалку	рибалку	1
комиксы	*комиксы	комікси	1
двухместные	*двухместные	двомісні	1
смей	*смей	смій	1
твердят	*твердят	стверджують	1
оборачивайся	*оборачивайся	обертайся	1
перевязал	*перевязал	перев'язав	1
садилось	*садилось	сідало	1
двуокись	*двуокись	двуокис	1
ленивый	*ленивый	ледачий	1
уловил	*уловил	вловити	1
шампунь	*шампунь	шампунь	1
сбылась	*сбылась	здійснилася	1
помяни	*помяни	промовка	1
упаковал	*упаковал	спакував	1
молик	*молик	молек	1
пью	*пью	"п'ю	1
вашей	*вашей	вашою	1
колумбии	*колумбии	колумбії	1
кружится	*кружится	паморочиться	1
сбрить	*сбрить	зголити	1
столике	*столике	столику	1
вылечить	*вылечить	вилічити	1
укололась	*укололась	вкололась	1
обижает	*обижает	ображає	1
гитаристом	*гитаристом	гітаристом	1
кузнечик	*кузнечик	коник	1
бьорк	*бьорк	бьорк	1
прикасайся	*прикасайся	торкайся	1
джима	*джима	джима	1
увидеться	*увидеться	побачитися	1
показалась	*показалась	показалася	1
угощайтесь	*угощайтесь	пригощайтеся	1
кондиционирование	*кондиционирование	кондиціонування	1
догадывался	*догадывался	здогадувався	1
проваливай	*проваливай	провалюй	1
повлияло	*повлияло	вплинуло	1
индии	*индии	індії	1
удается	*удается	вдається	1
мордочки	*мордочки	мордочки	1
аптечка	*аптечка	аптечка	1
наглость	*наглость	нахабство	1
рейх	*рейх	рейх	1
гамлета	*гамлета	гамлета	1
медитировать	*медитировать	медитувати	1
нару	*нару	нару	1
дверь	*дверь	дверi	1
моцарта	*моцарта	моцарта	1
похожа	*похожа	схожа	1
удалась	*удалась	вдалося	1
старик	*старик	старий	1
пульт	*пульт	пульт	1
испугался	*испугался	злякався	1
поймали	*поймали	зловили	1
сдвинулась	*сдвинулась	зрушилася	1
поговорить	*поговорить	потеревеніти	1
обожали	*обожали	обожнювали	1
ржавое	*ржавое	іржаве	1
неся	*неся	несучи	1
забрался	*забрался	забрався	1
выглядеть	*выглядеть	виглядати	1
ни	*ни	їм	1
матрос	*матрос	матрос	1
понравилось	*понравилось	сподобалось	1
выберемся	*выберемся	виберимося	1
общаюсь	*общаюсь	спілкуюся	1
тихая	*тихая	тиха	1
подмогу	*подмогу	допомогу	1
энн	*энн	енн	1
удался	*удался	вдався	1
посольскую	*посольскую	посольську	1
разыскивали	*разыскивали	розшукували	1
крутым	*крутым	крутим	1
поплачешь	*поплачешь	посмiхнись	1
мудренее	*мудренее	мудріший	1
китай	*китай	китай	1
пароме	*пароме	паромі	1
упустил	*упустил	пропустив	1
пропустил	*пропустил	випустив	1
пей	*пей	пий	1
орали	*орали	орали	1
вредил	*вредил	шкодив	1
хоббайт	*хоббайт	гобайт	1
шатаешься	*шатаешься	вештаєшся	1
верн	*верн	верн	1
обожаю	*обожаю	обожнюю	1
циркулем	*циркулем	циркулем	1
мусоргского	*мусоргского	мусоргського	1
оденься	*оденься	вдягнись	1
курсовая	*курсовая	курсова	1
укротив	*укротив	приборкав	1
татоэба	*татоэба	татоеба	1
неизлечимо	*неизлечимо	невиліковно	1
ускакал	*ускакал	поскакав	1
утратил	*утратил	втратив	1
газели	*газели	газелі	1
уснула	*уснула	заснула	1
критическая	*критическая	критична	1
галгаш	*галгаш	галгаш	1
просят	*просят	просимо	1
купались	*купались	купалися	1
робин	*робин	робін	1
драконы	*драконы	дракони	1
купался	*купался	купався	1
укусит	*укусит	укусить	1
улыбнись	*улыбнись	посмiхнись	1
падают	*падают	падають	1
майка	*майка	майка	1
бергер	*бергер	берґер	1
усерднее	*усерднее	старанніше	1
тьфу	*тьфу	тьфу	1
проголодались	*проголодались	зголодніли	1
запомнить	*запомнить	запам'ятати"	1
выслал	*выслал	вислав	1
сандра	*сандра	сандра	1
вредит	*вредит	шкодить	1
модеста	*модеста	модеста	1
вебсайтам	*вебсайтам	вебсайтів	1
бедняжка	*бедняжка	бідолаха	1
летят	*летят	летять	1
мамонта	*мамонта	мамонта	1
приснилось	*приснилось	наснилось	1
рукав	*рукав	рукав	1
спасти	*спасти	спасти	1
бега	*бега	бігу	1
баночку	*баночку	баночку	1
опустить	*опустить	опустити	1
провалился	*провалился	провалився	1
сортируют	*сортируют	сортують	1
слезли	*слезли	злізли	1
уловом	*уловом	уловом	1
сбудется	*сбудется	справдиться	1
спиртное	*спиртное	спиртне"	1
увидимся	*увидимся	побачимося	1
парагвай	*парагвай	парагвай	1
основную	*основную	основну	1
бригадников	*бригадников	бригадників	1
тяжеловоз	*тяжеловоз	ваговоз	1
эдита	*эдита	едита	1
засеяна	*засеяна	засіяна	1
спикировал	*спикировал	пікірував	1
чучело	*чучело	величезного	1
дышать	*дышать	дихати	1
повешу	*повешу	повішу	1
зарезервированы	*зарезервированы	зарезервовані	1
мари	*мари	макі	1
пустую	*пустую	пусту	1
побалансировать	*побалансировать	побалансувати	1
швейцарии	*швейцарии	швейцарії	1
интернет	*интернет	інтернет	1
порез	*порез	подряпина	1
обманывать	*обманывать	обманювати	1
губка	*губка	губка	1
литва	*литва	литва	1
одевай	*одевай	одягай	1
понравился	*понравился	сподобався	1
элеватор	*элеватор	елеватор	1
погладить	*погладить	попрасувати	1
обходили	*обходили	оминали	1
бабочки	*бабочки	метелики	1
инъективный	*инъективный	ін'єктивний	1
пусто	*пусто	пусто	1
потеряли	*потеряли	втратили	1
саранча	*саранча	саранча	1
вымерли	*вымерли	вимерли	1
сыроед	*сыроед	сироїд	1
классно	*классно	класно	1
сегодняшний	*сегодняшний	сьогоднішній	1
осмеливаетесь	*осмеливаетесь	насмілюєтеся	1
рассыпались	*рассыпались	розсипалися	1
пахнут	*пахнут	пахнуть	1
гордимся	*гордимся	гордуємо	1
снопом	*снопом	скиртою	1
перестроил	*перестроил	перебудував	1
шипов	*шипов	шипів	1
массаж	*массаж	масаж	1
апчхи	*апчхи	ачхи	1
каникулы	*каникулы	канікули	1
стричь	*стричь	стригти	1
стиральная	*стиральная	пральна	1
правит	*правит	керує	1
фейерверки	*фейерверки	феєрверки	1
пребывания	*пребывания	перебування	1
яна	*яна	яно	1
дракон	*дракон	дракон	1
вращаются	*вращаются	обертаються	1
соломки	*соломки	соломки	1
удаётся	*удаётся	вдається	1
доводы	*доводы	доводи	1
предназначена	*предназначена	призначена	1
зефир	*зефир	зефір	1
силура	*силура	силуру	1
пятом	*пятом	п'ятому	1
поглощена	*поглощена	поглинена	1
джим	*джим	джиме	1
молодой	*молодой	молодої	1
эмета	*эмета	емета	1
перестает	*перестает	перестає	1
обманули	*обманули	обдурили	1
шелдрейк	*шелдрейк	шелдрейк	1
палуба	*палуба	палуба	1
джек	*джек	джек	1
задержался	*задержался	затримався	1
читала	*читала	читав	1
куёт	*куёт	кує	1
настал	*настал	настав	1
асоциален	*асоциален	антисоціальний	1
серийная	*серийная	серійна	1
девятой	*девятой	дев'ятій	1
жарко	*жарко	затра	1
устроиться	*устроиться	влаштуватися	1
мария	*мария	марія	1
плачешь	*плачешь	плачеш	1
обманул	*обманул	обманув	1
великих	*великих	великих	1
затонул	*затонул	затонув	1
строг	*строг	строгим	1
трудности	*трудности	труднощів	1
камешки	*камешки	камінці	1
припарковалась	*припарковалась	припаркувалася	1
спешить	*спешить	поспішати	1
сырой	*сырой	сирої	1
прибираться	*прибираться	прибирати	1
белоруссии	*белоруссии	білорусі	1
сердись	*сердись	сердся	1
прикольно	*прикольно	прикольно	1
околдована	*околдована	зачарована	1
угарте	*угарте	угарт	1
пропустишь	*пропустишь	пропустиш	1
выдались	*выдались	видалися	1
врождённая	*врождённая	природжена	1
уравнении	*уравнении	рівнянні	1
арбуза	*арбуза	кавуна	1
огурец	*огурец	огірок	1
злись	*злись	злостися	1
разве	*разве	раніше	1
столь	*столь	настільки	1
шнобелевскую	*шнобелевскую	шнобелевську	1
механизатор	*механизатор	механізатор	1
курево	*курево	куриво	1
брюссель	*брюссель	брюссель	1
последователен	*последователен	послідовний	1
хвастается	*хвастается	вихваляється	1
поговорить	*поговорить	побалакати	1
саэб	*саэб	саеб	1
сентиментален	*сентиментален	сентементальний	1
следуйте	*следуйте	слідуйте	1
википедия	*википедия	вікіпедія	1
читай	*читай	читай	1
пьёшь	*пьёшь	п'єш	1
штора	*штора	штора	1
пас	*пас	пас	1
помните	*помните	пам'ятаєте	1
держась	*держась	тримаючись	1
обжег	*обжег	обпік	1
третичный	*третичный	третинний	1
иврит	*иврит	іврит	1
другой	*другой	другої	1
плывет	*плывет	пливе	1
подчиниться	*подчиниться	підкоритися	1
пуншем	*пуншем	пуншем	1
до	*до	до"	1
сердитесь	*сердитесь	сердтеся	1
моррис	*моррис	морріс	1
молодому	*молодому	молодому	1
рад	*рад	рад	1
положиться	*положиться	покластися	1
одеты	*одеты	вдягнені	1
впустил	*впустил	впустив	1
улыбнулась	*улыбнулась	розвернулася	1
невежества	*невежества	невігластво	1
бивень	*бивень	бивень	1
гордон	*гордон	гордон"	1
хоть	*хоть	хоч	1
преувеличивать	*преувеличивать	перебільшувати	1
безобразники	*безобразники	бешкетники	1
заблудился	*заблудился	заблукав	1
пройтись	*пройтись	пройтися	1
оглядел	*оглядел	оглянув	1
жутко	*жутко	люто	1
мексике	*мексике	мексиці	1
проснёшься	*проснёшься	прокинешся	1
боцман	*боцман	боцман	1
теннисист	*теннисист	тенісист	1
порядочным	*порядочным	порядною	1
завоевание	*завоевание	завоювання	1
прижиться	*прижиться	прижитися	1
присутствует	*присутствует	присутня	1
наплакал	*наплакал	наплакав	1
пунической	*пунической	пунічної	1
пахнут	*пахнут	пахнуть"	1
лучший	*лучший	накращий	1
спрыгнул	*спрыгнул	зстрибнув	1
вернёшься	*вернёшься	повернешся	1
пакистан	*пакистан	пакістан	1
заснуть	*заснуть	заснути	1
перестаёт	*перестаёт	перестає	1
весит	*весит	важить	1
потянулся	*потянулся	потягнувся	1
татоэбе	*татоэбе	татоебі	1
неплохая	*неплохая	непогана	1
одета	*одета	вдягена	1
палеозойскую	*палеозойскую	палеозойську	1
хриплю	*хриплю	хриплю	1
ласточка	*ласточка	ластівка	1
сигары	*сигары	цигарки	1
картонных	*картонных	картонних	1
риком	*риком	ріком	1
списывал	*списывал	списував	1
рискнуть	*рискнуть	ризикнути	1
безнадёжный	*безнадёжный	безнадійний	1
спой	*спой	заспівай	1
пожалуйста	*пожалуйста	побачитися	1
спеша	*спеша	поспішаючи	1
подлей…	*подлей…	підлий…	1
черным	*черным	чорним	1
терпит	*терпит	терпить	1
братиславы	*братиславы	братислави	1
старайся	*старайся	старайся	1
порезался	*порезался	порізався	1
болячка	*болячка	болячка	1
штрассе	*штрассе	штрассер	1
стегозавр	*стегозавр	стегозавр	1
полна	*полна	повна	1
поговорка	*поговорка	приказка	1
дует	*дует	дує	1
грамматически	*грамматически	граматично	1
алматы	*алматы	алмати	1
вылезайте	*вылезайте	вилазьте	1
утратите	*утратите	втратите	1
три	*три	граю	1
неоднократный	*неоднократный	неодноразовий	1
обманчива	*обманчива	оманлива	1
бывает	*бывает	буваю	1
отравилась	*отравилась	отруїлася	1
улыбнулась	*улыбнулась	усміхнулась	1
мудры	*мудры	мудрі	1
прогуливаться	*прогуливаться	прогулюватися	1
поспешишь	*поспешишь	поспішиш	1
мило	*мило	милі	1
мацусиму	*мацусиму	мацусіму	1
захватчиками	*захватчиками	загарбниками	1
ваше	*ваше	виконано	1
разрядился	*разрядился	розрядився	1
щёки	*щёки	щоки	1
выносливость	*выносливость	витривалість	1
падает	*падает	падає	1
попался	*попался	попався	1
психоанализа	*психоанализа	психоаналіз	1
брубейкер	*брубейкер	брубейкер	1
последним	*последним	останній	1
обманули	*обманули	ошукали	1
крухулик	*крухулик	крухулик	1
саже	*саже	сажі	1
пострижена	*пострижена	підстрижена	1
забеременела	*забеременела	завагітніла	1
ильза	*ильза	ільзо	1
вредить	*вредить	шкодити	1
плывут	*плывут	пливуть	1
разряжена	*разряжена	розряджена	1
погружен	*погружен	занурений	1
жуки	*жуки	жуки	1
смастерили	*смастерили	змайстрували	1
поступить	*поступить	вступити	1
дует	*дует	дме	1
агата	*агата	агата	1
симпатичен	*симпатичен	симпатичний	1
яблони	*яблони	яблучко	1
слепа	*слепа	сліпа	1
глупо	*глупо	нерозумно	1
лгун	*лгун	брехун	1
вставала	*вставала	вставала	1
бойся	*бойся	бійся	1
накапливались	*накапливались	накопичувалися	1
хочется	*хочется	хочеться	1
меленянским	*меленянским	мелянським	1
перевяжи	*перевяжи	"перев'яжи	1
прождал	*прождал	прочекав	1
сбываются	*сбываются	збуваються	1
рвётся	*рвётся	рветься	1
елизавета	*елизавета	єлізавета	1
посылать	*посылать	посилати	1
неверные	*неверные	невірні	1
шпионила	*шпионила	шпигувала	1
завидует	*завидует	заздрить	1
выдумала	*выдумала	вигадала	1
англичанином	*англичанином	англійцем	1
ездить	*ездить	їздити	1
плачет	*плачет	плаче	1
бездянки	*бездянки	бездянки	1
эврика	*эврика	евріка	1
поплавать	*поплавать	поплавати	1
морковь	*морковь	морква	1
верну	*верну	поверну	1
пустой	*пустой	пуста	1
видео	*видео	відео	1
задолбалась	*задолбалась	задовбало	1
спускай	*спускай	спускай	1
озёрная	*озёрная	озерна	1
помнится	*помнится	пам'ятається	1
коньках	*коньках	ковзанах	1
заболел	*заболел	захворів	1
непостоянные	*непостоянные	непостійні	1
потеряла	*потеряла	загубила	1
бесследно	*бесследно	безслідно	1
застрял	*застрял	застряг	1
женился	*женился	оженився	1
высока	*высока	висока	1
проговорили	*проговорили	проговорили	1
стряслось	*стряслось	скоїлося	1
плавает	*плавает	плаває	1
облагаются	*облагаются	обкладаються	1
штора	*штора	загорілася	1
низкий	*низкий	найнижчий	1
старики	*старики	старі	1
закурю	*закурю	закурю	1
многая	*многая	многая	1
последним	*последним	останнім	1
хироси	*хироси	хіросі	1
забронировали	*забронировали	забронювали	1
уин-та-тати-терий	*уин-та-*тати-*терий	уін-та-таті-терий	1
уин-та-тати-терий	*уин-та-*тати-*терий	уін-та-таті-терий	1
плакал	*плакал	плакав	1
малайзии	*малайзии	малайзії	1
иврите	*иврите	івриті	1
сыпать	*сыпать	сипати	1
презирают	*презирают	зневажають	1
вылезет	*вылезет	вилізе	1
вернёмся	*вернёмся	вернімося	1
дурой	*дурой	ідіоткою	1
нависла	*нависла	нависла	1
эгоистична	*эгоистична	егоїстична	1
осуществиться	*осуществиться	здійснитися	1
свинец	*свинец	свинець	1
парочка	*парочка	парочка	1
одолжили	*одолжили	позичили	1
латынь	*латынь	латинь	1
лучших	*лучших	найкращих	1
гвозди	*гвозди	цвяхи	1
белоснежные	*белоснежные	білосніжне	1
сочувствую	*сочувствую	співчуваю	1
покуковать	*покуковать	кукувати	1
перезвоню	*перезвоню	перетелефоную	1
перекусить	*перекусить	перекусити	1
малибу	*малибу	малібу	1
слабак	*слабак	олабак	1
боже	*боже	боже	1
злой	*злой	злий	1
великая	*великая	велика	1
подумайте	*подумайте	подумайте	1
вытрите	*вытрите	витирайте	1
успокойся	*успокойся	заспокойся	1
ослом	*ослом	віслюком	1
ударил	*ударил	вдарив	1
высадить	*высадить	висадити	1
принадлежат	*принадлежат	належать	1
вздохните	*вздохните	зітхніть	1
десерт	*десерт	десерт	1
ни	*ни	анітрохи	1
содовая	*содовая	сода	1
поцарапало	*поцарапало	пошкрябало	1
осчастливил	*осчастливил	ощасливив	1
ногти	*ногти	нігті	1
концентрационных	*концентрационных	концентраційних	1
пробудешь	*пробудешь	пробудеш	1
взлома	*взлома	злому	1
повесила	*повесила	повісила	1
попросил	*попросил	попрохав	1
бельгии	*бельгии	бельгії	1
паразитов	*паразитов	паразитів	1
пьян	*пьян	п'яний"	1
пожелать	*пожелать	побажати	1
повезёт	*повезёт	пощастить	1
пролежал	*пролежал	пролежав	1
диснейленд	*диснейленд	діснейленд	1
нила	*нила	ніла	1
нашего	*нашего	нашого	1
птеранодоны	*птеранодоны	птеранодони	1
младше	*младше	молодшою	1
пятом	*пятом	"п'ятому	1
коронёром	*коронёром	коронером	1
захотите	*захотите	схочете	1
дебилка	*дебилка	дебілка	1
залезайте	*залезайте	залазьте	1
замерли	*замерли	завмерли	1
напирайте	*напирайте	напирайте	1
солдафон	*солдафон	солдафон	1
осколки	*осколки	осколки	1
страстно	*страстно	пристрасно	1
лучшим	*лучшим	найкращим	1
трёх	*трёх	трьох	1
довольна	*довольна	задоволена	1
портсигар	*портсигар	портсигар	1
вышивания	*вышивания	вишивання	1
жребий	*жребий	жереб	1
витамины	*витамины	вітаміни	1
минеральная	*минеральная	мінеральна	1
подготовилась	*подготовилась	підготувалася	1
янина	*янина	яніна	1
водохранилище	*водохранилище	водосховищі	1
джимми	*джимми	джиммі	1
мексиканской	*мексиканской	мексиканської	1
верёвку	*верёвку	мотузку	1
тряслись	*тряслись	тряслись	1
марка	*марка	марка	1
сильнейшее	*сильнейшее	найсильніша	1
родила	*родила	народила	1
намажь	*намажь	намаж	1
слушайтесь	*слушайтесь	слухайтеся	1
спорят	*спорят	сперечаються	1
звонил	*звонил	дзвонив	1
истоптана	*истоптана	потоптана	1
спиртное	*спиртное	спиртне	1
наплевать	*наплевать	начхати	1
притворяются	*притворяются	прикидаться	1
яндекс	*яндекс	яндекс	1
восьмидесятых	*восьмидесятых	вісімдесятих	1
засыпать	*засыпать	засипати	1
переночевать	*переночевать	переночувати	1
катаются	*катаются	катаються	1
придержи	*придержи	притримайте	1
прогулялся	*прогулялся	прогулявся	1
покрасят	*покрасят	пофарбують	1
болтай	*болтай	базікай	1
высох	*высох	висох	1
раскаиваюсь	*раскаиваюсь	розкаююся	1
пиджак	*пиджак	піджак	1
уайт	*уайт	уайт	1
тайский	*тайский	тайська	1
допотопными	*допотопными	допотопними	1
кимуру	*кимуру	кімуру	1
рик	*рик	рік	1
начерти	*начерти	накресли	1
макароны	*макароны	макарони	1
пожмём	*пожмём	потиснемо	1
измученный	*измученный	змучений	1
утонул	*утонул	потонув	1
мелодичен	*мелодичен	милозвучна	1
черная	*черная	чорна	1
взяться	*взяться	взятися	1
силур	*силур	силур	1
жалким	*жалким	жалюгідним	1
лиссабоне	*лиссабоне	лісабоні	1
неразговорчив	*неразговорчив	неговіркий	1
изысканный	*изысканный	вишуканий	1
точнее	*точнее	точніше	1
жгучей	*жгучей	пекучої	1
индивидуалист	*индивидуалист	індивідуаліст	1
равносилен	*равносилен	рівносильна	1
посылаю	*посылаю	надсилаю	1
помыть	*помыть	вимити	1
шоколадного	*шоколадного	шоколадного	1
фламинго	*фламинго	фламінго	1
женаты	*женаты	одружений	1
стареет	*стареет	старішає	1
бена	*бена	бена	1
венера	*венера	венера	1
панды	*панды	панди	1
дружелюбные	*дружелюбные	дружелюбні	1
полставки	*полставки	півставки	1
встаю	*встаю	шостій	1
ведро	*ведро	відро	1
кивнул	*кивнул	кивнув	1
презервативов	*презервативов	презервативів	1
покачал	*покачал	похитав	1
дурачествами	*дурачествами	дурощами	1
холера	*холера	холера	1
отрастил	*отрастил	відростив	1
тварь	*тварь	тварюка	1
помойте	*помойте	вимийте	1
биллу	*биллу	біллу	1
разбежались	*разбежались	розбіглися	1
двадцатилетняя	*двадцатилетняя	двадцятирічна	1
последнего	*последнего	останнього	1
потрясающий	*потрясающий	вражаючим	1
вентиля	*вентиля	вентиля	1
курит	*курит	курить	1
купальник	*купальник	купальник	1
лёко	*лёко	льоко	1
познакомиться	*познакомиться	познайомитися	1
гнездышко	*гнездышко	гніздечко	1
сомневаюсь	*сомневаюсь	сумніваюся	1
поторопись	*поторопись	поквапся	1
хм	*хм	гм	1
шумите	*шумите	шуміть	1
согласиться	*согласиться	погодитися	1
убирайся	*убирайся	забирайся	1
окончено	*окончено	закінчено	1
блейк	*блейк	блейка	1
терпеливым	*терпеливым	терплячим	1
разобрать	*разобрать	розібрати	1
плевал	*плевал	плював	1
смазал	*смазал	змастив	1
римлян	*римлян	римлян	1
средиземное	*средиземное	середземне	1
наивный	*наивный	наївний	1
бузина	*бузина	бузина	1
ежа	*ежа	їжака	1
ме	*ме	бе	1
старался	*старался	намагався	1
близких	*близких	близьких	1
облетела	*облетела	розлетілася	1
чаевые	*чаевые	чайові	1
