subject - тақырып , сабақ , пән
city - қала , қалашық
to learn - оқы , біл
get food - ас ал , ас тап
fine - жақсы , штраф
fire - өрте , қуыл
fell - түс , құла 
break - сындыр, бұз
run - жүгір , басқар , қаш
well - жақсы , құдық
crane - кран , тырна
slow - ақырын , артта
health - ахуал , денсаулық
mean - білдір , орта
formal - формальды , ресми
way - жол , пікір
orderly - дұрыс , тату
penalty - жаза , ескерту , штраф
ugly - сұсты , кейіпсіз
items - жиhаз , дана
dwarf - айдап жіберу , тықсыртқыз , тықсырттыр , тықсырт , тықсыр , тықсырыл , ығыстыр , ығыстырыл
housewife - үй шаруасындағы әйел , күтуші
classmate - сыныптас , кластас
post - аспирант 
education - білім
schooling - оқу
joint - жік , ұйымшыл
bold - қалың , батыр
rather - тезірек , дегенмен
outspoken - ашық
positive - оңды , позитив
adamant - қайтпас , табанды , адамантты
innocent - айыпсыз , күнәсіз
sister - апа , әпке , тәте 
Chennai - Ченнаи
tamil - тамил 
spacious - айдынды , аумақты , даңғырадай , еркін , кең , мол
commodious - айдынды , аумақты , даңғырадай , еркін , кең , мол
roomy - айдынды , аумақты , даңғырадай , еркін , кең , мол
scarcity - зарар , жетімсіздік, жетіспеушілік , кемдік , тапшылық
brackish - ащылау
giddy - алаңғасар , желөкпе , жеңіл ойлы , жеңілтек , ұстамсыз , ұшқалақ , шошақай
fast - тез
Mumbai - Мумбай
aloud - дауыстап , үн шығарып
sentence - үкім , сөйлем
abandon - жайғар , жайпа , жалма , жой , жоюшылық , құрту , қыру алыстау , аулақтану , қашықтау , айдап шығар , қуып шығар , шығарып жібер , жұл , кетір , суырып алып таста
abandonment - болдырма , бұзу , жойыл , жой , кейінге қалдыр , өзгерт , бас тарт , қабыл алма , тоқтап қал
abbreviation - азайту; кеміту; қысқарту; қысқару; қысқарылу; шағындау; ықшамдау
abbreviation - аббревиатура , қысқарма 
ability -  алғырлық , қабілеттілік , жүйріктік , зеректік ,  мүмкіндік , тәсілқойлық , еп , ептілік , епшілдік , икем , икемділік , шеберлік , іскерлік , істей біл , мүмкіншілік
abnormal - жұмысқа жарамайтын , қабілетсіз , шалымсыз , авариялық , апаттық , нормаға сәйкес келмейтін
bort -  басылу , қысқарт , тоқтал , тоқта 
about - жақын , жуық , қаптал , мыңдай , тарта , шақтағанда , шақты , шама , шамада , шамалап , шамамен , шамасы , шамасында
abridge -  қысқарт , ықшамда , азайт , кеміт , қысқарт ,  шағында
abridgement - қысқартy , ықшамдаy , азайтy , кемітy , қысқартy ,  шағындаy
abs - абсолюттік мән , функция , жоқ , жоқ болған , келмеген , келмей қалушы , қатыспаушы
accelerator -  жылдамдатқыш , тездеткіш , үдеткіш , акселератор
accept -  жақтыр , жарату , қоста , қошта , мақұлда , ал , қабыл ал , қабыл ет
access - іріктеме , қолжетімділік , мүмкіндік , рұқсат , ұлықсат , үндеу
accident - кездейсоқтық ,  апат , жаңылу , шалысу , іркілу 
account - есептеу , санау , есептесу , есеп , есеп жазбасы , есеп жүргізу
