KEY
гэта	этот	это	
еўропа — гэта кантынент .	европа — этот континент .	европа - это континент .	
еўропа — гэта кантынент .	европа — этот континент .	европа - это континент .	
суматра — гэта выспа .	*суматра — этот остров .	суматра — это остров .	
суматра — гэта выспа .	*суматра — этот остров .	суматра — это остров .	
еўропа — гэта паўвостраў у заходняй еўразіі	европа — этот полуостров в западной евразии	европа — это полуостров в западной евразии	
чый гэта парасон ?	чей этот зонтик ?	чей это зонтик ?	
індустрыялізацыя — гэта пытанне канкурэнтаздатнасці	*індустрыялізацыя — этот вопрос *канкурэнтаздатнасці	индустриализация - это вопрос конкурентоспособности	
індустрыялізацыя — гэта пытанне канкурэнтаздатнасці казахстана	*індустрыялізацыя — этот вопрос *канкурэнтаздатнасці казахстана	индустриализация - это вопрос конкурентоспособности казахстана	
індустрыялізацыя — гэта пытанне канкурэнтаздатнасці казахстана ў	*індустрыялізацыя — этот вопрос *канкурэнтаздатнасці казахстана в	индустриализация - это вопрос конкурентоспособности казахстана в	
я дам гэта тому .	я дам этот тому .	я дам это тому .	
квінтэсенцыя свабоды — гэта матэматыка	*квінтэсенцыя свободы — этот математика	квинтэссенция свободы — это математика	
квінтэсенцыя свабоды — гэта матэматыка .	*квінтэсенцыя свободы — этот математика .	квинтэссенция свободы — это математика .	
гэта хлопчык .	этот мальчик .	это мальчик .	
гэта аловак .	этот карандаш .	это карандаш .	
гэта кот ці сабака ?	этот кот или собака ?	это кот или собака ?	
спаць на дыване — гэта	*спаць на ковре — этот	спать на ковре — это	
спаць на дыване — гэта клас .	*спаць на ковре — этот класс .	спать на ковре — это класс .	
вайна — гэта пекла .	война — этот ад .	война - это ад .	
вайна — гэта пекла .	война — этот ад .	война - это ад .	



KEY
вядомае	известной	известно	
возера товада вядомае сваёй прыгажосцю .	озеро *товада известной своей красотой .	озеро товада известно своей красотой .	
возера товада вядомае сваёй прыгажосцю .	озеро *товада известной своей красотой .	озеро товада известно своей красотой .	



KEY
другая	вторая	второй	
— другая па даўжыні рака ў свеце свеце ніла	— вторая по длине рака в мире после *ніла	амазонка второй по длине рекой в \u200b\u200bмире после нила	



KEY
элегантная	элегантная	элегантна	
 ж элегантная , як мая	 ж элегантная , как мая	 же элегантна , как .	



KEY
сваё	своё	свое	
люся ненавідзела сваё імя .	*люся *ненавідзела своё имя .	люся ненавидела свое имя .	
люся ненавідзела сваё імя .	*люся *ненавідзела своё имя .	люся ненавидела свое имя .	
люся ненавідзела сваё імя .	*люся *ненавідзела своё имя .	люся ненавидела свое имя .	



KEY
кітайскай	китайской	китайском	
каб элементы меню на кітайскай	чтобы элементы меню на китайской	чтобы элементы меню на китайском	



KEY
шаўкоўніцай	шелковицей	шелковницей	
ззяюць на чатыры свету свету . яно завецца шаўкоўніцай	*ззяюць на четыре бока мира . оно *завецца шелковицей	сияют на четыре стороны света . оно называется шелковницей	
свету свету . яно завецца шаўкоўніцай блукання . зрабіць	бока мира . оно *завецца шелковицей блуждания . *зрабіць	стороны света . оно называется шелковницей блуждания . если	



KEY
маё	моё	моём	
гэта песня заўжды нагадвае мне пра маё дзяцінства	эта пёсня всегда *нагадвае мне о моё детство	эта песня всегда напоминает мне о моём детстве	
заўжды нагадвае мне пра маё дзяцінства .	всегда *нагадвае мне о моё детство .	всегда напоминает мне о моём детстве .	
нагадвае мне пра маё дзяцінства .	*нагадвае мне о моё детство .	напоминает мне о моём детстве .	



KEY
беларускае	белорусской	белорусское	
купляйце беларускае !	*купляйце белорусской !	покупайте белорусское !	
купляйце беларускае !	*купляйце белорусской !	покупайте белорусское !	



KEY
адкрытым	открытым	открытыми	
tatoeba — праэкт з адкрытым крынічным кодам	tatoeba — *праэкт с открытым *крынічным кодом	tatoeba — проект с открытыми исходными кодами	
tatoeba — праэкт з адкрытым крынічным кодам	tatoeba — *праэкт с открытым *крынічным кодом	tatoeba — проект с открытыми исходными кодами	
— праэкт з адкрытым крынічным кодам	— *праэкт с открытым *крынічным кодом	— проект с открытыми исходными кодами	
праэкт з адкрытым крынічным кодам	*праэкт с открытым *крынічным кодом	проект с открытыми исходными кодами	



KEY
важныя	важные	важны	
гарантыі правоў жанчын вельмі важныя для нацыі .	гарантии прав женщин очень важные для нации .	гарантии прав женщин очень важны для нации .	



KEY
адкрыты	открытый	открыты	
краінай нашай краінай адкрыты новыя перспектывы .	перед нашей страной открытый новые перспективы .	перед нашей страной открыты новые перспективы .	



KEY
адчыненымі	открытыми	открытой	
хто пакінуў дзверы адчыненымі ?	кто оставил *дзверы открытыми ?	кто оставил дверь открытой ?	
хто пакінуў дзверы адчыненымі ?	кто оставил *дзверы открытыми ?	кто оставил дверь открытой ?	



KEY
заняпад	упадок	упадке	
як люстра , можно даведацца пра ўзвышэнне і заняпад	как люстра , можно *даведацца о возвышение и упадок	историю как , можно узнать о возвышении и упадке	



KEY
богу	боге	богу	
дзякуй богу .	*дзякуй боге .	слава богу .	
дзякуй богу .	*дзякуй боге .	слава богу .	



KEY
»	тебе	тебе"	
 слова « не » »	 слово « не » тебе	" слова `` нет '' тебе"	
 слова « « » »	 слово « нету » тебе	" слова `` нет '' тебе"	



KEY
парнаграфію	детскую	детской	
па закону пра дзіцячую парнаграфію .	*засудзяць по закона о детскую порнографию	осудят по закону о детской порнографии	
закону пра дзіцячую парнаграфію .	по закона о детскую порнографию	по закону о детской порнографии	



KEY
,	кто	это	
« « , , хто ?	« *ало , кто эта ?	« алло , это кто ?	
« « , , хто ? ?	« *ало , кто эта ? »	« алло , это кто ? »	
« « , , хто ? ?	« *ало , кто эта ? »	« алло , это кто ? »	
« « , , хто ? ?	« *ало , кто эта ? »	« алло , это кто ? »	



KEY
замежных	иностранных	иностранным	
у некаторых абласцях францыі забаронены доступ да замежных сайтаў	в некоторых областях франции запрещённый доступ к иностранных *сайтаў	в некоторых областях франции запрещён доступ к иностранным сайтам	
забаронены доступ да замежных сайтаў для дарослых .	запрещённый доступ к иностранных *сайтаў для взрослых .	запрещён доступ к иностранным сайтам для взрослых .	



KEY
вывучыць	изучить	научиться	
нешта , што немагчыма вывучыць у берліне , акрамя	что-то , что невозможно изучить в берлине , кроме	что-то , чему нельзя научиться в берлине , кроме	



KEY
надзелены	наделённый	наделены	
. яны надзелены розумам i сумленнем i i павiнны	. яны наделённый умом i совестью i *павi*нны *ставi*цца	правах . наделены разумом и совестью и поступать в	
надзелены розумам i сумленнем i i павiнны ставiцца адзiн	наделённый умом i совестью i *павi*нны *ставi*цца *адзi*н к	наделены разумом и совестью и поступать в отношении друг	



KEY
пачаўся	начался	началось	
учасна , і сход пачаўся позна .	*учасна , и собрание начался поздно .	подошёл , и собрание началось поздно .	



KEY
прыпынак	остановка	остановку	
аўтобус прыедзе на прыпынак праз пятнаццаць хвілін .	автобус приедет на остановка через *пятнаццаць минут .	автобус приедет на остановку через пятнадцать минут .	
прыедзе на прыпынак праз пятнаццаць хвілін .	приедет на остановка через *пятнаццаць минут .	приедет на остановку через пятнадцать минут .	



KEY
ранняй	ранним	раннем	
у ранняй творчасці пісьменніка праяўляліся тыя	в ранним творчестве писателя *праяўляліся те	в раннем творчестве писателя проявлялись те	
у ранняй творчасці пісьменніка праяўляліся тыя ж тэмы ,	в ранним творчестве писателя *праяўляліся те ж темы ,	в раннем творчестве писателя проявлялись те же темы ,	



KEY
два	два	две	
у нашым доме два вольныя пакоі	в нашим доме два *вольныя комнате	в нашем доме две свободные комнаты	
у нашым доме два вольныя пакоі .	в нашим доме два *вольныя комнате .	в нашем доме две свободные комнаты .	
у нашым доме два вольныя пакоі .	в нашим доме два *вольныя комнате .	в нашем доме две свободные комнаты .	
нашым доме два вольныя пакоі .	нашим доме два *вольныя комнате .	нашем доме две свободные комнаты .	
я папрасіў два кубкі гарбаты і тры	я попросил два кубки горбатый и три	я попросил две чашки и три чашки	
я папрасіў два кубкі гарбаты і тры кубкі	я попросил два кубки горбатый и три кубки	я попросил две чашки и три чашки кофе	



KEY
турэцкай	турецкой	турецком	
вы ствараеце на татоэбе сказы на турэцкай і	вы *ствараеце на *татоэбе предложения на турецкой и	вы создаёте на татоэбе предложения на турецком и	
на татоэбе сказы на турэцкай і эстонскай , вельмі	на *татоэбе предложения на турецкой и *эстонскай , очень	на татоэбе предложения на турецком и эстонском , очень	
сказы на турэцкай і эстонскай , вельмі верагодна ,	предложения на турецкой и *эстонскай , очень вероятно ,	предложения на турецком и эстонском , очень вероятно ,	



KEY
песнямі	пёснями	песнями	
не прызначаная для абмену песнямі ? ! і як	не назначенная для обмена пёснями ? ! и как	не предназначена для обмена песнями ? ! и как	



KEY
,	он	она	
наснілася , ці , , якому , што ён	что он *чжуанцзы , или бабочка , которому *наснілася	что она чжуан-цзы , который проснувшись , долго не	



KEY
беларускую	белорусскую	белорусский	
што ніхто тут не вывучае беларускую .	что никто здесь не *вывучае белорусскую .	что никто здесь не изучает белорусский .	
ніхто тут не вывучае беларускую .	никто здесь не *вывучае белорусскую .	никто здесь не изучает белорусский .	



KEY
чалавека	человека	человеку	
ў адносінах да чалавека застаўляе тысячы людзей тужыць .	в отношениях к человека *застаўляе тысяче людей *тужыць .	бесчеловечность бога к человеку заставляет бесчисленные множества роптать .	



KEY
гэта	эта	этот	
гэта гарбата занадта гарачая .	эта горбато слишком горячая .	этот чай слишком горячий .	
гэта гарбата занадта гарачая .	эта горбато слишком горячая .	этот чай слишком горячий .	
гэта гарбата занадта гарачая .	эта горбато слишком горячая .	этот чай слишком горячий .	



KEY
іх	изменилась	поменялось	
. » . часу цягам часу іх на «	. с тягам времени них значение изменилась на «	`` . с времени их значение поменялось на ``	



KEY
кветкі	цветка	цветы	
сарваныя кветкі хутка вянуць .	*сарваныя цветка быстро *вянуць .	сорванные цветы быстро вянут .	
сарваныя кветкі хутка вянуць .	*сарваныя цветка быстро *вянуць .	сорванные цветы быстро вянут .	
сарваныя кветкі хутка вянуць .	*сарваныя цветка быстро *вянуць .	сорванные цветы быстро вянут .	
кветкі засыхалі без вады .	цветка *засыхалі без изъяна .	цветы засыхали без воды .	
кветкі засыхалі без вады .	цветка *засыхалі без изъяна .	цветы засыхали без воды .	
кветкі засыхалі без вады .	цветка *засыхалі без изъяна .	цветы засыхали без воды .	
не чапай кветкі .	не *чапай цветка .	не трогай цветы .	
не чапай кветкі .	не *чапай цветка .	не трогай цветы .	



KEY
будучыні	будущем	будущего	
лацінская — мова будучыні !	латинская — язык будущем !	латинский — язык будущего !	
лацінская — мова будучыні !	латинская — язык будущем !	латинский — язык будущего !	



KEY
золата	золото	золота	
мы ўсе пайшлі на пошукі золата .	мы все пошли на поиски золото .	мы все отправились на поиски золота .	
ўсе пайшлі на пошукі золата .	все пошли на поиски золото .	все отправились на поиски золота .	



KEY
сэрца	сердце	сердцу	
не бяры гэта блізка да сэрца .	не бери эта близко к сердце .	не бери это близко к сердцу .	
бяры гэта блізка да сэрца .	бери эта близко к сердце .	бери это близко к сердцу .	



KEY
меркаванні	мнении	мнения	
гэта два абсалютна розныя меркаванні	эта два абсолютно разные мнении	это два абсолютно различных мнения	
гэта два абсалютна розныя меркаванні .	эта два абсолютно разные мнении .	это два абсолютно различных мнения .	
гэта два абсалютна розныя меркаванні .	эта два абсолютно разные мнении .	это два абсолютно различных мнения .	



KEY
белае	белого	белое	
ці падабаецца вам белае віно ?	или *падабаецца вам белого вино ?	нравится ли вам белое вино ?	



KEY
большы	больший	больше	
тэхас амаль удвая большы за	*тэхас почти вдвое больший за	техас почти вдвое больше японии	



KEY
краіна	страна	страны	
кожная краіна мае дзяржаўны сцяг .	каждая страна мои государственное знамя .	каждой страны есть государственный флаг .	



KEY
жудаснага	ужасного	ужасному	
здзівіўся з яго жудаснага апетыту .	удивился с его ужасного аппетита .	повар удивился его ужасному аппетиту .	



KEY
зоркі	звезды	звёзды	
зоркі раскіданыя па ўсяму небу	звезды *раскіданыя по всему ночному	звёзды разбросаны по всему ночному	
зоркі раскіданыя па ўсяму небу небу	звезды *раскіданыя по всему ночному небу	звёзды разбросаны по всему ночному небу	
зоркі зоркі бачна праз агні	звезды плохо видно через огне	звёзды плохо видно сквозь огни	
зоркі зоркі бачна праз агні горада .	звезды плохо видно через огне города .	звёзды плохо видно сквозь огни города .	
зоркі зоркі бачна праз агні горада .	звезды плохо видно через огне города .	звёзды плохо видно сквозь огни города .	



KEY
эзатэрычных	эзотерических	экзотерических	
ўзроўні эзатэрычных абрадаў , прыстасаваных да і побыту арабаў	уровне эзотерических обрядов , *прыстасаваных к и быта арабов	уровне экзотерических обрядов , приспособленных к и быту арабов	



KEY
раней	ранее	раньше	
я ніколі раней не чуў пра львоў	я никогда ранее не *чуў о *львоў	я никогда раньше не слышал о львове	
я ніколі раней не чуў пра львоў .	я никогда ранее не *чуў о *львоў .	я никогда раньше не слышал о львове .	
раней не чуў пра львоў .	ранее не *чуў о *львоў .	раньше не слышал о львове .	
так часта , як раней .	так часто , как ранее .	так часто , как раньше .	
раней я гуляў з сваёй	ранее я *гуляў со своей	раньше я играл со своей	
раней я гуляў з сваёй сястрой у	ранее я *гуляў со своей сестрой в	раньше я играл со своей сестрой в	
ўпэўнены , што не бачыў яго раней .	убеждённый , что не *бачыў его ранее .	я , что не видел его раньше .	
што не бачыў яго раней .	что не *бачыў его ранее .	что не видел его раньше .	
хатніх жывёлаў , але раней ён трымаў сабаку .	домашних *жывёлаў , но ранее он держал собаку .	нет домашних , но раньше он держал собаку .	



KEY
б	бы	вы	
б вы мне сказаць , як дайсці да вакзала	бы вы мне *сказаць , как дойти к вокзала	вы мне сказать , как дойти до вокзала ?	



KEY
адно	одно	один	
магу адказаць ні на адно пытанне у гэтым тэсце	маге ответить ни на одно вопрос в этим тесте	могу ответить ни на один вопрос в этом тесте	
на адно пытанне у гэтым тэсце .	на одно вопрос в этим тесте .	на один вопрос в этом тесте .	
ён задаў мне адно пытанне .	он задал мне одно вопрос .	он задал мне один вопрос .	



KEY
замка́	замка́	замка	
мне ключ ад гэтага замка́ .	мне ключ от этого замка́ .	мне ключ от этого замка .	



KEY
май	май	имей	
не май сто рублёў , а	не май сто рублей , а	не имей сто рублей , а	
сто рублёў , а май сто сяброў .	сто рублей , а май сто членов .	сто рублей , а имей сто друзей .	



KEY
апошнім	последним	последнее	
апошнім часам ён зашмат п	последним иногда он многовато пьёт	последнее время он слишком много	



KEY
у	в	во	
у сусвеце шмат галактык .	в вселенной много галактик .	во вселенной много галактик .	
на сваёй радзіме , у францыі , праэкт tatoeba	на своей родине , в франции , *праэкт tatoeba	себя на родине , во франции , проект tatoeba	
а я зараз у львове !	а я сейчас в *львове !	а я сейчас во львове !	
а я зараз у львове !	а я сейчас в *львове !	а я сейчас во львове !	
 у сусвеце шмат галактык .	 в вселенной много галактик .	 во вселенной есть много галактик	
пераканала мужа правесці водпуск у францыі .	убедила мужа провести отпуск в франции .	убедила мужа провести отпуск во франции .	
у многіх краінах іслам асвойваецца	в *многіх странах *іслам *асвойваецца	во многих странах ислам осваивается	
у многіх краінах іслам асвойваецца ў	в *многіх странах *іслам *асвойваецца в	во многих странах ислам осваивается в	
у многіх краінах іслам асвойваецца ў адрыве ад	в *многіх странах *іслам *асвойваецца в отрыве от	во многих странах ислам осваивается в отрыве от	
у многіх краінах іслам асвойваецца ў адрыве ад сваёй	в *многіх странах *іслам *асвойваецца в отрыве от своей	во многих странах ислам осваивается в отрыве от своей	



KEY
ўсё	всё	все	
я люблю ўсё на свеце .	я *люблю всё на мире .	я люблю все на свете .	
я люблю ўсё на свеце .	я *люблю всё на мире .	я люблю все на свете .	
я люблю ўсё на свеце .	я *люблю всё на мире .	я люблю все на свете .	
клава ўсё спрошчвае .	*клава всё *спрошчвае .	клава все упрощает .	
клава ўсё спрошчвае .	*клава всё *спрошчвае .	клава все упрощает .	
клава ўсё спрошчвае .	*клава всё *спрошчвае .	клава все упрощает .	



KEY
адзін	один	одна	
юэбін — гэта адзін з	*юэбін — эта один с	юэбин - это одна из	
юэбін — гэта адзін з кітайскіх	*юэбін — эта один с китайских	юэбин - это одна из разновидностей	
юэбін — гэта адзін з кітайскіх ласункаў	*юэбін — эта один с китайских лакомств	юэбин - это одна из разновидностей китайских	
 адзін з кітайскіх ласункаў .	 один с китайских лакомств .	 одна из разновидностей китайских сладостей	



KEY
апетыту	аппетита	аппетиту	
здзівіўся з яго жудаснага апетыту .	удивился с его ужасного аппетита .	повар удивился его ужасному аппетиту .	



KEY
наша	наш	наша	
наша яда танная .	наш як дешёвая .	наша еда дешёвая .	
наша яда танная .	наш як дешёвая .	наша еда дешёвая .	



KEY
бацька	отец	отца	
бацька мае звычку чытаць газеты	отец мои привычку *чытаць газеты	отца есть привычка читать газеты	



KEY
на	на	наши	
з другога боку , , толькі на на свой	соседи со второго боке , но только на свой	мы . вот вам наши порядки , наши школы	



KEY
не	не	на	
. калі скупы адмаўляецца , пачаставаць работнікаў , не	. когда скупой и *адмаўляецца *пачаставаць работников , не	черепичным пивом » , чтобы это отпраздновать . на	



KEY
«	нету	нет	
 слова « « » »	 слово « нету » тебе	" слова `` нет '' тебе"	



KEY
невялікім	небольшим	небольшом	
яна вырасла ў невялікім мястэчку .	яна выросла в небольшим местечке .	она выросла в небольшом городке .	
яна вырасла ў невялікім мястэчку .	яна выросла в небольшим местечке .	она выросла в небольшом городке .	



KEY
ў	в	во	
хачу ў львоў ...	хочу в *львоў ...	хочу во львов ...	
хачу ў львоў ...	хочу в *львоў ...	хочу во львов ...	



KEY
дзяцінства	детство	детстве	
гэта песня заўжды нагадвае мне пра маё дзяцінства	эта пёсня всегда *нагадвае мне о моё детство	эта песня всегда напоминает мне о моём детстве	
заўжды нагадвае мне пра маё дзяцінства .	всегда *нагадвае мне о моё детство .	всегда напоминает мне о моём детстве .	
нагадвае мне пра маё дзяцінства .	*нагадвае мне о моё детство .	напоминает мне о моём детстве .	



KEY
былі	тем	этом	
былі месцы заўжды прыцемкі прыцемкі .	тем месте всегда были полумраки .	этом месте был вечный сумрак .	



KEY
гэтым	этим	этом	
у гэтым класе 40 вучняў .	в этим классе 40 учеников .	в этом классе 40 учеников .	
магу адказаць ні на адно пытанне у гэтым тэсце	маге ответить ни на одно вопрос в этим тесте	могу ответить ни на один вопрос в этом тесте	
на адно пытанне у гэтым тэсце .	на одно вопрос в этим тесте .	на один вопрос в этом тесте .	
расце людзей , што улоўліваць у гэтым гуцы толькі	растёт людей , что *улоўліваць в этим *гуцы только	годы растет людей , улавливающих в этом лишь какофонию	
у гэтым парку шмат дрэў ?	в этим парк много деревьев ?	в этом парке много деревьев ?	
у гэтым парку шмат дрэў ?	в этим парк много деревьев ?	в этом парке много деревьев ?	



KEY
выдуманая	вымышленная	вымышленное	
цмок — гэта выдуманая істота .	дракон — эта вымышленная *істота .	дракон — это вымышленное существо .	
цмок — гэта выдуманая істота .	дракон — эта вымышленная *істота .	дракон — это вымышленное существо .	
цмок — гэта выдуманая істота .	дракон — эта вымышленная *істота .	дракон — это вымышленное существо .	



KEY
такі	токи	таким	
гэта ты стаў такі вядомы , што фарамп пісаць	эта ты пруд токи известный , что *фарамп *пісаць	как это ты таким известным , что фарамп писать	
такі вядомы , што фарамп пісаць пра цябе ?	токи известный , что *фарамп *пісаць о тебя ?	таким известным , что фарамп писать про тебя ?	



KEY
згвалтаванне	изнасилование	изнасиловании	
могуць перадаць у суд сведчанні пра згвалтаванне дзіцяці ,	могут передать в суд свидетельстве о изнасилование ребёнке ,	могут передать в суд свидетельства об изнасиловании ребёнка ,	
перадаць у суд сведчанні пра згвалтаванне дзіцяці , бо	передать в суд свидетельстве о изнасилование ребёнке , так	передать в суд свидетельства об изнасиловании ребёнка , так	
у суд сведчанні пра згвалтаванне дзіцяці , бо іх	в суд свидетельстве о изнасилование ребёнке , так как	в суд свидетельства об изнасиловании ребёнка , так как	
суд сведчанні пра згвалтаванне дзіцяці , бо іх саміх	суд свидетельстве о изнасилование ребёнке , так как них	суд свидетельства об изнасиловании ребёнка , так как их	



KEY
розныя	разные	различных	
гэта два абсалютна розныя меркаванні	эта два абсолютно разные мнении	это два абсолютно различных мнения	
гэта два абсалютна розныя меркаванні .	эта два абсолютно разные мнении .	это два абсолютно различных мнения .	
гэта два абсалютна розныя меркаванні .	эта два абсолютно разные мнении .	это два абсолютно различных мнения .	



KEY
зрабіў	эта	это	
паслаць табе зефір , , , я гэта зрабіў	послать тебе *зефір , *чанг , я бы эта	тебе зефир , чанг , я сделал бы это	



KEY
сястра	сестра	сестры	
 сястра не мае вышэйшае асветы	 сестра не мои высшего просвещения	 сестры нет высшего образования .	



KEY
,	что	то	
а , тое , , мы . дык дык	а то самой , что мы . *дык *наце	не вы , а то самое , что мы	



KEY
дзяржаўны	государственное	государственный	
кожная краіна мае дзяржаўны сцяг .	каждая страна мои государственное знамя .	каждой страны есть государственный флаг .	



KEY
люстра	разбитой	разбитое	
а люстра люстра абяцала сем год год .	а разбитой люстра *абяцала ней семь год несчастья	а разбитое обещало ей семь лет несчастий .	
люстра люстра абяцала сем год год .	разбитой люстра *абяцала ней семь год несчастья	разбитое обещало ей семь лет несчастий .	



KEY
халодная	холодная	холодное	
кава халодная .	кофе холодная .	кофе холодное .	



KEY
ён	он	она	
ці месяц ? вядома ж месяц , ён свеціць	или месяц ? конечно ж месяц , он *свеціць	или луна ? конечно же луна , она светит	
месяц ? вядома ж месяц , ён свеціць ,	месяц ? конечно ж месяц , он *свеціць ,	луна ? конечно же луна , она светит ,	
вядома ж месяц , ён свеціць , калі ,	конечно ж месяц , он *свеціць , когда темно	конечно же луна , она светит , темно ,	
ж месяц , ён свеціць , калі , ,	ж месяц , он *свеціць , когда темно ,	же луна , она светит , темно , а	
ён свеціць , калі , , а свеціць толькі	он *свеціць , когда темно , а солнце *свеціць	она светит , темно , а солнце светит только	



KEY
афарызмы	который	которой	
: часам , афарызмы , ці піша , часам	: шахматист , который иногда *піша афоризмы , *афарыст	он бабочка , которой снится , что она чжуан-цзы	



KEY
другога	со	то	
з другога боку , , толькі на на свой	соседи со второго боке , но только на свой	а то самое , что мы . вот вам	



KEY
хвіліну	минуту	минутку	
хвіліну ! не кладзіце трубку	минуту ! не кладите трубку	минутку ! не кладите трубку	



KEY
направа	направо	вправо	
перасунь палец налева ці направа	*перасунь палец налево или направо	передвинь палец влево или вправо	
перасунь палец налева ці направа , каб	*перасунь палец налево или направо , чтобы	передвинь палец влево или вправо , чтобы	
перасунь палец налева ці направа , каб пабачыць іншую	*перасунь палец налево или направо , чтобы *пабачыць другое	передвинь палец влево или вправо , чтобы увидеть другое	
ці направа , каб пабачыць іншую жывёлу .	или направо , чтобы *пабачыць другое животное .	или вправо , чтобы увидеть другое животное .	



KEY
жыхарства	жительство	жительства	
у суботніках па месцу жыхарства і працы .	в субботниках по месту жительство и работе .	в субботниках по месту жительства и работы .	
па месцу жыхарства і працы .	по месту жительство и работе .	по месту жительства и работы .	



KEY
прыродныя	природные	природными	
што багатыя на прыродныя рэсурсы .	что богатые на природные ресурсы .	стран , изобилующих природными ресурсами .	



KEY
пялёнак	пелён	пелёнок	
палітыкі , ён усё яшчэ не вылез з пялёнак	политики , он всё ещё не *вылез с пелён	политики , он всё еще не вылез из пелёнок	
ён усё яшчэ не вылез з пялёнак .	он всё ещё не *вылез с пелён .	он всё еще не вылез из пелёнок .	
усё яшчэ не вылез з пялёнак .	всё ещё не *вылез с пелён .	всё еще не вылез из пелёнок .	



KEY
дамашняе	домашнего	домашнее	
ты сам рабіў дамашняе заданне ?	ты сам *рабіў домашнего задание ?	ты сам делал домашнее задание ?	
ты сам рабіў дамашняе заданне ?	ты сам *рабіў домашнего задание ?	ты сам делал домашнее задание ?	



KEY
?	?	?"	
яны спяць ! » — « ж ж ?	*спяць вместе ! » — « почему ж ?	"они спят вместе ! '' - `` почему-же ?"	



KEY
шчаслівы	счастливый	счастлив	
ты шчаслівы , то я таксама	ты счастливый , то я также	ты счастлив , то и я	



KEY
поспеху	успехе	успехам	
мая цётка радавалася майму поспеху .	мая тётка радовалась моему успехе .	моя тётя радовалась моим успехам .	
мая цётка радавалася майму поспеху .	мая тётка радовалась моему успехе .	моя тётя радовалась моим успехам .	
мая цётка радавалася майму поспеху .	мая тётка радовалась моему успехе .	моя тётя радовалась моим успехам .	



KEY
птушка	птица	птичка	
якая прыгожая птушка !	которая красивая птица !	какая красивая птичка !	
якая прыгожая птушка !	которая красивая птица !	какая красивая птичка !	



KEY
якой	которой	котором	
жа мове , на якой машыністы ў электрычках аб	же языке , на которой машинисты в электричках о	же языке , на котором машинисты в электричках объявляют	



KEY
гэты	этот	это	
паглядзіце на гэты высокі будынак	*паглядзіце на этот высокое здание	посмотрите на это высокое здание	
паглядзіце на гэты высокі будынак .	*паглядзіце на этот высокое здание .	посмотрите на это высокое здание .	
— гэты свет для другой планеты .	— этот ад для вторыми планеты .	— это ад для другой планеты .	



KEY
зайцы	зайце	зайцы	
усе зайцы — казлы !	все зайце — козлы !	все зайцы — козлы !	



KEY
той	тот	той	
па той вуліцы ў той дзень , я б	по та улице в тот день , я бы	я не шёл по той улице в тот день	



KEY
што	эта	это	
« , а а што за за ? »	бабушка , а что эта за ягода ? »	бабушка , а что это за ягода ? »	



KEY
ўрокам	уроком	урокам	
я навучыўся маляваць па яго ўрокам .	я научился *маляваць по его уроком .	я научился рисовать по его урокам .	
навучыўся маляваць па яго ўрокам .	научился *маляваць по его уроком .	научился рисовать по его урокам .	



KEY
паказаў	показов	показал	
ён паказаў мне свой фотаальбом .	он показов мне свой фотоальбом .	он показал мне свой фотоальбом .	



KEY
палічцы	полочке	полке	
на кніжнай палічцы толькі кнігі .	на книжной полочке только книги .	на книжной полке только книги .	



KEY
акружаная	окружённая	окружена	
царква акружаная лясамі і азёрамі .	церковь окружённая лесами и озёрами .	церковь окружена лесами и озерами .	
царква акружаная лясамі і азёрамі .	церковь окружённая лесами и озёрами .	церковь окружена лесами и озерами .	



KEY
грым	грим	гримм	
у братоў грым чырвонае каптурко	в братьев грим красной *каптурко	у братьев гримм красное шапочко	
у братоў грым чырвонае каптурко ніякага роду ,	в братьев грим красной *каптурко никакого рода ,	у братьев гримм красное шапочко рода , а	
у братоў грым чырвонае каптурко ніякага роду , а	в братьев грим красной *каптурко никакого рода , а	у братьев гримм красное шапочко рода , а у	



KEY
ў	который	которой	
афарызмы , ці піша , часам , ў гуляе	который иногда *піша афоризмы , *афарыст , который иногда	снилось , что он бабочка бабочка , которой снилось	



KEY
свой	свой	своё	
я перакладаю на татоэбе ў свой	я *перакладаю на *татоэбе в свой	я перевожу на татоэбе в своё	
я перакладаю на татоэбе ў свой вольны час	я *перакладаю на *татоэбе в свой *вольны время	я перевожу на татоэбе в своё свободное время	
перакладаю на татоэбе ў свой вольны час .	*перакладаю на *татоэбе в свой *вольны время .	перевожу на татоэбе в своё свободное время .	



KEY
хлопчыку	мальчике	мальчик	
хвалюйся , хлопчыку . твой сябра рон знішчаны .	волнуйся , мальчике . *твой член *рон уничтоженный .	волнуйся , мальчик . твой друг рон уничтожен .	
хлопчыку . твой сябра рон знішчаны . мы вырашылі	мальчике . *твой член *рон уничтоженный . мы *вырашылі	мальчик . твой друг рон уничтожен . мы решили	



KEY
ён	что	кто	
сніць , ён чжуанцзы , , які праснуўшыся доўга	*сніць , что он *чжуанцзы , и яки *праснуўшыся	не , кто я , иногда пишет или афорист	



KEY
гэта	эта	это	
 гэта што , жарт такі	 эта что , шутка токи	 это что , шутка ?	
kawa — гэта рэалізацыя мовы scheme для	kawa — эта реализация языка scheme для	kawa — это реализация языка scheme для	
гэта маё жыццё .	эта моя жизнь .	это моя жизнь .	
глядзі , гэта палярная зорка	смотри , эта полярная зорко	гляди , это полярная звезда	
глядзі , гэта палярная зорка .	смотри , эта полярная зорко .	гляди , это полярная звезда .	
глядзі , гэта палярная зорка .	смотри , эта полярная зорко .	гляди , это полярная звезда .	
чый гэта ровар ?	чей эта *ровар ?	чей это велосипед ?	
чый гэта ровар ?	чей эта *ровар ?	чей это велосипед ?	
б з радасцю ўсё гэта пераклаў , але не	бы с радостью всё эта переложил , но не	бы с радостью всё это перевёл , но не	
з радасцю ўсё гэта пераклаў , але не ведаю	с радостью всё эта переложил , но не *ведаю	с радостью всё это перевёл , но не знаю	
гэта ўсё , што я	эта всё , что я	это всё , что я	
гэта было яшчэ да таго	эта бывше ещё к того	это было ещё до того	
гэта было яшчэ да таго ,	эта бывше ещё к того ,	это было ещё до того ,	
гэта было яшчэ да таго , як я	эта бывше ещё к того , как я	это было ещё до того , как я	
словамі гэта апісаць немагчыма .	словами эта описать невозможно .	словами это описать невозможно .	
 гэта таму што ты дзяўчынка	 эта потому что ты девочка	 это потому , что ты	
труба — гэта музычны інструмент .	труба — эта музыкальный инструмент .	труба — это музыкальный инструмент .	
гэта два абсалютна розныя меркаванні	эта два абсолютно разные мнении	это два абсолютно различных мнения	
гэта два абсалютна розныя меркаванні .	эта два абсолютно разные мнении .	это два абсолютно различных мнения .	
гэта два абсалютна розныя меркаванні .	эта два абсолютно разные мнении .	это два абсолютно различных мнения .	
ёсць зубы , то гэта не птушка .	будем зубы , то эта не птица .	. зубы , то это не птица .	
гэта пошта , а то	эта почта , а то	это почта , а то	
гэта не поўнасцю памылкова .	эта не полностью ошибочно .	это не полностью неверно .	
гэта не поўнасцю памылкова .	эта не полностью ошибочно .	это не полностью неверно .	
гэта не дарога , а	эта не дорога , а	это не дорога , а	
гэта цікава .	эта интересно .	это интересно .	
для прагляду выяў . гэта невялічкая праграма з базавай	для просмотра изображений . эта *невялічкая программа с базовой	для просмотра изображений . это небольшая программа с базовой	
прагляду выяў . гэта невялічкая праграма з базавай функцыянальнасцю	просмотра изображений . эта *невялічкая программа с базовой *функцыянальнасцю	просмотра изображений . это небольшая программа с базовой функциональностью	
гэта царква , ў якой	эта церковь , в которой	это церковь , в которой	
гэта нічога не зменіць .	эта ничего не изменит .	это ничего не изменит .	
гэта хітрасць цао цао .	эта хитрость *цао *цао .	это хитрость цао цао .	
гэта хітрасць цао цао .	эта хитрость *цао *цао .	это хитрость цао цао .	
гэта хітрасць цао цао .	эта хитрость *цао *цао .	это хитрость цао цао .	
гэта хітрасць цао цао .	эта хитрость *цао *цао .	это хитрость цао цао .	
гэта хітрасць цао цао .	эта хитрость *цао *цао .	это хитрость цао цао .	
гэта дакладна што , што я	эта точно то , что я	это в точности то , что	
гэта не нож . вось	эта не нож . вот	это не нож . вот	
не нож . вось гэта — нож .	не нож . вот эта — нож .	не нож . вот это - нож .	
нож . вось гэта — нож .	нож . вот эта — нож .	нож . вот это - нож .	
гэта не так гэта ,	эта не так плохо ,	это не так плохо как	
цмок — гэта выдуманая істота .	дракон — эта вымышленная *істота .	дракон — это вымышленное существо .	
цмок — гэта выдуманая істота .	дракон — эта вымышленная *істота .	дракон — это вымышленное существо .	
цмок — гэта выдуманая істота .	дракон — эта вымышленная *істота .	дракон — это вымышленное существо .	
гэта не кроў . гэта	эта не кровь . эта	это не кровь . это	
гэта не кроў . гэта	эта не кровь . эта	это не кровь . это	
 кроў . гэта кроў .	 кровь . эта свёкла .	не кровь . это свёкла .	
гэта не кроў . гэта кроў .	эта не кровь . эта свёкла .	это не кровь . это свёкла .	
гэта не кроў . гэта кроў .	эта не кровь . эта свёкла .	это не кровь . это свёкла .	
не кроў . гэта кроў .	не кровь . эта свёкла .	 кровь . это свёкла .	
цмок — гэта выдуманая істота .	дракон — эта вымышленная *істота .	дракон — это выдуманное существо .	
цмок — гэта выдуманая істота .	дракон — эта вымышленная *істота .	дракон — это выдуманное существо .	
цмок — гэта выдуманая істота .	дракон — эта вымышленная *істота .	дракон — это выдуманное существо .	
гэта было не сапраўднае каханне	эта бывше не настоящей любовь	это не была настоящая любовь	
гэта было не сапраўднае каханне .	эта бывше не настоящей любовь .	это не была настоящая любовь .	
гэта было не сапраўднае каханне .	эта бывше не настоящей любовь .	это не была настоящая любовь .	
гэта залежыць ад сітуацыі .	эта зависит от ситуации .	это зависит от ситуации .	
не ведаю , ці зможаш ты зрабіць гэта сам	не *ведаю , или сможешь ты *зрабіць эта сам	не знаю , сможешь ли ты сделать это сам	
ці зможаш ты зрабіць гэта сам .	или сможешь ты *зрабіць эта сам .	сможешь ли ты сделать это сам .	
гэта толькі фармальнасць .	эта только формальность .	это только формальность .	
гэта не цацка !	эта не игрушка !	это не игрушка !	
для мяне гэта не праблема .	для меня эта не проблема .	для меня это не проблема .	
свабода — гэта свабода сказаць , што	свобода — эта свобода *сказаць , что	свобода — это свобода сказать , что	
свабода — гэта свабода сказаць , што двойчы два	свобода — эта свобода *сказаць , что дважды два	свобода — это свобода сказать , что дважды два	
два — чатыры . гэта ёсць ёсць , то	два — четыре . эта давай будем , то	дважды два четыре . это есть , из этого	
гэта самая абсурдная ідэя ,	эта самая абсурдная идея ,	это самая абсурдная идея ,	
гэта браян рок .	эта *браян *рок .	это брайан рок .	
гэта браян рок .	эта *браян *рок .	это брайан рок .	
гэта браян рок .	эта *браян *рок .	это брайан рок .	
ніхто не ведае , як яны гэта	никто не *ведае , как они эта	никто не знает , как они это	
ведае , як яны гэта робяць і навошта ,	*ведае , как они эта *робяць и зачем ,	знает , как они это делают и зачем ,	
тры і пяць — гэта няцотныя лікі .	три и пять — эта нечётные числа .	три и пять — это нечётные числа .	
я купіў гэта на мінулым тыдні	я *купіў эта на прошлой неделе	я купил это на той неделе	
я купіў гэта на мінулым тыдні .	я *купіў эта на прошлой неделе .	я купил это на той неделе .	
я купіў гэта на мінулым тыдні .	я *купіў эта на прошлой неделе .	я купил это на той неделе .	
паслугі — гэта дзяржаўная манаполія .	услуги — эта государственная монополия .	услуги — это государственная монополия .	
гэта гісторыя адной коткі .	эта история одной *коткі .	это история одной кошки .	
гэта гісторыя адной коткі .	эта история одной *коткі .	это история одной кошки .	
гэта вёска , дзе я	эта деревня , где я	это деревня , где я	
як мне гэта вытрымаць ?	как мне эта выдержать ?	как мне это выдержать ?	
мы мусім абмеркаваць гэта з дырэктарам тэт-а-тэт	мы *мусім *абмеркаваць эта с директором *тэт-а-*тэт	мы должны обсудить это с директором тет-а-тет	
мы мусім абмеркаваць гэта з дырэктарам тэт-а-тэт	мы *мусім *абмеркаваць эта с директором *тэт-а-*тэт	мы должны обсудить это с директором тет-а-тет	
абмеркаваць гэта з дырэктарам тэт-а-тэт	*абмеркаваць эта с директором *тэт-а-*тэт	обсудить это с директором тет-а-тет	
гэта ежа .	эта еда .	это еда .	
як бы мне гэта сказаць	как бы мне эта *сказаць	как бы мне это сказать	
усё гэта толькі ліслівасць .	всё эта только лесть .	все это только лесть .	
усё гэта толькі ліслівасць .	всё эта только лесть .	все это только лесть .	
гэта цікавая кніга .	эта интересная книга .	это интересная книга .	
гэта зроблена ў казахстане .	эта *зроблена в казахстане .	это сделано в казахстане .	
гэта зроблена ў казахстане .	эта *зроблена в казахстане .	это сделано в казахстане .	
не бяры гэта блізка да сэрца .	не бери эта близко к сердце .	не бери это близко к сердцу .	
бяры гэта блізка да сэрца .	бери эта близко к сердце .	бери это близко к сердцу .	
і памёр , ты крыўдуеш . гэта б ты	и умер , ты *крыўдуеш . эта когда бы	и погиб , ты недоволен . это как бы	
для мяне , гэта — не праблема .	для меня , эта — не проблема .	для меня , это — не проблема .	
гэта вельмі смачна .	эта очень вкусно .	это очень вкусно .	
гэта таму што англійская —	эта потому что английская —	это потому что английский —	
гэта таму што англійская — сусветная мова	эта потому что английская — мировой язык	это потому что английский — международный язык	
гэй , пандарку , як гэта ты	*гэй , *пандарку , как эта ты	эй , пандарк , как это ты	
гэта быў найлепшы дзень майго	эта был наилучший день моей	это был лучший день в	
гэта таму што ты заўсёды	эта потому что ты всегда	это потому , что ты	
я не ведаю , што гэта .	я не *ведаю , что эта .	я не знаю , что это .	
не ведаю , што гэта .	не *ведаю , что эта .	не знаю , что это .	
гэта як раз што , пра што	эта как однажды то , о что	это как раз то , о чём	
я забыў , была гэта субота ці нядзеля .	я забыл , была эта суббота или воскресенье .	я забыл , была это суббота или воскресенье .	
я не ведаў , адкуль гэта прыйшло	я не *ведаў , откуда эта пришло	я не знал , откуда это пришло	
не ведаў , адкуль гэта прыйшло .	не *ведаў , откуда эта пришло .	не знал , откуда это пришло .	
гэта мае штаны .	эта мои *штаны .	это мои штаны .	
гэта мае штаны .	эта мои *штаны .	это мои штаны .	
гэта сіні дом .	эта синий дом .	это синий дом .	
што гэта за кніга ?	что эта за книга ?	что это за книга ?	
 гадоў — гэта доўгі тэрмін	 годов — эта длинный термин	 лет - это срок .	
юэбін — гэта адзін з	*юэбін — эта один с	юэбин - это одна из	
юэбін — гэта адзін з кітайскіх	*юэбін — эта один с китайских	юэбин - это одна из разновидностей	
юэбін — гэта адзін з кітайскіх ласункаў	*юэбін — эта один с китайских лакомств	юэбин - это одна из разновидностей китайских	



KEY
наша	наша	наши	
мова такая такая ж , і наша наша ,	ваш язык такая ж , как и наша ,	мы . вот вам наши порядки , наши школы	



KEY
,	что	кто	
што ён , , я таксама , я часу	которому *наснілася , что он *чжуанцзы , я также	с не , кто я , иногда пишет или	



KEY
папсавалі	неё	не	
і наша наша , вы вы папсавалі » »	как и наша , только вы неё *папсавалі »	соседи говорили : « вы — не вы ,	



KEY
поўная	полный	полна	
бутэлька поўная вады .	бутылка полный изъяна .	бутылка полна воды .	
бутэлька поўная вады .	бутылка полный изъяна .	бутылка полна воды .	



KEY
:	он	она	
доўга не мог , , ж ж : :	долго не мог понять , кто ж он :	он бабочка , которой снится , что она чжуан-цзы	
ж : : , , наснілася што , наснілася	ж он : *чжуанцзы , которому *наснілася , что	что она чжуан-цзы , который проснувшись , долго не	



KEY
краі	крайу	края	
птушкі адляцелі ў цёплыя краі .	птицы *адляцелі в тёплые крайу .	птицы улетели в тёплые края .	
птушкі адляцелі ў цёплыя краі .	птицы *адляцелі в тёплые крайу .	птицы улетели в тёплые края .	



KEY
сказ	предложение	предложении	
што ты думаеш пра яе сказ ?	что ты *думаеш о неё предложение ?	что ты думаешь о её предложении ?	
што ты думаеш пра яе сказ ?	что ты *думаеш о неё предложение ?	что ты думаешь о её предложении ?	
ты думаеш пра яе сказ ?	ты *думаеш о неё предложение ?	ты думаешь о её предложении ?	



KEY
старадаўняй	старинной	старинном	
у старадаўняй гаворцы гэтыя знакі азначалі	в старинной речи эти знаки *азначалі	в старинном наречии эти знаки означали	



KEY
гэтая	это	эта	
гэтая манга даволі папулярная ў	это манго довольно популярная в	эта манга довольно популярна в	
гэтая манга даволі папулярная ў кітаі	это манго довольно популярная в китае	эта манга довольно популярна в китае	
гэтая манга даволі папулярная ў кітаі .	это манго довольно популярная в китае .	эта манга довольно популярна в китае .	



KEY
сваёй	своим	своего	
вельмі хутка падняць рэйтынг сваёй .	очень быстро поднять рейтинг своим .	очень быстро поднять рейтинг своего .	



KEY
люстэрка	зеркало	зеркальце	
разбіўшы люстэрка , раксалана занепакоілася :	разбив зеркало , *раксалана *занепакоілася :	разбив зеркальце , роксолана встревожилась :	
разбіўшы люстэрка , раксалана занепакоілася : верыла ў	разбив зеркало , *раксалана *занепакоілася : она верила	разбив зеркальце , роксолана встревожилась : она верила	
разбіўшы люстэрка , раксалана занепакоілася : верыла ў ,	разбив зеркало , *раксалана *занепакоілася : она верила приметы	разбив зеркальце , роксолана встревожилась : она верила в	



KEY
беларускай	белоруской	белорусской	
андрэй хадановіч — велічыня беларускай паэзіі	андрей *хадановіч — величина белоруской поэзии	андрей хаданович — величина белорусской поэзии	
андрэй хадановіч — велічыня беларускай паэзіі .	андрей *хадановіч — величина белоруской поэзии .	андрей хаданович — величина белорусской поэзии .	



KEY
цябе	тебя	тебе	
птушкай , я б паляцеў да цябе .	птицей , я бы улетел к тебя .	птицей , я бы полетел к тебе .	
я б паляцеў да цябе .	я бы улетел к тебя .	я бы полетел к тебе .	
я няшмат пра цябе ведаю .	я немного о тебя *ведаю .	я немного о тебе знаю .	
я няшмат пра цябе ведаю .	я немного о тебя *ведаю .	я немного о тебе знаю .	



KEY
агні	огне	огни	
зоркі зоркі бачна праз агні	звезды плохо видно через огне	звёзды плохо видно сквозь огни	
зоркі зоркі бачна праз агні горада .	звезды плохо видно через огне города .	звёзды плохо видно сквозь огни города .	
зоркі зоркі бачна праз агні горада .	звезды плохо видно через огне города .	звёзды плохо видно сквозь огни города .	



KEY
мір	всем	всём	
ссср ў за і за мір ва ўсім	ссср и за мир в всем мире .	ссср и за мир во всём мире .	
ў за і за мір ва ўсім	и за мир в всем мире .	и за мир во всём мире .	



KEY
сучаснай	литературе	литературы	
— — сапраўдны шэдэўр сучаснай літаратуры	— настоящий шедевр современной литературе .	— настоящий шедевр современной литературы .	



KEY
беларусі	тем	этим	
жыву ў беларусі і беларусі ганаруся .	живу в беларуси и тем *ганаруся .	живу в беларуси и этим горжусь .	
ў беларусі і беларусі ганаруся .	в беларуси и тем *ганаруся .	в беларуси и этим горжусь .	



KEY
песню	пёсню	песню	
давайце заспяваем песню .	давайте *заспяваем пёсню .	давайте споём песню .	
давайце заспяваем песню .	давайте *заспяваем пёсню .	давайте споём песню .	
 заспяваем песню на англійскай мове	 *заспяваем пёсню на английским языке	 споём песню на английском .	
цікава , анжаліка агурбаш спявала песню на	интересно , *анжаліка *агурбаш пела пёсню на	интересно , анжелика агурбаш пела песню на	
цікава , анжаліка агурбаш спявала песню на словы	интересно , *анжаліка *агурбаш пела пёсню на слова	интересно , анжелика агурбаш пела песню на слова	
спявала песню на словы някляева , ці магла яна	пела пёсню на слова *някляева , или могла она	пела песню на слова некляева , могла ли она	



KEY
яна	яна	она	
яна размаўляе з рускай настаўніцай .	яна *размаўляе с русской учительницей .	она разговаривает с русской учительницей .	
яна часта там снедае .	яна часто там *снедае .	она часто там завтракает .	
яна часта там снедае .	яна часто там *снедае .	она часто там завтракает .	
яна дала яму гадзіннік .	яна дала яму часы .	она дала ему часы .	
яна дала яму гадзіннік .	яна дала яму часы .	она дала ему часы .	
яна вырасла ў невялікім мястэчку .	яна выросла в небольшим местечке .	она выросла в небольшом городке .	
яна вырасла ў невялікім мястэчку .	яна выросла в небольшим местечке .	она выросла в небольшом городке .	
яна проста зайздросціць вашай маладосці .	яна просто *зайздросціць вашей молодости .	она просто завидует вашей молодости .	
яна вучыцца плаваць .	яна *вучыцца *плаваць .	она учится плавать .	
яна вучыцца плаваць .	яна *вучыцца *плаваць .	она учится плавать .	
яна вучыцца плаваць .	яна *вучыцца *плаваць .	она учится плавать .	
яна пераклала ліст з японскай на	яна переложила лист с японской на	она перевела письмо с японского на	
яна пераклала ліст з японскай на французскую	яна переложила лист с японской на французскую	она перевела письмо с японского на французский	
яна пераклала ліст з японскай на французскую .	яна переложила лист с японской на французскую .	она перевела письмо с японского на французский .	
яна пайшла . .	яна пошла # домой	она пошла домой .	
яна пайшла . .	яна пошла # домой	она пошла домой .	
яна пайшла . .	яна пошла # домой	она пошла домой .	
яна дапамагла свайму мужу выканаць яго работу .	яна помогла своему муже выполнить его работу .	она помогла своему мужу выполнить его работу .	
яна працягнула працаваць .	яна продолжила *працаваць .	она продолжала работать .	
яна працягнула працаваць .	яна продолжила *працаваць .	она продолжала работать .	
яна працягнула працаваць .	яна продолжила *працаваць .	она продолжала работать .	
яна выпіла кубак малака .	яна выпила кубок молока .	она выпила чашку молока .	
яна выпіла кубак малака .	яна выпила кубок молока .	она выпила чашку молока .	
яна абдурыла яго .	яна одурачила его .	она обдурила его .	
яна абдурыла яго .	яна одурачила его .	она обдурила его .	
яна задала мне пытанне .	яна задала мне вопрос .	она задала мне вопрос .	
яна заплятала свае валасы ў	яна *заплятала свои волосы в	она заплетала свои волосы в	
яна заплятала свае валасы ў косы	яна *заплятала свои волосы в *косы	она заплетала свои волосы в косы	
яна адрэдагавала артыкул .	яна *адрэдагавала артикул .	она отредактировала статью .	
яна адрэдагавала артыкул .	яна *адрэдагавала артикул .	она отредактировала статью .	
яна адрэдагавала артыкул .	яна *адрэдагавала артикул .	она отредактировала статью .	



KEY
тэрміновая	срочная	срочное	
прыходзь хутчэй ; справа тэрміновая .	приходи поскорее ; справа срочная .	приходи скорей ; дело срочное .	
прыходзь хутчэй ; справа тэрміновая .	приходи поскорее ; справа срочная .	приходи скорей ; дело срочное .	
прыходзь хутчэй ; справа тэрміновая .	приходи поскорее ; справа срочная .	приходи скорей ; дело срочное .	



KEY
глыбокае	глубокой	глубокое	
возера вельмі глыбокае .	озеро очень глубокой .	озеро очень глубокое .	



KEY
выпадковыя	случайные	случайны	
такія выпадковасці зусім не выпадковыя .	такие случайности совсем не случайные .	такие случайности совсем не случайны .	



KEY
ёй	ней	ей	
я вырашыў расказаць ёй , што	я *вырашыў *расказаць ней , что	я решил рассказать ей , что	
я вырашыў расказаць ёй , што я	я *вырашыў *расказаць ней , что я	я решил рассказать ей , что я	
я вырашыў расказаць ёй , што я кахаю	я *вырашыў *расказаць ней , что я *кахаю	я решил рассказать ей , что я люблю	
ёй , што я кахаю яго .	ней , что я *кахаю его .	ей , что я люблю его .	
ён падараваў ёй ляльку .	он *падараваў ней *ляльку .	он подарил ей куклу .	
ён падараваў ёй ляльку .	он *падараваў ней *ляльку .	он подарил ей куклу .	
ён падараваў ёй ляльку .	он *падараваў ней *ляльку .	он подарил ей куклу .	
твая маці гэтага ці не , але ёй рана	*твая мать этого или не , но ней рано	твоя мать этого или нет , но ей рано	
ці не , але ёй рана ці позна давядзецца	или не , но ней рано или поздно *давядзецца	или нет , но ей рано или поздно придется	
ёй рана ці позна давядзецца змірыцца з думкаай ,	ней рано или поздно *давядзецца *змірыцца с *думкаай ,	ей рано или поздно придется смириться с , что	



KEY
французская	французская	французский	
спрачаліся пра тое , якая мова прасцейшая : французская	спорили о то , которая язык *прасцейшая : французская	спорили о том , какой язык проще : французский	
якая мова прасцейшая : французская ці нямецкая .	которая язык *прасцейшая : французская или немецкая .	какой язык проще : французский или немецкий .	
прасцейшая : французская ці нямецкая .	*прасцейшая : французская или немецкая .	проще : французский или немецкий .	



KEY
неба	небо	неба	
у неба ёсць ёсць вецер	в небо давай будем ветер	у неба есть ветер и	
у неба ёсць ёсць вецер і	в небо давай будем ветер и	у неба есть ветер и дождь	
ад іх не падымецца аж да неба !	от них не поднимется *аж к небо !	от них не поднимется аж до неба !	
іх не падымецца аж да неба !	них не поднимется *аж к небо !	них не поднимется аж до неба !	
не падымецца аж да неба !	не поднимется *аж к небо !	не поднимется аж до неба !	



KEY
сваім	своим	своём	
безумоўна , размяшчаючы на сваім сайце кнопки	безусловно , *размяшчаючы на своим *сайце *кнопки	безусловно , размещая на своём сайте кнопки	
безумоўна , размяшчаючы на сваім сайце кнопки сэрвісаў сацыяльных	безусловно , *размяшчаючы на своим *сайце *кнопки *сэрвісаў социальных	безусловно , размещая на своём сайте кнопки сервисов социальных	
размяшчаючы на сваім сайце кнопки сэрвісаў сацыяльных закладак ,	*размяшчаючы на своим *сайце *кнопки *сэрвісаў социальных закладок ,	размещая на своём сайте кнопки сервисов социальных закладок ,	
на сваім сайце кнопки сэрвісаў сацыяльных закладак , вэбмайстры	на своим *сайце *кнопки *сэрвісаў социальных закладок , *вэбмайстры	на своём сайте кнопки сервисов социальных закладок , вебмастеры	



KEY
шматразовага	многократного	многоразового	
і праязнога білета шматразовага выкарыстання пракампасціруйце білет аднаразовага выкарыстання	и проездного билета многократного использования *пракампасціруйце билет одноразового использования	и проездного билета многоразового пользования прокомпостируйте билет одноразового пользования	
праязнога білета шматразовага выкарыстання пракампасціруйце білет аднаразовага выкарыстання ,	проездного билета многократного использования *пракампасціруйце билет одноразового использования ,	проездного билета многоразового пользования прокомпостируйте билет одноразового пользования ,	



KEY
.	порнографию	порнографии	
па закону пра дзіцячую парнаграфію .	*засудзяць по закона о детскую порнографию	осудят по закону о детской порнографии	
закону пра дзіцячую парнаграфію .	по закона о детскую порнографию	по закону о детской порнографии	



KEY
польшчы	польше	польши	
стагоддзяў кракаў быў сталіцай польшчы .	веков *кракаў был столицей польше .	столетиями краков был столицей польши .	



KEY
захаду	запада	западу	
роджэр вандраваў па захаду з	*роджэр *вандраваў по запада с	роджер путешествовал по западу из	
роджэр вандраваў па захаду з горада	*роджэр *вандраваў по запада с города	роджер путешествовал по западу из города	
роджэр вандраваў па захаду з горада ў горад	*роджэр *вандраваў по запада с города в город	роджер путешествовал по западу из города в город	
роджэр вандраваў па захаду з горада ў горад .	*роджэр *вандраваў по запада с города в город .	роджер путешествовал по западу из города в город .	



KEY
,	черепице	черепицы	
чарапіцы , , частуе частуе так так « «	укладки черепице , хозяин *частуе строителей так *званым «	кладке черепицы , хозяин угощает строителей так называемым «	



KEY
працы	работе	работы	
у суботніках па месцу жыхарства і працы .	в субботниках по месту жительство и работе .	в субботниках по месту жительства и работы .	
па месцу жыхарства і працы .	по месту жительство и работе .	по месту жительства и работы .	



KEY
мінулым	прошлым	прошлом	
не хвалюйся аб мінулым !	не волнуйся о прошлым !	не беспокойся о прошлом .	
не хвалюйся аб мінулым !	не волнуйся о прошлым !	не беспокойся о прошлом .	
не хвалюйся аб мінулым !	не волнуйся о прошлым !	не беспокойся о прошлом .	



KEY
купляў	покупок	покупал	
ён купляў якія папала кнігі .	он покупок которые попала книги .	он покупал какие попало книги .	
ён купляў якія папала кнігі .	он покупок которые попала книги .	он покупал какие попало книги .	
ён купляў якія папала кнігі .	он покупок которые попала книги .	он покупал какие попало книги .	



KEY
ўставаў	уставов	вставал	
ён звычайна ўставаў рана .	он обычно уставов рано .	он обычно вставал рано .	



KEY
будзе	будет	пребудет	
няхай будзе з табою сіла .	пусть будет с тобой сила .	да пребудет с тобой сила .	



KEY
дом	море	моря	
ён мае дом ля дом .	он мои дом у море .	у него дом у моря .	



KEY
месцы	месте	места	
месцы для курцоў ці для	месте для курильщиков или для	места для курящих или для	



KEY
наснілася	которому	которой	
ж ж : : , , наснілася што ,	кто ж он : *чжуанцзы , которому *наснілася ,	приснилось , что он бабочка , которой снится ,	



KEY
нашым	нашими	нашим	
што не заўсёды адпавядае нашым чаканням !	что не всегда *адпавядае нашими ожиданиям !	что не всегда соответствует нашим ожиданиям !	



KEY
агародніна	овощ	овощи	
садавіна і агародніна важная для	плод и овощ важная для	фрукты и овощи важны для	
садавіна і агародніна важная для збалансованага харчавання	плод и овощ важная для *збалансованага питания	фрукты и овощи важны для сбалансированного питания	
садавіна і агародніна важная для збалансованага харчавання .	плод и овощ важная для *збалансованага питания .	фрукты и овощи важны для сбалансированного питания .	
і агародніна важная для збалансованага харчавання .	и овощ важная для *збалансованага питания .	и овощи важны для сбалансированного питания .	



KEY
полымя	пламя	полымя	
з агню ды ў полымя	с огня и в пламя	из огня да в полымя	
з агню ды ў полымя .	с огня и в пламя .	из огня да в полымя .	
з агню ды ў полымя .	с огня и в пламя .	из огня да в полымя .	



KEY
якой	которой	которому	
была накрытая мяккай коўдрай лісця , па якой было	была *накрытая мягким одеялом листа , по которой бывше	была укрыта мягким одеялом листьев , по которому было	
коўдрай лісця , па якой было лёгка ісці .	одеялом листа , по которой бывше легко идти .	одеялом листьев , по которому было легко идти .	
лісця , па якой было лёгка ісці .	листа , по которой бывше легко идти .	листьев , по которому было легко идти .	



KEY
нашым	нашим	нашем	
у нашым доме два вольныя пакоі	в нашим доме два *вольныя комнате	в нашем доме две свободные комнаты	
у нашым доме два вольныя пакоі .	в нашим доме два *вольныя комнате .	в нашем доме две свободные комнаты .	
у нашым доме два вольныя пакоі .	в нашим доме два *вольныя комнате .	в нашем доме две свободные комнаты .	
нашым доме два вольныя пакоі .	нашим доме два *вольныя комнате .	нашем доме две свободные комнаты .	



KEY
думаю	думой	думаю	
думаю , ён не прыйдзе	думой , он не придёт	думаю , он не придёт	



KEY
пабудову	общество	общества	
поспехаў за пабудову за пабудову камуністычнага ссср ў за	борьбе за построение коммунистического общество в ссср и за	борьбе за построение коммунистического общества в ссср и за	



KEY
застаўся	остался	осталось	
застаўся горкі паслясмак .	остался горки *паслясмак .	осталось горькое послевкусие .	
застаўся горкі паслясмак .	остался горки *паслясмак .	осталось горькое послевкусие .	
застаўся горкі паслясмак .	остался горки *паслясмак .	осталось горькое послевкусие .	



KEY
надзеі	надежде	надежды	
усе свае надзеі беларускі народ ускладае беларускі	все свои надежде белорусский народ *ускладае исключительно	все свои надежды белорусский народ возлагает исключительно	
свае надзеі беларускі народ ускладае беларускі на першага прэзідэнта	свои надежде белорусский народ *ускладае исключительно на первого президента	свои надежды белорусский народ возлагает исключительно на первого президента	



KEY
,	то	но	
не вы , а , тое , , мы	не вы , а то самой , что мы	соседи с другой , но только на свой лад	



KEY
купляйце	белорусской	белорусское	
выставу « « купляйце !	*выставу « *купляйце белорусской !	выставку « покупайте белорусское !	
выставу « « купляйце ! » »	*выставу « *купляйце белорусской ! » *рэкламавалі	выставку « покупайте белорусское ! » рекламировали	
выставу « « купляйце ! » » рэкламавалі	*выставу « *купляйце белорусской ! » *рэкламавалі с	выставку « покупайте белорусское ! » рекламировали с	
« купляйце ! » » рэкламавалі з дапамогай спаму	*купляйце белорусской ! » *рэкламавалі с помощью *спаму .	покупайте белорусское ! » рекламировали с помощью спама .	



KEY
садзе	саде	саду	
ёсць запасны ключ , схаваны ў садзе .	будем запасной ключ , скрытый в саде .	есть запасной ключ , спрятанный в саду .	
ключ , схаваны ў садзе .	ключ , скрытый в саде .	ключ , спрятанный в саду .	
ў садзе , садзіць ружы .	в саде , *садзіць розе .	в саду , сажает розы .	



KEY
рэсурсы	ресурсы	ресурсами	
што багатыя на прыродныя рэсурсы .	что богатые на природные ресурсы .	стран , изобилующих природными ресурсами .	



KEY
піша	афоризмы	афорист	
: часам , афарызмы , ці піша , часам	: шахматист , который иногда *піша афоризмы , *афарыст	кто я , иногда пишет или афорист , который	



KEY
гатовае	готовой	готов	
снеданне гатовае ?	завтрак готовой ?	завтрак готов ?	



KEY
марка	марка	марко	
машына марка называецца « thunder giant	машина марка *называецца « thunder giant	машина марко называется « thunder giant	
машына марка называецца « thunder giant	машина марка *называецца « thunder giant	машина марко называется « thunder giant	



KEY
кроку	шаге	шага	
падарожжа ў тысячу лі пачынаецца з аднаго кроку	путешествие в тысячу *лі *пачынаецца с одного шаге	путешествие в тысячу ли начинается с одного шага	
падарожжа ў тысячу лі пачынаецца з аднаго кроку .	путешествие в тысячу *лі *пачынаецца с одного шаге .	путешествие в тысячу ли начинается с одного шага .	
лі пачынаецца з аднаго кроку .	*лі *пачынаецца с одного шаге .	ли начинается с одного шага .	



KEY
японскай	японской	японского	
яна пераклала ліст з японскай на	яна переложила лист с японской на	она перевела письмо с японского на	
яна пераклала ліст з японскай на французскую	яна переложила лист с японской на французскую	она перевела письмо с японского на французский	
яна пераклала ліст з японскай на французскую .	яна переложила лист с японской на французскую .	она перевела письмо с японского на французский .	
ліст з японскай на французскую .	лист с японской на французскую .	письмо с японского на французский .	



KEY
кантакт	тёсный	тесный	
і сацыялізму , , усталявалі кантакт з імперыялістамі імперыялістамі	демократии и социализма , *усталявалі тёсный контакт с *імперыялістамі	демократии и социализма , установили тесный контакт с империалистами	
усталявалі кантакт з імперыялістамі імперыялістамі маршалізаваных краін , куды	*усталявалі тёсный контакт с *імперыялістамі *маршалізаваных стран , куда	установили тесный контакт с империалистами маршаллизованных стран , куда	
кантакт з імперыялістамі імперыялістамі маршалізаваных краін , куды яны	тёсный контакт с *імперыялістамі *маршалізаваных стран , куда они	тесный контакт с империалистами маршаллизованных стран , куда они	



KEY
кожная	каждая	каждой	
кожная краіна мае дзяржаўны сцяг .	каждая страна мои государственное знамя .	каждой страны есть государственный флаг .	



KEY
божа	божо	боже	
дзякуй табе , божа ,	*дзякуй тебе , божо ,	спасибо тебе , боже ,	



KEY
забаронены	запрещённый	запрещен	
экспарт зброі быў забаронены .	экспорт оружии был запрещённый .	экспорт оружия был запрещен .	
экспарт зброі быў забаронены .	экспорт оружии был запрещённый .	экспорт оружия был запрещен .	



KEY
напісаны	написанный	написана	
артыкул напісаны звязнай сучаснай мовай	артикул написанный связной современным языком	статья написана связным современным языком	
артыкул напісаны звязнай сучаснай мовай .	артикул написанный связной современным языком .	статья написана связным современным языком .	
артыкул напісаны звязнай сучаснай мовай .	артикул написанный связной современным языком .	статья написана связным современным языком .	



KEY
не	не	нет	
ён прыйдзе , ці не .	он придёт , или не .	придёт ли он или нет .	
 слова « не » »	 слово « не » тебе	" слова `` нет '' тебе"	
? » — « « , не , не	? » — « *ну , не , не	— « ну , нет , теперь уже нет	
я не маю маю на	я не маю времени на	меня нет времени на чтение	
я не маю маю на чытанне	я не маю времени на чтение	меня нет времени на чтение книг	
табе вырашаць , купляць ці не	тебе *вырашаць , *купляць или не	тебе решать , покупать или нет	
табе вырашаць , купляць ці не .	тебе *вырашаць , *купляць или не .	тебе решать , покупать или нет .	
вырашаць , купляць ці не .	*вырашаць , *купляць или не .	решать , покупать или нет .	
не , дзякуй .	не , *дзякуй .	нет , спасибо .	
не , дзякуй .	не , *дзякуй .	нет , спасибо .	
 сястра не мае вышэйшае асветы	 сестра не мои высшего просвещения	 сестры нет высшего образования .	
хоча твая маці гэтага ці не	хочет *твая мать этого или не	хочет твоя мать этого или нет	
твая маці гэтага ці не , але ёй рана	*твая мать этого или не , но ней рано	твоя мать этого или нет , но ей рано	
ці не , але ёй рана ці позна давядзецца	или не , но ней рано или поздно *давядзецца	или нет , но ей рано или поздно придется	
не , не і яшчэ	не , не и ещё	нет , нет и ещё	
не , не і яшчэ	не , не и ещё	нет , нет и ещё	
не , не і яшчэ раз не	не , не и ещё однажды не	нет , нет и ещё раз нет	
не , не і яшчэ раз не	не , не и ещё однажды не	нет , нет и ещё раз нет	
не , не і яшчэ раз не	не , не и ещё однажды не	нет , нет и ещё раз нет	
не і яшчэ раз не !	не и ещё однажды не !	нет и ещё раз нет !	
не і яшчэ раз не !	не и ещё однажды не !	нет и ещё раз нет !	



KEY
нядзелі	воскресенье	воскресенья	
панядзелак ідзе панядзелак нядзелі .	понедельник идёт после воскресенье .	понедельник идёт после воскресенья .	
панядзелак ідзе панядзелак нядзелі .	понедельник идёт после воскресенье .	понедельник идёт после воскресенья .	
панядзелак ідзе панядзелак нядзелі .	понедельник идёт после воскресенье .	понедельник идёт после воскресенья .	
панядзелак ідзе панядзелак нядзелі .	понедельник идёт после воскресенье .	понедельник идёт после воскресенья .	



KEY
японію	японию	японии	
амаль удвая большы за японію .	почти вдвое больший за японию .	техас почти вдвое больше японии .	



KEY
ж	ж	же	
колькі ж казахаў размаўляе размаўляе на	сколько ж казахов действительно *размаўляе на	сколько же казахов действительно говорят на	
колькі ж казахаў размаўляе размаўляе на казахскай мове ?	сколько ж казахов действительно *размаўляе на *казахскай языке ?	сколько же казахов действительно говорят на казахском языке ?	
у ранняй творчасці пісьменніка праяўляліся тыя ж тэмы ,	в ранним творчестве писателя *праяўляліся те ж темы ,	в раннем творчестве писателя проявлялись те же темы ,	
творчасці пісьменніка праяўляліся тыя ж тэмы , што і	творчестве писателя *праяўляліся те ж темы , что и	творчестве писателя проявлялись те же темы , что и	
карысней , сонца ці месяц ? вядома ж месяц	*карысней , солнце или месяц ? конечно ж месяц	полезнее , солнце или луна ? конечно же луна	
ці месяц ? вядома ж месяц , ён свеціць	или месяц ? конечно ж месяц , он *свеціць	или луна ? конечно же луна , она светит	
месяц ? вядома ж месяц , ён свеціць ,	месяц ? конечно ж месяц , он *свеціць ,	луна ? конечно же луна , она светит ,	
вядома ж месяц , ён свеціць , калі ,	конечно ж месяц , он *свеціць , когда темно	конечно же луна , она светит , темно ,	
ж месяц , ён свеціць , калі , ,	ж месяц , он *свеціць , когда темно ,	же луна , она светит , темно , а	
які ж ты гультай !	яки ж ты лентяй !	какой же ты ленивый !	
які ж ты гультай !	яки ж ты лентяй !	какой же ты ленивый !	
які ж ты гультай !	яки ж ты лентяй !	какой же ты ленивый !	
 ж элегантная , як мая	 ж элегантная , как мая	 же элегантна , как .	



KEY
прызначаная	назначенная	предназначена	
татоэба не прызначаная для абмену	*татоэба не назначенная для обмена	татоэба не предназначена для обмена	
не прызначаная для абмену песнямі ? ! і як	не назначенная для обмена пёснями ? ! и как	не предназначена для обмена песнями ? ! и как	



KEY
гарачая	горячая	горячий	
гэта гарбата занадта гарачая .	эта горбато слишком горячая .	этот чай слишком горячий .	
гэта гарбата занадта гарачая .	эта горбато слишком горячая .	этот чай слишком горячий .	
гэта гарбата занадта гарачая .	эта горбато слишком горячая .	этот чай слишком горячий .	
гэтая кава такая гарачая , што я	этот кофе такая горячая , что я	этот кофе такой горячий , что я	
гэтая кава такая гарачая , што я не	этот кофе такая горячая , что я не	этот кофе такой горячий , что я не	



KEY
якім	которым	который	
шукала ідэальны колер , якім яна хацела б пафарбаваць	*шукала *ідэальны цвет , которым она хотела бы *пафарбаваць	идеальный цвет , в который она хотела бы покрасить	
якім яна хацела б пафарбаваць сцены свойго сцены .	которым она хотела бы *пафарбаваць стены *свойго комнаты .	который она хотела бы покрасить стены своей комнаты .	



KEY
вадзіцы	водице	водицы	
дабудзь жа ты мне цяпер гэткай вадзіцы , пашукай	*дабудзь же ты мне сейчас *гэткай водице , *пашукай	добудь же ты мне теперь этакой водицы , поищи	
жа ты мне цяпер гэткай вадзіцы , пашукай ,	же ты мне сейчас *гэткай водице , *пашукай ,	же ты мне теперь этакой водицы , поищи ,	
ты мне цяпер гэткай вадзіцы , пашукай , прынясі	ты мне сейчас *гэткай водице , *пашукай , *прынясі	ты мне теперь этакой водицы , поищи , принеси	
цяпер гэткай вадзіцы , пашукай , прынясі , карэньчыкі	сейчас *гэткай водице , *пашукай , *прынясі , *карэньчыкі	теперь этакой водицы , поищи , принеси , корешки	
вадзіцы , пашукай , прынясі , карэньчыкі мае бедныя	водице , *пашукай , *прынясі , *карэньчыкі мои бедные	водицы , поищи , принеси , корешки мои бедные	



KEY
школьныя	школьные	школьных	
мой бацька часта апавядаў нам пра свае школьныя	мой отец часто *апавядаў зам о свои школьные	мой отец часто рассказывал нам о своих школьных	
мой бацька часта апавядаў нам пра свае школьныя годы	мой отец часто *апавядаў зам о свои школьные *годы	мой отец часто рассказывал нам о своих школьных годах	
часта апавядаў нам пра свае школьныя годы .	часто *апавядаў зам о свои школьные *годы .	часто рассказывал нам о своих школьных годах .	
апавядаў нам пра свае школьныя годы .	*апавядаў зам о свои школьные *годы .	рассказывал нам о своих школьных годах .	
нам пра свае школьныя годы .	зам о свои школьные *годы .	нам о своих школьных годах .	



KEY
высновы	вывода	выводу	
мы прыйшлі да высновы , што ён меў	мы пришли к вывода , что он *меў	мы пришли к выводу , что него была	
да высновы , што ён меў рацыю .	к вывода , что он *меў рацию .	к выводу , что него была рация .	



KEY
фантаны	фонтаны	фонтана	
чатыры фантаны з статуямі нептуна , яго жонкі амфітрыты	четыре фонтаны со статуями *нептуна , его жены *амфітрыты	четыре фонтана со статуями нептуна , его жены амфитриты	



KEY
ўсход	восток	востоку	
горад размешчаны на ўсход ад лонадана	город размещённый на восток от *лонадана	город находится к востоку от лондона	
горад размешчаны на ўсход ад лонадана .	город размещённый на восток от *лонадана .	город находится к востоку от лондона .	
горад размешчаны на ўсход ад лонадана .	город размещённый на восток от *лонадана .	город находится к востоку от лондона .	
размешчаны на ўсход ад лонадана .	размещённый на восток от *лонадана .	находится к востоку от лондона .	



KEY
кут	угол	уголок	
мой родны кут , як ты мне	мой родной угол , как ты мне	мой родной уголок , как ты мне	



KEY
пакоі	комнате	комнаты	
у нашым доме два вольныя пакоі	в нашим доме два *вольныя комнате	в нашем доме две свободные комнаты	
у нашым доме два вольныя пакоі .	в нашим доме два *вольныя комнате .	в нашем доме две свободные комнаты .	
у нашым доме два вольныя пакоі .	в нашим доме два *вольныя комнате .	в нашем доме две свободные комнаты .	
нашым доме два вольныя пакоі .	нашим доме два *вольныя комнате .	нашем доме две свободные комнаты .	



KEY
тое	то	том	
яны спрачаліся пра тое ,	яны спорили о то ,	они спорили о том ,	
спрачаліся пра тое , якая мова прасцейшая : французская	спорили о то , которая язык *прасцейшая : французская	спорили о том , какой язык проще : французский	



KEY
кароткае	короткой	коротка	
жыццё надта кароткае , каб вывучаць нямецкую	жизнь слишком короткой , чтобы изучат немецкую	жизнь слишком коротка , чтобы изучать немецкий	
надта кароткае , каб вывучаць нямецкую .	слишком короткой , чтобы изучат немецкую .	слишком коротка , чтобы изучать немецкий .	
кароткае , каб вывучаць нямецкую .	короткой , чтобы изучат немецкую .	коротка , чтобы изучать немецкий .	



KEY
свае	свои	своих	
мой бацька часта апавядаў нам пра свае школьныя	мой отец часто *апавядаў зам о свои школьные	мой отец часто рассказывал нам о своих школьных	
мой бацька часта апавядаў нам пра свае школьныя годы	мой отец часто *апавядаў зам о свои школьные *годы	мой отец часто рассказывал нам о своих школьных годах	
часта апавядаў нам пра свае школьныя годы .	часто *апавядаў зам о свои школьные *годы .	часто рассказывал нам о своих школьных годах .	
апавядаў нам пра свае школьныя годы .	*апавядаў зам о свои школьные *годы .	рассказывал нам о своих школьных годах .	
нам пра свае школьныя годы .	зам о свои школьные *годы .	нам о своих школьных годах .	



KEY
працягнула	продолжила	продолжала	
яна працягнула працаваць .	яна продолжила *працаваць .	она продолжала работать .	
яна працягнула працаваць .	яна продолжила *працаваць .	она продолжала работать .	
яна працягнула працаваць .	яна продолжила *працаваць .	она продолжала работать .	



KEY
за	в	во	
ссср ў за і за мір ва ўсім	ссср и за мир в всем мире .	ссср и за мир во всём мире .	
ў за і за мір ва ўсім	и за мир в всем мире .	и за мир во всём мире .	



KEY
гэтае	этого	этот	
гэтае дзіця яшчэ не ўмее	этого ребёнок ещё не *ўмее	этот ребёнок ещё не умеет	
гэтае дзіця яшчэ не ўмее хадзіць .	этого ребёнок ещё не *ўмее ходить .	этот ребёнок ещё не умеет ходить .	



KEY
бок	сторона	сторону	
tatoeba : пераходзь на цёмны бок .	tatoeba : *пераходзь на *цёмны сторона .	tatoeba : переходи на тёмную сторону .	
tatoeba : пераходзь на цёмны бок . мы маем	tatoeba : *пераходзь на *цёмны сторона . мы маем	tatoeba : переходи на тёмную сторону . у есть	
: пераходзь на цёмны бок . мы маем шакаладнае	: *пераходзь на *цёмны сторона . мы маем шоколадного	: переходи на тёмную сторону . у есть шоколадное	
бок . мы маем шакаладнае пячэнне	сторона . мы маем шоколадного печенье	сторону . у есть шоколадное печенье	



KEY
пра	закона	закону	
па закону пра дзіцячую парнаграфію .	*засудзяць по закона о детскую порнографию	осудят по закону о детской порнографии	
закону пра дзіцячую парнаграфію .	по закона о детскую порнографию	по закону о детской порнографии	



KEY
схаваны	скрытый	спрятанный	
ёсць запасны ключ , схаваны ў садзе .	будем запасной ключ , скрытый в саде .	есть запасной ключ , спрятанный в саду .	
ключ , схаваны ў садзе .	ключ , скрытый в саде .	ключ , спрятанный в саду .	



KEY
ўзвышэнне	возвышение	возвышении	
як люстра , можно даведацца пра ўзвышэнне і заняпад	как люстра , можно *даведацца о возвышение и упадок	историю как , можно узнать о возвышении и упадке	



KEY
дзіцяці	ребёнке	ребёнка	
могуць перадаць у суд сведчанні пра згвалтаванне дзіцяці ,	могут передать в суд свидетельстве о изнасилование ребёнке ,	могут передать в суд свидетельства об изнасиловании ребёнка ,	
перадаць у суд сведчанні пра згвалтаванне дзіцяці , бо	передать в суд свидетельстве о изнасилование ребёнке , так	передать в суд свидетельства об изнасиловании ребёнка , так	
у суд сведчанні пра згвалтаванне дзіцяці , бо іх	в суд свидетельстве о изнасилование ребёнке , так как	в суд свидетельства об изнасиловании ребёнка , так как	
суд сведчанні пра згвалтаванне дзіцяці , бо іх саміх	суд свидетельстве о изнасилование ребёнке , так как них	суд свидетельства об изнасиловании ребёнка , так как их	
дзіцяці , бо іх саміх засудзяць па закону пра	ребёнке , так как них самих *засудзяць по закона	ребёнка , так как их осудят по закону о	



KEY
магу	маге	могу	
я больш не магу цярпець гэты	я более не маге терпеть эта	я больше не могу терпеть эту	
больш не магу цярпець гэты боль .	более не маге терпеть эта боль .	больше не могу терпеть эту боль .	
дзе я магу адрамантаваць гадзіннік ?	где я маге *адрамантаваць часы ?	где я могу починить часы ?	
дзе я магу адрамантаваць гадзіннік ?	где я маге *адрамантаваць часы ?	где я могу починить часы ?	
магу адказаць ні на адно пытанне у гэтым тэсце	маге ответить ни на одно вопрос в этим тесте	могу ответить ни на один вопрос в этом тесте	
я не магу нічога зрабіць з нічога , што	я не маге ничего *зрабіць с тем , что	я не могу ничего сделать с тем , что	
не магу ціма знайсці . ён	не маге *ціма *знайсці . он	не могу тима найти . он	
не магу ціма знайсці . ён ужо	не маге *ціма *знайсці . он уже	не могу тима найти . он уже	
не магу ціма знайсці . ён ужо пайшоў	не маге *ціма *знайсці . он уже пошёл	не могу тима найти . он уже ушел	
не магу зразумець , якая яго сапраўдная мэта .	не маге понять , которая его настоящая цель .	не могу понять , какова его настоящая цель .	
я магу пазычыць вам крыху грошай ,	я маге *пазычыць вам немного денег ,	я могу одолжить вам немного денег ,	



KEY
ты	бы	ты	
ты крыўдуеш . гэта б ты ты зярно ,	ты *крыўдуеш . эта когда бы ты продавал *зярно	недоволен . это как бы ты продавал зерно ,	
крыўдуеш . гэта б ты ты зярно , ,	*крыўдуеш . эта когда бы ты продавал *зярно ,	сражении и погиб , ты недоволен . это как	
крыўдуеш . гэта б ты ты зярно , ,	*крыўдуеш . эта когда бы ты продавал *зярно ,	. это как бы ты продавал зерно , и	
гэта б ты ты зярно , , крыўдаваў што	эта когда бы ты продавал *зярно , и *крыўдаваў	как бы ты продавал зерно , и недоволен ,	
б ты ты зярно , , крыўдаваў што ,	когда бы ты продавал *зярно , и *крыўдаваў ,	бы ты продавал зерно , и недоволен , что	



KEY
тое	самой	свой	
— — не вы , а , тое ,	— эта не вы , а то самой ,	соседи с другой , но только на свой лад	



KEY
ці	или	ли	
 ці падабаецца вам белае віно	 или *падабаецца вам белого вино	 ли вам белое вино ?	



KEY
усё	всё	все	
усё гэта толькі ліслівасць .	всё эта только лесть .	все это только лесть .	
усё гэта толькі ліслівасць .	всё эта только лесть .	все это только лесть .	



KEY
паляпшэнне	улучшение	улучшении	
сэрвісаў сацыяльных закладак , вэбмайстры думаюць пра паляпшэнне работы	*сэрвісаў социальных закладок , *вэбмайстры *думаюць о улучшение работы	сервисов социальных закладок , вебмастеры думают о улучшении работы	
сацыяльных закладак , вэбмайстры думаюць пра паляпшэнне работы з	социальных закладок , *вэбмайстры *думаюць о улучшение работы с	социальных закладок , вебмастеры думают о улучшении работы с	
пра паляпшэнне работы з сайтам у апошнюю чаргу .	о улучшение работы с *сайтам в последнюю очередь .	о улучшении работы с сайтом в последнюю очередь .	



KEY
цётка	тётка	тётя	
мая цётка радавалася майму поспеху .	мая тётка радовалась моему успехе .	моя тётя радовалась моим успехам .	
мая цётка радавалася майму поспеху .	мая тётка радовалась моему успехе .	моя тётя радовалась моим успехам .	
мая цётка радавалася майму поспеху .	мая тётка радовалась моему успехе .	моя тётя радовалась моим успехам .	



KEY
ўмее	них	их	
табе , , не не ўмее іх бачыць	тот , кто не *ўмее них *бачыць .	тот , кто не умеет их видеть .	



KEY
»	и	и"	
старадаўняй гаворцы гэтыя знакі азначалі « дух » »	старинной речи эти знаки *азначалі « дух » и	"старинном наречии эти знаки означали `` дух '' и"	



KEY
варожага	вражеского	вражеский	
адкрытыя адкрытыя для варожага агню .	были открытые для вражеского огня .	солдаты попали под вражеский обстрел .	



KEY
сведчанні	свидетельстве	свидетельства	
могуць перадаць у суд сведчанні пра згвалтаванне дзіцяці ,	могут передать в суд свидетельстве о изнасилование ребёнке ,	могут передать в суд свидетельства об изнасиловании ребёнка ,	
перадаць у суд сведчанні пра згвалтаванне дзіцяці , бо	передать в суд свидетельстве о изнасилование ребёнке , так	передать в суд свидетельства об изнасиловании ребёнка , так	
у суд сведчанні пра згвалтаванне дзіцяці , бо іх	в суд свидетельстве о изнасилование ребёнке , так как	в суд свидетельства об изнасиловании ребёнка , так как	
суд сведчанні пра згвалтаванне дзіцяці , бо іх саміх	суд свидетельстве о изнасилование ребёнке , так как них	суд свидетельства об изнасиловании ребёнка , так как их	



KEY
удавы	удавы	вдовы	
у адной удавы было дзве	в одной удавы бывше две	у одной вдовы было две	
у адной удавы было дзве дачкі .	в одной удавы бывше две дочери .	у одной вдовы было две дочери .	
у адной удавы было дзве дачкі .	в одной удавы бывше две дочери .	у одной вдовы было две дочери .	



KEY
маю	маю	мою	
маю руку . мы ўдвох пабудуем утопію .	маю руку . мы *ўдвох построим утопию .	мою руку . мы вдвоём построим утопию .	



KEY
нямецкую	немецкую	немецкий	
жыццё надта кароткае , каб вывучаць нямецкую	жизнь слишком короткой , чтобы изучат немецкую	жизнь слишком коротка , чтобы изучать немецкий	
надта кароткае , каб вывучаць нямецкую .	слишком короткой , чтобы изучат немецкую .	слишком коротка , чтобы изучать немецкий .	
кароткае , каб вывучаць нямецкую .	короткой , чтобы изучат немецкую .	коротка , чтобы изучать немецкий .	



KEY
,	звезды	звёзды	
людзі , бо глядзім глядзім на на , ,	люди , так как давай смотрим на звезды ,	мы люди , потому что смотрим на звёзды ,	
глядзім глядзім на на , , мы мы глядзім	как давай смотрим на звезды , или мы давай	потому что смотрим на звёзды , или мы смотрим	
глядзім глядзім на на , , мы мы глядзім	как давай смотрим на звезды , или мы давай	или мы смотрим на звёзды , потому что мы	
на , , мы мы глядзім на на ,	на звезды , или мы давай смотрим на звезды	смотрим на звёзды , или мы смотрим на звёзды	
мы глядзім на на , , мы людзі мы	мы давай смотрим на звезды , так как мы	потому что смотрим на звёзды , или мы смотрим	
мы глядзім на на , , мы людзі мы	мы давай смотрим на звезды , так как мы	или мы смотрим на звёзды , потому что мы	
на на , , мы людзі мы	смотрим на звезды , так как мы	смотрим на звёзды , потому что мы	
на , , мы людзі мы	на звезды , так как мы	на звёзды , потому что мы	



KEY
чырвонае	красной	красное	
у братоў грым чырвонае каптурко	в братьев грим красной *каптурко	у братьев гримм красное шапочко	
у братоў грым чырвонае каптурко ніякага роду ,	в братьев грим красной *каптурко никакого рода ,	у братьев гримм красное шапочко рода , а	
у братоў грым чырвонае каптурко ніякага роду , а	в братьев грим красной *каптурко никакого рода , а	у братьев гримм красное шапочко рода , а у	



KEY
—	эта	это	
маркс сцвярджае , щто « « гісторыя — —	*маркс *сцвярджае , щто « история общество — эта	маркс утверждает , что `` история общества - это	
щто « « гісторыя — — гэта гісторыя класавай	щто « история общество — эта история классовой борьбы	что `` история общества - это история классовой борьбы	



KEY
розумам	умом	разумом	
. яны надзелены розумам i сумленнем i i павiнны	. яны наделённый умом i совестью i *павi*нны *ставi*цца	правах . наделены разумом и совестью и поступать в	
надзелены розумам i сумленнем i i павiнны ставiцца адзiн	наделённый умом i совестью i *павi*нны *ставi*цца *адзi*н к	наделены разумом и совестью и поступать в отношении друг	



KEY
шахматыст	кто	что	
шахматыст я : часам , афарызмы , ці піша	кто я : шахматист , который иногда *піша афоризмы	что она чжуан-цзы , который проснувшись , долго не	



KEY
толькі	но	на	
суседзі з другога боку , , толькі на на	*казалі соседи со второго боке , но только на	соседи с другой , но только на свой лад	



KEY
татарскай	татарским	татарском	
у інтэрнэце татарскай сайтаў на татарскай	в *інтэрнэце мало *сайтаў на татарским	в интернете мало сайтов на татарском	
у інтэрнэце татарскай сайтаў на татарскай мове .	в *інтэрнэце мало *сайтаў на татарским языке .	в интернете мало сайтов на татарском языке .	
інтэрнэце татарскай сайтаў на татарскай мове .	*інтэрнэце мало *сайтаў на татарским языке .	интернете мало сайтов на татарском языке .	



KEY
значку	значке	значку	
каб дадаць пераклад , пстрыкніце па значку « あ→а	чтобы добавить перевод , *пстрыкніце по значке « あ→а	чтобы добавить перевод , щёлкните по значку « あ→а	
пераклад , пстрыкніце па значку « あ→а » над	перевод , *пстрыкніце по значке « あ→а » над	перевод , щёлкните по значку « あ→а » над	



KEY
аднаразовага	одноразового	многоразового	
выкарыстання пракампасціруйце білет аднаразовага выкарыстання , не чакаючы наступнага	использования *пракампасціруйце билет одноразового использования , не *чакаючы следующей	и проездного билета многоразового пользования прокомпостируйте билет одноразового пользования	



KEY
электрамеханіку	электромеханике	электромеханику	
ён вывучаў электрамеханіку і будызм у	он *вывучаў электромеханике и буддизм в	он изучал электромеханику и буддизм в	
ён вывучаў электрамеханіку і будызм у мясцовым	он *вывучаў электромеханике и буддизм в местным	он изучал электромеханику и буддизм в местном	
электрамеханіку і будызм у мясцовым універсітэце .	электромеханике и буддизм в местным университете .	электромеханику и буддизм в местном университете .	



KEY
багатая	богатая	богата	
краіна багатая на прыродныя рэсурсы .	страна богатая на природные ресурсы .	страна богата на природные ресурсы .	



KEY
з	детство	детства	
з з словы і нават разумееш фразы фразы	детство слова и даже *разумееш целые фразы .	детства слова и даже понимаешь целые фразы .	



KEY
пара	пара	пора	
мне пара ісці спаць .	мне пара идти *спаць .	мне пора идти спать .	
мне пара ісці спаць .	мне пара идти *спаць .	мне пора идти спать .	
мне ўжо пара ісці ў банк .	мне уже пара идти в банк .	мне уже пора идти в банк .	



KEY
знішчаны	уничтоженный	уничтожен	
хвалюйся , хлопчыку . твой сябра рон знішчаны .	волнуйся , мальчике . *твой член *рон уничтоженный .	волнуйся , мальчик . твой друг рон уничтожен .	
хлопчыку . твой сябра рон знішчаны . мы вырашылі	мальчике . *твой член *рон уничтоженный . мы *вырашылі	мальчик . твой друг рон уничтожен . мы решили	
. твой сябра рон знішчаны . мы вырашылі ,	. *твой член *рон уничтоженный . мы *вырашылі ,	. твой друг рон уничтожен . мы решили ,	
рон знішчаны . мы вырашылі , што так будзе	*рон уничтоженный . мы *вырашылі , что так будет	рон уничтожен . мы решили , что так будет	



KEY
фізкультуры	физкультуре	физкультуры	
у нас урок фізкультуры .	в нас урок физкультуре .	у нас урок физкультуры .	
у нас урок фізкультуры .	в нас урок физкультуре .	у нас урок физкультуры .	



KEY
начальніка	начальника	начальником	
груба жартаваць з свайго начальніка на людзях	грубо шутить со своего начальника на людях	грубо шутить над своим начальником на людях	
груба жартаваць з свайго начальніка на людзях .	грубо шутить со своего начальника на людях .	грубо шутить над своим начальником на людях .	
груба жартаваць з свайго начальніка на людзях .	грубо шутить со своего начальника на людях .	грубо шутить над своим начальником на людях .	



KEY
буракі	свёклы	свеклу	
я не люблю буракі .	я не *люблю свёклы .	я не люблю свеклу .	
я не люблю буракі .	я не *люблю свёклы .	я не люблю свеклу .	



KEY
важная	важная	важны	
садавіна і агародніна важная для	плод и овощ важная для	фрукты и овощи важны для	
садавіна і агародніна важная для збалансованага харчавання	плод и овощ важная для *збалансованага питания	фрукты и овощи важны для сбалансированного питания	
садавіна і агародніна важная для збалансованага харчавання .	плод и овощ важная для *збалансованага питания .	фрукты и овощи важны для сбалансированного питания .	
і агародніна важная для збалансованага харчавання .	и овощ важная для *збалансованага питания .	и овощи важны для сбалансированного питания .	



KEY
за	коммунистического	коммунистической	
за пабудову камуністычнага ссср ў за і за мір	коммунистического общество в ссср и за мир в всем	коммунистической партии в тесном сотрудничестве со всеми социалистическими странами	



KEY
вайну	войну	войне	
дзядуля рэдка гаварыў пра вайну .	дедушка редко *гаварыў о войну .	дедушка редко говорил о войне .	
дзядуля рэдка гаварыў пра вайну .	дедушка редко *гаварыў о войну .	дедушка редко говорил о войне .	



KEY
гатовы	готовый	готов	
я ўжо гатовы .	я уже готовый .	я уже готов .	



KEY
свайго	своей	свою	
я пахаваў свайго сабаку на могілках для	я похоронил своей собаку на кладбище для	я похоронил свою собаку на кладбище для	



KEY
маці	мать	матери	
заўтра дзень маці .	завтра день мать .	завтра день матери .	



KEY
саміх	них	их	
суд сведчанні пра згвалтаванне дзіцяці , бо іх саміх	суд свидетельстве о изнасилование ребёнке , так как них	суд свидетельства об изнасиловании ребёнка , так как их	
дзіцяці , бо іх саміх засудзяць па закону пра	ребёнке , так как них самих *засудзяць по закона	ребёнка , так как их осудят по закону о	



KEY
нямецкай	немецкой	немецкого	
я вучыў французскую замест нямецкай .	я *вучыў французскую вместо немецкой .	я учил французский вместо немецкого .	
я вучыў французскую замест нямецкай .	я *вучыў французскую вместо немецкой .	я учил французский вместо немецкого .	
я вучыў французскую замест нямецкай .	я *вучыў французскую вместо немецкой .	я учил французский вместо немецкого .	



KEY
білет	билет	билета	
выкарыстання пракампасціруйце білет аднаразовага выкарыстання , не чакаючы наступнага	использования *пракампасціруйце билет одноразового использования , не *чакаючы следующей	и проездного билета многоразового пользования прокомпостируйте билет одноразового пользования	



KEY
роўна	ровно	равно	
мне ўсё роўна , ці ён прыйдзе	мне всё ровно , или он придёт	мне всё равно , придёт ли он	
ўсё роўна , ці ён прыйдзе , ці не	всё ровно , или он придёт , или не	всё равно , придёт ли он или нет .	



KEY
мой	мой	моя	
сабака . а дзе мой ?	собака . а где мой ?	собака . а где моя ?	



KEY
рэжым	отражения	изображения	
опцыя « « » дазваляе дазваляе выбраць рэжым рэжым	*опцыя « расположение » *дазваляе *выбраць режим отражения изображения	опция « расположение » позволяет выбрать режим изображения .	
« « » дазваляе дазваляе выбраць рэжым рэжым .	« расположение » *дазваляе *выбраць режим отражения изображения .	« расположение » позволяет выбрать режим изображения . есть	
» дазваляе дазваляе выбраць рэжым рэжым . . .	» *дазваляе *выбраць режим отражения изображения . давай будем	» позволяет выбрать режим изображения . есть четыре варианта	



KEY
партыі	тёсным	тесном	
што пад кіраўніцтвам камуністычнай партыі ў цесным супрацоўніцтве супрацоўніцтве	руководством коммунистической партии в тёсным сотрудничестве со всеми социалистическими	руководством коммунистической партии в тесном сотрудничестве со всеми социалистическими	



KEY
гарачае	горячей	горячо	
куй жалеза , пакуль гарачае	*куй железо , пока горячей	куй железо , пока горячо	
куй жалеза , пакуль гарачае .	*куй железо , пока горячей .	куй железо , пока горячо .	



KEY
мова	ваш	наши	
нашы , , школы , мову , мова такая	порядки , наши школы , язык , ваш язык	мы . вот вам наши порядки , наши школы	



KEY
прэзідэнта	президента	президенты	
што ён будзе балатавацца на прэзідэнта ?	что он будет *балатавацца на президента ?	что он будет баллотироваться в президенты ?	
ён будзе балатавацца на прэзідэнта ?	он будет *балатавацца на президента ?	он будет баллотироваться в президенты ?	



KEY
азёрамі	озёрами	озерами	
царква акружаная лясамі і азёрамі .	церковь окружённая лесами и озёрами .	церковь окружена лесами и озерами .	
царква акружаная лясамі і азёрамі .	церковь окружённая лесами и озёрами .	церковь окружена лесами и озерами .	



KEY
гультай	лентяй	ленивый	
які ж ты гультай !	яки ж ты лентяй !	какой же ты ленивый !	
які ж ты гультай !	яки ж ты лентяй !	какой же ты ленивый !	
які ж ты гультай !	яки ж ты лентяй !	какой же ты ленивый !	



KEY
пад	коммунистической	коммунистического	
пад кіраўніцтвам камуністычнай партыі ў цесным супрацоўніцтве супрацоўніцтве усімі	коммунистической партии в тёсным сотрудничестве со всеми социалистическими странами	коммунистического общества в ссср и за мир во всём	



KEY
праліў	пролив	пролил	
я праліў праліў на дыван .	я пролив кофе на ковёр .	я пролил кофе на ковёр .	
я праліў праліў на дыван .	я пролив кофе на ковёр .	я пролил кофе на ковёр .	
я праліў праліў на дыван .	я пролив кофе на ковёр .	я пролил кофе на ковёр .	



KEY
гэтыя	эти	это	
гэтыя лекі дапамогуць табе .	эти леки помогут тебе .	это лекарство тебе поможет .	
гэтыя лекі дапамогуць табе .	эти леки помогут тебе .	это лекарство тебе поможет .	
гэтыя лекі дапамогуць табе .	эти леки помогут тебе .	это лекарство тебе поможет .	



KEY
тоні	тоне	тони	
тоні — выхаваны хлопчык .	тоне — воспитанный мальчик .	тони - воспитанный мальчик .	
тоні — выхаваны хлопчык .	тоне — воспитанный мальчик .	тони - воспитанный мальчик .	



KEY
яшчэ	ещё	еще	
палітыкі , ён усё яшчэ не вылез з пялёнак	политики , он всё ещё не *вылез с пелён	политики , он всё еще не вылез из пелёнок	
ён усё яшчэ не вылез з пялёнак .	он всё ещё не *вылез с пелён .	он всё еще не вылез из пелёнок .	
усё яшчэ не вылез з пялёнак .	всё ещё не *вылез с пелён .	всё еще не вылез из пелёнок .	
часопіс . я яго яшчэ не прачытаў .	журнал . я его ещё не прочитал .	журнал . я его еще не прочитал .	



KEY
банку	банке	банку	
дайце мне банку варэння .	дайте мне банке варенья .	дайте мне банку варенья .	



KEY
французскую	французскую	французский	
яна пераклала ліст з японскай на французскую	яна переложила лист с японской на французскую	она перевела письмо с японского на французский	
яна пераклала ліст з японскай на французскую .	яна переложила лист с японской на французскую .	она перевела письмо с японского на французский .	
ліст з японскай на французскую .	лист с японской на французскую .	письмо с японского на французский .	
я вучыў французскую замест нямецкай .	я *вучыў французскую вместо немецкой .	я учил французский вместо немецкого .	
я вучыў французскую замест нямецкай .	я *вучыў французскую вместо немецкой .	я учил французский вместо немецкого .	
я вучыў французскую замест нямецкай .	я *вучыў французскую вместо немецкой .	я учил французский вместо немецкого .	



KEY
спадару	господине	господину	
я забыўся патэлефанаваць спадару форду .	я *забыўся *патэлефанаваць господине форду .	я забыл позвонить господину форду .	
я забыўся патэлефанаваць спадару форду .	я *забыўся *патэлефанаваць господине форду .	я забыл позвонить господину форду .	
я забыўся патэлефанаваць спадару форду .	я *забыўся *патэлефанаваць господине форду .	я забыл позвонить господину форду .	



KEY
бульбу	картофель	картофеле	
я нічога не ведаю пра бульбу .	я ничего не *ведаю о картофель .	я ничего не знаю о картофеле .	
нічога не ведаю пра бульбу .	ничего не *ведаю о картофель .	ничего не знаю о картофеле .	



KEY
найлепшая	наилучшая	наилучший	
нямецкая — найлепшая з моваў	немецкая — наилучшая с *моваў	немецкий — наилучший язык в	
 найлепшая з моваў у свеце	 наилучшая с *моваў в мире	 наилучший язык в мире .	



KEY
гады	гады	годы	
але ў апошнія гады расце людзей , што улоўліваць	но в последние гады растёт людей , что *улоўліваць	но в последние годы растет людей , улавливающих в	



KEY
апытаных	опрошенных	опрашиваемых	
68,4 % апытаных беларусаў адказалі , што	68,4 % опрошенных белорусов ответили , что	68,4 % опрашиваемых белорусов ответили , что	



KEY
абдурыла	одурачила	обдурила	
яна абдурыла яго .	яна одурачила его .	она обдурила его .	
яна абдурыла яго .	яна одурачила его .	она обдурила его .	



KEY
кодам	кодом	кодами	
tatoeba — праэкт з адкрытым крынічным кодам	tatoeba — *праэкт с открытым *крынічным кодом	tatoeba — проект с открытыми исходными кодами	
tatoeba — праэкт з адкрытым крынічным кодам	tatoeba — *праэкт с открытым *крынічным кодом	tatoeba — проект с открытыми исходными кодами	
— праэкт з адкрытым крынічным кодам	— *праэкт с открытым *крынічным кодом	— проект с открытыми исходными кодами	
праэкт з адкрытым крынічным кодам	*праэкт с открытым *крынічным кодом	проект с открытыми исходными кодами	



KEY
гаворцы	речи	наречии	
у старадаўняй гаворцы гэтыя знакі азначалі	в старинной речи эти знаки *азначалі	в старинном наречии эти знаки означали	
старадаўняй гаворцы гэтыя знакі азначалі « дух » »	старинной речи эти знаки *азначалі « дух » и	"старинном наречии эти знаки означали `` дух '' и"	



KEY
папала	попала	попало	
ён купляў якія папала кнігі .	он покупок которые попала книги .	он покупал какие попало книги .	
ён купляў якія папала кнігі .	он покупок которые попала книги .	он покупал какие попало книги .	
ён купляў якія папала кнігі .	он покупок которые попала книги .	он покупал какие попало книги .	



KEY
цягам	них	их	
. » . часу цягам часу іх на «	. с тягам времени них значение изменилась на «	`` . с времени их значение поменялось на ``	



KEY
расплюшчыце	откроете	откройте	
расплюшчыце вочы .	откроете глаза .	откройте глаза .	



KEY
звычайна	обычно	конечно	
так , звычайна .	так , обычно .	да , конечно .	
так , звычайна .	так , обычно .	да , конечно .	



KEY
госці	гостье	гости	
госці заўсёды прыносяць радасць ;	гостье всегда *прыносяць радость ;	гости всегда приносят радость ;	
госці заўсёды прыносяць радасць ; не прыходам	гостье всегда *прыносяць радость ; не приходом	гости всегда приносят радость ; не приходом	



KEY
пакой	комната	комнату	
ён убег у пакой .	он вбежал в комната .	он вбежал в комнату .	



KEY
жыццё	электричестве	электричества	
уявіць , якім было б нашае жыццё без жыццё	представить , которым бывше бы нашей жизнь без электричестве	представить , какой была б наша жизнь без электричества	
б нашае жыццё без жыццё ?	бы нашей жизнь без электричестве ?	б наша жизнь без электричества ?	



KEY
што	которому	которой	
наснілася , ці , , якому , што ён	что он *чжуанцзы , или бабочка , которому *наснілася	снилось , что он бабочка бабочка , которой снилось	
што ён , , я таксама , я часу	которому *наснілася , что он *чжуанцзы , я также	которой снилось , , я тоже с не ,	



KEY
прысеў	присев	присел	
ён прысеў пачытаць раман .	он присев *пачытаць роман .	он присел почитать роман .	
ён прысеў пачытаць раман .	он присев *пачытаць роман .	он присел почитать роман .	



KEY
павярнулася	повернулась	вернулась	
няўжо дарэнда павярнулася ?	*няўжо *дарэнда повернулась ?	неужели доренда вернулась ?	
няўжо дарэнда павярнулася ?	*няўжо *дарэнда повернулась ?	неужели доренда вернулась ?	
няўжо дарэнда павярнулася ?	*няўжо *дарэнда повернулась ?	неужели доренда вернулась ?	



KEY
нямецкая	немецкая	немецкий	
нямецкая — найлепшая з моваў	немецкая — наилучшая с *моваў	немецкий — наилучший язык в	
нямецкая — найшепшая мова ў	немецкая — *найшепшая язык в	немецкий — наилучший язык в	
якая мова прасцейшая : французская ці нямецкая .	которая язык *прасцейшая : французская или немецкая .	какой язык проще : французский или немецкий .	
прасцейшая : французская ці нямецкая .	*прасцейшая : французская или немецкая .	проще : французский или немецкий .	



KEY
)	чужим	чужом	
( здавалася ! ) ) чужой : : ,	*здавалася бы ! ) чужим языке : *славацкай ,	казалось бы ! ) чужом языке : словацком ,	



KEY
наснілася	что	кто	
наснілася , ці , , якому , што ён	что он *чжуанцзы , или бабочка , которому *наснілася	кто я , иногда пишет или афорист , который	



KEY
ўвагі	внимания	внимание	
не змаглі прыняць да ўвагі асаблівыя патрэбы састарэлых людзей	не смогли принять к внимания особые потребности *састарэлых людей	не смогли принять во внимание особые нужды пожилых людей	
прыняць да ўвагі асаблівыя патрэбы састарэлых людзей .	принять к внимания особые потребности *састарэлых людей .	принять во внимание особые нужды пожилых людей .	



KEY
офісу	офису	офиса	
ён вярнуўся з офісу .	он вернулся с офису .	он вернулся из офиса .	
ён вярнуўся з офісу .	он вернулся с офису .	он вернулся из офиса .	



KEY
раніцы	утре	утро	
добрай раніцы .	хорошим утре .	доброе утро !	
добрай раніцы .	хорошим утре .	доброе утро !	
добрай раніцы .	хорошим утре .	доброе утро !	



KEY
яе	неё	ней	
хоча , каб я прыдумваў пра яе .	хочет , чтобы я *прыдумваў о неё .	хочет , чтобы я придумывал о ней .	
каб я прыдумваў пра яе .	чтобы я *прыдумваў о неё .	чтобы я придумывал о ней .	



KEY
метра	метра	метро	
у метра чамусьці шмат міліцыі .	в метра почему-то много милиции .	в метро почему-то много милиции .	



KEY
часопіс	журнал	"журнал	
часопіс « домбра » » на	журнал « домбра » выходить на	"журнал `` домбра '' выходит на"	



KEY
ваш	ваш	ваше	
дзякуй за ваш ліст .	*дзякуй за ваш лист .	спасибо за ваше письмо .	
дзякуй за ваш ліст .	*дзякуй за ваш лист .	спасибо за ваше письмо .	
дзякуй за ваш ліст .	*дзякуй за ваш лист .	спасибо за ваше письмо .	



KEY
найлепшы	наилучший	лучший	
ён мой найлепшы сябра . ён мне	он мой наилучший член . он мне	он мой лучший друг . он мне	
ён мой найлепшы сябра . ён мне амаль	он мой наилучший член . он мне почти	он мой лучший друг . он мне прямо	
гэта быў найлепшы дзень майго	эта был наилучший день моей	это был лучший день в	
 найлепшы дзень майго жыцця .	 наилучший день моей жизни .	 лучший день в моей жизни	



KEY
японскую	японскую	японский	
перакладзіце наступныя сказы на японскую	переложите следующие предложения на японскую	переведите следующие предложения на японский	
перакладзіце наступныя сказы на японскую .	переложите следующие предложения на японскую .	переведите следующие предложения на японский .	



KEY
розных	разных	различных	
у беларусі жывуць прадстаўнікі розных рэлігій .	в беларуси живут представители разных религий .	в беларуси живут представители различных религий .	



KEY
кошыку	корзинке	корзине	
у кошыку было даволі шмат гнілых	в корзинке бывше довольно много гнилых	в корзине было довольно много гнилых	
у кошыку было даволі шмат гнілых яблыкаў	в корзинке бывше довольно много гнилых яблок	в корзине было довольно много гнилых яблок	



KEY
ўласную	собственную	собственном	
моў , нічога не ведае пра ўласную .	языков , ничего не *ведае о собственную .	языков , ничего не знает о собственном .	
нічога не ведае пра ўласную .	ничего не *ведае о собственную .	ничего не знает о собственном .	



KEY
хоць	хотя	хоть	
ты не можаш хоць раз прыйсці ўчасна ? я	ты не можешь хотя однажды прийти *ўчасна ? я	ты не можешь хоть раз прийти вовремя ? я	
цёмна , хоць вока выкалі .	темно , хотя глаз *выкалі .	темно , хоть глаз выколи .	
цёмна , хоць вока выкалі .	темно , хотя глаз *выкалі .	темно , хоть глаз выколи .	



KEY
афарызмы	который	которому	
: часам , афарызмы , ці піша , часам	: шахматист , который иногда *піша афоризмы , *афарыст	словно чжуан-цзы , которому приснилось , что он бабочка	



KEY
гэтае	этой	этот	
усе ведаюць і любляць гэтае свята	все *ведаюць и *любляць этой свято	все знают и любят этот праздник	
усе ведаюць і любляць гэтае свята .	все *ведаюць и *любляць этой свято .	все знают и любят этот праздник .	
усе ведаюць і любляць гэтае свята .	все *ведаюць и *любляць этой свято .	все знают и любят этот праздник .	



KEY
часу	времени	времён	
і абычаі нашых беларускіх часу часу , ужо ужо	*абычаі наших белорусских панов времени наполеона , уже сейчас	и наших белорусских панов времён наполеона , уже теперь	



KEY
щто	щто	что	
карл маркс сцвярджае , щто «	карл *маркс *сцвярджае , щто «	карл маркс утверждает , что ``	
карл маркс сцвярджае , щто « «	карл *маркс *сцвярджае , щто « история	карл маркс утверждает , что `` история	
карл маркс сцвярджае , щто « « гісторыя —	карл *маркс *сцвярджае , щто « история общество —	карл маркс утверждает , что `` история общества -	
маркс сцвярджае , щто « « гісторыя — —	*маркс *сцвярджае , щто « история общество — эта	маркс утверждает , что `` история общества - это	
щто « « гісторыя — — гэта гісторыя класавай	щто « история общество — эта история классовой борьбы	что `` история общества - это история классовой борьбы	



KEY
яе	неё	её	
што ты думаеш пра яе сказ ?	что ты *думаеш о неё предложение ?	что ты думаешь о её предложении ?	
што ты думаеш пра яе сказ ?	что ты *думаеш о неё предложение ?	что ты думаешь о её предложении ?	
ты думаеш пра яе сказ ?	ты *думаеш о неё предложение ?	ты думаешь о её предложении ?	
што ты думаеш пра яе прапанову ?	что ты *думаеш о неё предложение ?	что ты думаешь о её предложении ?	
што ты думаеш пра яе прапанову ?	что ты *думаеш о неё предложение ?	что ты думаешь о её предложении ?	
ты думаеш пра яе прапанову ?	ты *думаеш о неё предложение ?	ты думаешь о её предложении ?	
ты не можаш разлічваць на яе дапамогу .	ты не можешь *разлічваць на неё помощь .	ты не можешь рассчитывать на её помощь .	
не можаш разлічваць на яе дапамогу .	не можешь *разлічваць на неё помощь .	не можешь рассчитывать на её помощь .	
табе падабаюцца яе песні ?	тебе *падабаюцца неё пёсне ?	тебе нравятся её песни ?	
табе падабаюцца яе песні ?	тебе *падабаюцца неё пёсне ?	тебе нравятся её песни ?	
табе падабаюцца яе песні ?	тебе *падабаюцца неё пёсне ?	тебе нравятся её песни ?	
невялічкая праграма з базавай функцыянальнасцю . у яе перакладзе	*невялічкая программа с базовой *функцыянальнасцю . в неё переводе	небольшая программа с базовой функциональностью . в её переводе	
дарагая , як я яе куплю ?	дорогая , как я неё покупку ?	дорогая , как я её куплю ?	
я ведаю яе адрэсу .	я *ведаю неё *адрэсу .	я знаю её адрес .	
я ведаю яе адрэсу .	я *ведаю неё *адрэсу .	я знаю её адрес .	
я ведаю яе адрэсу .	я *ведаю неё *адрэсу .	я знаю её адрес .	
каб прасты смертны мог яе зразумець .	чтобы *прасты смертный мог неё понять .	чтобы простой смертный мог её понять .	
з думкаай , што яе дачка вырасла .	с *думкаай , что неё дочь выросла .	смириться с , что её дочь выросла .	



KEY
побыту	быта	быту	
ўзроўні эзатэрычных абрадаў , прыстасаваных да і побыту арабаў	уровне эзотерических обрядов , *прыстасаваных к и быта арабов	уровне экзотерических обрядов , приспособленных к и быту арабов	



KEY
перакладуць	переложат	переведут	
гэты сказ перакладуць .	это предложение переложат .	это предложение переведут .	



KEY
ўсім	всем	всём	
жадаю плёну заўсёды і ва ўсім	*жадаю плода всегда и в всем	желаю успехов всегда и во всём	
жадаю плёну заўсёды і ва ўсім .	*жадаю плода всегда и в всем .	желаю успехов всегда и во всём .	
плёну заўсёды і ва ўсім .	плода всегда и в всем .	успехов всегда и во всём .	



KEY
рускай	русской	русском	
я не буду дадаваць сказы на рускай .	я не буду *дадаваць предложения на русской .	я не буду добавлять предложения на русском .	
буду дадаваць сказы на рускай .	буду *дадаваць предложения на русской .	буду добавлять предложения на русском .	



KEY
старадаўняй	старинной	"старинном	
старадаўняй гаворцы гэтыя знакі азначалі « дух » »	старинной речи эти знаки *азначалі « дух » и	"старинном наречии эти знаки означали `` дух '' и"	



KEY
звязнай	связной	связным	
артыкул напісаны звязнай сучаснай мовай	артикул написанный связной современным языком	статья написана связным современным языком	
артыкул напісаны звязнай сучаснай мовай .	артикул написанный связной современным языком .	статья написана связным современным языком .	
артыкул напісаны звязнай сучаснай мовай .	артикул написанный связной современным языком .	статья написана связным современным языком .	



KEY
гаворцы	речи	"наречии	
гаворцы гэтыя знакі азначалі « дух » » «	речи эти знаки *азначалі « дух » и «	"наречии эти знаки означали `` дух '' и ``"	



KEY
песенным	песенным	песенном	
гетэр яані — найлепшая спявачка на песенным конкурсе	гетер *яані — наилучшая певица на песенным конкурсе	геттер яани — лучшая певица на песенном конкурсе	
— найлепшая спявачка на песенным конкурсе « еўрабачанне 2011	— наилучшая певица на песенным конкурсе « *еўрабачанне 2011	— лучшая певица на песенном конкурсе « евровидение 2011	



KEY
папулярная	популярная	популярна	
гэтая манга даволі папулярная ў	это манго довольно популярная в	эта манга довольно популярна в	
гэтая манга даволі папулярная ў кітаі	это манго довольно популярная в китае	эта манга довольно популярна в китае	
гэтая манга даволі папулярная ў кітаі .	это манго довольно популярная в китае .	эта манга довольно популярна в китае .	



KEY
англійскай	английским	английском	
 заспяваем песню на англійскай мове	 *заспяваем пёсню на английским языке	 споём песню на английском .	
ёсць ёсць журналы на англійскай мове ?	давай будем журналы на английским языке ?	библиотеке есть журналы на английском языке .	
журналы на англійскай мове ?	журналы на английским языке ?	журналы на английском языке .	



KEY
і	тем	том	
што каму рупіць , аб аб і	что кому *рупіць , тот о тем	кого что болит , тот о том	



KEY
,	обычае	обычаи	
так так , так так шчыра малюе , ,	так ясно , так честно *малюе характер , обычае	так ясно , так искренне рисует характер , обычаи	
так , так так шчыра малюе , , звычаі	ясно , так честно *малюе характер , обычае и	ясно , так искренне рисует характер , обычаи и	



KEY
нядзелі	воскресенье	воскресеньям	
у нядзелі магазін зачынены .	в воскресенье магазин закрытый .	по воскресеньям магазин закрыт .	
у нядзелі магазін зачынены .	в воскресенье магазин закрытый .	по воскресеньям магазин закрыт .	
у нядзелі магазін зачынены .	в воскресенье магазин закрытый .	по воскресеньям магазин закрыт .	
у нядзелі крама не працуе	в воскресенье магазин не *працуе	по воскресеньям магазин не работает	
у нядзелі крама не працуе .	в воскресенье магазин не *працуе .	по воскресеньям магазин не работает .	
у нядзелі крама не працуе .	в воскресенье магазин не *працуе .	по воскресеньям магазин не работает .	



KEY
найлепшая	наилучшая	лучшая	
гетэр яані — найлепшая спявачка на	гетер *яані — наилучшая певица на	геттер яани — лучшая певица на	
гетэр яані — найлепшая спявачка на песенным конкурсе	гетер *яані — наилучшая певица на песенным конкурсе	геттер яани — лучшая певица на песенном конкурсе	
— найлепшая спявачка на песенным конкурсе « еўрабачанне 2011	— наилучшая певица на песенным конкурсе « *еўрабачанне 2011	— лучшая певица на песенном конкурсе « евровидение 2011	



KEY
табе	тебе	тебя	
табе калісьці здраджваў сябра ?	тебе когда-то *здраджваў член ?	тебя когда-то предавал друг ?	
табе калісьці здраджваў сябра ?	тебе когда-то *здраджваў член ?	тебя когда-то предавал друг ?	
табе калісьці здраджваў сябра ?	тебе когда-то *здраджваў член ?	тебя когда-то предавал друг ?	



KEY
манга	манго	манга	
гэтая манга даволі папулярная ў	это манго довольно популярная в	эта манга довольно популярна в	
гэтая манга даволі папулярная ў кітаі	это манго довольно популярная в китае	эта манга довольно популярна в китае	
гэтая манга даволі папулярная ў кітаі .	это манго довольно популярная в китае .	эта манга довольно популярна в китае .	



KEY
няма	нету	нет	
няма такога слова ў рускай	нету такого слово в русским	нет такого слова в русском	
няма такога слова ў рускай мове .	нету такого слово в русским языке .	нет такого слова в русском языке .	
няма такога слова ў рускай мове .	нету такого слово в русским языке .	нет такого слова в русском языке .	
у нас сёння няма заняткаў	в нас сегодня нету занятий	у нас сегодня нет занятий	
у нас сёння няма заняткаў , бо гэта	в нас сегодня нету занятий , так как	у нас сегодня нет занятий , потому что	
сёння няма заняткаў , бо гэта нядзеля .	сегодня нету занятий , так как это воскресенье	сегодня нет занятий , потому что это воскресенье	
няма заняткаў , бо гэта нядзеля .	нету занятий , так как это воскресенье	нет занятий , потому что это воскресенье	
няма нічога новага пад сонцам	нету ничего нового под солнцем	нет ничего нового под солнцем	
у слоўніку няма слова « gullible »	в словаре нету слово « gullible »	в словаре нет слова « gullible »	
у слоўніку няма слова « gullible »	в словаре нету слово « gullible »	в словаре нет слова « gullible »	
у жніўні заняткаў няма .	в августе занятий нету .	в августе занятий нет .	
няма нічога благога ў ,	нету ничего дурного в ,	нет ничего плохого в том	
няма нічога благога ў , што хлопец	нету ничего дурного в , что парень	нет ничего плохого в том , что	
маёй мовы няма ў спісе	моим языка нету в списке	моего языка нет в списке	
маёй мовы няма ў спісе !	моим языка нету в списке !	моего языка нет в списке !	
няма бога апрача алаха ,	нету бога кроме *алаха ,	нет бога , кроме аллаха	
у арктыцы пінгвінаў няма .	в *арктыцы пингвинов нету .	в арктике пингвинов нет .	
у арктыцы пінгвінаў няма .	в *арктыцы пингвинов нету .	в арктике пингвинов нет .	
амаль няма такіх людзей , што	почти нету таких людей , что	почти нет таких людей , которые	



KEY
пачакайце	подождите	погодите	
пачакайце , не страляйце !	подождите , не *страляйце !	погодите , не стреляйте !	
пачакайце , не страляйце !	подождите , не *страляйце !	погодите , не стреляйте !	



KEY
такая	такая	такой	
гэтая кава такая гарачая , што я	этот кофе такая горячая , что я	этот кофе такой горячий , что я	
гэтая кава такая гарачая , што я не	этот кофе такая горячая , что я не	этот кофе такой горячий , что я не	



KEY
вялікі	большой	большое	
вялікі дзякуй !	большой *дзякуй !	большое спасибо !	
вялікі дзякуй !	большой *дзякуй !	большое спасибо !	



KEY
а	а	за	
« а — « » ? » — «	« а почему они красные ? » — «	это за ягода ? » — « » .	



KEY
яго	его	него	
 у яго ёсць ёсць машына	 в его давай будем машина	 у него есть машина .	



KEY
прапанову	предложение	предложении	
што ты думаеш пра яе прапанову ?	что ты *думаеш о неё предложение ?	что ты думаешь о её предложении ?	
што ты думаеш пра яе прапанову ?	что ты *думаеш о неё предложение ?	что ты думаешь о её предложении ?	
ты думаеш пра яе прапанову ?	ты *думаеш о неё предложение ?	ты думаешь о её предложении ?	



KEY
мова	ваш	вам	
мова такая такая ж , і наша наша ,	ваш язык такая ж , как и наша ,	вам наши порядки , наши школы , , такой	



KEY
сотні	сотне	сотни	
навошта , але штогод інапланецяне выкрадаюць сотні людзей .	зачем , но ежегодно *інапланецяне *выкрадаюць сотне людей .	зачем , но ежегодно инопланетяне похищают сотни людей .	
але штогод інапланецяне выкрадаюць сотні людзей .	но ежегодно *інапланецяне *выкрадаюць сотне людей .	но ежегодно инопланетяне похищают сотни людей .	



KEY
расце	растёт	растет	
але ў апошнія гады расце людзей , што улоўліваць	но в последние гады растёт людей , что *улоўліваць	но в последние годы растет людей , улавливающих в	



KEY
налева	налево	влево	
перасунь палец налева ці направа	*перасунь палец налево или направо	передвинь палец влево или вправо	
перасунь палец налева ці направа , каб	*перасунь палец налево или направо , чтобы	передвинь палец влево или вправо , чтобы	
перасунь палец налева ці направа , каб пабачыць іншую	*перасунь палец налево или направо , чтобы *пабачыць другое	передвинь палец влево или вправо , чтобы увидеть другое	



KEY
рускай	русским	русском	
няма такога слова ў рускай	нету такого слово в русским	нет такого слова в русском	
няма такога слова ў рускай мове .	нету такого слово в русским языке .	нет такого слова в русском языке .	
няма такога слова ў рускай мове .	нету такого слово в русским языке .	нет такого слова в русском языке .	



KEY
кітай	китай	китае	
ён напісаў кнігу пра кітай .	он написал книгу о китай .	он написал книгу о китае .	



KEY
правы	права	прав	
або ты не правы ,	либо ты не права ,	или ты не прав ,	
або ты не правы , або ён .	либо ты не права , либо он .	или ты не прав , или он .	
ты не правы , або ён .	ты не права , либо он .	ты не прав , или он .	
кліент заўсёды правы .	клиент всегда права .	клиент всегда прав .	



KEY
прыйдзе	придёт	придет	
магчыма , яна прыйдзе .	возможно , она придёт .	возможно , она придет .	



KEY
гэты	эта	эту	
я больш не магу цярпець гэты	я более не маге терпеть эта	я больше не могу терпеть эту	
больш не магу цярпець гэты боль .	более не маге терпеть эта боль .	больше не могу терпеть эту боль .	



KEY
ружы	розе	розы	
ў садзе , садзіць ружы .	в саде , *садзіць розе .	в саду , сажает розы .	



KEY
зброі	оружии	оружия	
экспарт зброі быў забаронены .	экспорт оружии был запрещённый .	экспорт оружия был запрещен .	
экспарт зброі быў забаронены .	экспорт оружии был запрещённый .	экспорт оружия был запрещен .	



KEY
значэнні	значении	значения	
у гэтага іерогліфа два значэнні	в этого *іерогліфа два значении	у этого иероглифа два значения	
у гэтага іерогліфа два значэнні .	в этого *іерогліфа два значении .	у этого иероглифа два значения .	
у гэтага іерогліфа два значэнні .	в этого *іерогліфа два значении .	у этого иероглифа два значения .	



KEY
лета	лето	лета	
ветраных званочкаў — адзна з характэрных рыс японскага лета	ветреных колокольчиков — *адзна с *характэрных рис японского лето	перезвон ветряных колокольчиков - из характерных черт японского лета	
званочкаў — адзна з характэрных рыс японскага лета ,	колокольчиков — *адзна с *характэрных рис японского лето ,	ветряных колокольчиков - из характерных черт японского лета ,	
— адзна з характэрных рыс японскага лета , але	— *адзна с *характэрных рис японского лето , но	колокольчиков - из характерных черт японского лета , но	
з характэрных рыс японскага лета , але ў апошнія	с *характэрных рис японского лето , но в последние	из характерных черт японского лета , но в последние	



KEY
«	сатанические	сатанинские	
« « сатанінскія » салмана салмана — — сапраўдны	« сатанические стихотворении » *салмана *рушдзі — настоящий шедевр	« сатанинские стихи » салмана рушди — настоящий шедевр	
« сатанінскія » салмана салмана — — сапраўдны шэдэўр	сатанические стихотворении » *салмана *рушдзі — настоящий шедевр современной	сатанинские стихи » салмана рушди — настоящий шедевр современной	



KEY
хутчэй	поскорее	скорей	
прыходзь хутчэй ; справа тэрміновая .	приходи поскорее ; справа срочная .	приходи скорей ; дело срочное .	
прыходзь хутчэй ; справа тэрміновая .	приходи поскорее ; справа срочная .	приходи скорей ; дело срочное .	
прыходзь хутчэй ; справа тэрміновая .	приходи поскорее ; справа срочная .	приходи скорей ; дело срочное .	



KEY
вымаўленні	произношении	произношения	
абодва вымаўленні правільныя .	оба произношении правильные .	оба произношения правильные .	



KEY
чацвёртым	четвёртым	четвёртом	
мой пакой на чацвёртым паверсе .	моя комната на четвёртым этаже .	моя комната на четвёртом этаже .	



KEY
той	тот	том	
урачы выпісваюць рэцэпты на той жа	врачи *выпісваюць рецепты на тот же	врачи выписывают рецепты на том же	



KEY
танная	дешёвая	дешёвый	
бульба вельмі танная .	картофель очень дешёвая .	картофель очень дешёвый .	



KEY
гэта	это	этого	
аж пакуль усё гэта возера не высушу , аж	*аж пока всё это озеро не *высушу , *аж	в них из этого озера полно слёз людских и	



KEY
гісторыя	общество	общества	
карл маркс сцвярджае , щто « « гісторыя —	карл *маркс *сцвярджае , щто « история общество —	карл маркс утверждает , что `` история общества -	
маркс сцвярджае , щто « « гісторыя — —	*маркс *сцвярджае , щто « история общество — эта	маркс утверждает , что `` история общества - это	
щто « « гісторыя — — гэта гісторыя класавай	щто « история общество — эта история классовой борьбы	что `` история общества - это история классовой борьбы	



KEY
лісця	листа	листьев	
горная была накрытая коўдрай лісця , мяккая і зручная	горная была *накрытая одеялом листа , мягкая и удобная	горная была укрыта одеялом листьев , мягкая и удобная	
была накрытая мяккай коўдрай лісця , па якой было	была *накрытая мягким одеялом листа , по которой бывше	была укрыта мягким одеялом листьев , по которому было	
коўдрай лісця , па якой было лёгка ісці .	одеялом листа , по которой бывше легко идти .	одеялом листьев , по которому было легко идти .	
лісця , па якой было лёгка ісці .	листа , по которой бывше легко идти .	листьев , по которому было легко идти .	



KEY
раману	роману	романа	
не чытаў жоднага яго раману .	не *чытаў *жоднага его роману .	читал ни одного его романа .	



KEY
здароўя	эта	это	
не люблю курыць , бо гэта здароўя для для	не *люблю курить , так как эта плохо для	не люблю курить , потому что это вредно для	
люблю курыць , бо гэта здароўя для для .	*люблю курить , так как эта плохо для здоровья	люблю курить , потому что это вредно для здоровья	



KEY
пераклала	переложила	перевела	
яна пераклала ліст з японскай на	яна переложила лист с японской на	она перевела письмо с японского на	
яна пераклала ліст з японскай на французскую	яна переложила лист с японской на французскую	она перевела письмо с японского на французский	
яна пераклала ліст з японскай на французскую .	яна переложила лист с японской на французскую .	она перевела письмо с японского на французский .	



KEY
старшыні	председателе	председателю	
ласка , звяртайцеся да старшыні !	ласка , *звяртайцеся к председателе !	пожалуйста , обращайтесь к председателю !	



KEY
звычку	привычку	привычка	
бацька мае звычку чытаць газеты	отец мои привычку *чытаць газеты	отца есть привычка читать газеты	
 звычку чытаць газеты звычку снеданнем	 привычку *чытаць газеты перед завтраком	 привычка читать газеты завтраком .	



KEY
дрэва	дерево	дерева	
ён выразаў з дрэва статую буды	он *выразаў с дерево истукане *буды	он вырезал из дерева статую будды	
ён выразаў з дрэва статую буды .	он *выразаў с дерево истукане *буды .	он вырезал из дерева статую будды .	
ён выразаў з дрэва статую буды .	он *выразаў с дерево истукане *буды .	он вырезал из дерева статую будды .	
ён выразаў з дрэва статую буды .	он *выразаў с дерево истукане *буды .	он вырезал из дерева статую будды .	
выразаў з дрэва статую буды .	*выразаў с дерево истукане *буды .	вырезал из дерева статую будды .	
стол зроблены з дрэва .	стол *зроблены с дерево .	стол сделан из дерева .	
стол зроблены з дрэва .	стол *зроблены с дерево .	стол сделан из дерева .	
стол зроблены з дрэва .	стол *зроблены с дерево .	стол сделан из дерева .	
яны злезлі з дрэва .	яны *злезлі с дерево .	они слезли с дерева .	
яны злезлі з дрэва .	яны *злезлі с дерево .	они слезли с дерева .	
яны злезлі з дрэва .	яны *злезлі с дерево .	они слезли с дерева .	



KEY
а	а	на	
адмаўляецца , пачаставаць работнікаў , не сцяг , а	и *адмаўляецца *пачаставаць работников , не знамя , а	черепичным пивом » , чтобы это отпраздновать . на	



KEY
эгаістычная	эгоистичная	эгоистична	
анжаліка піклз вельмі эгаістычная .	*анжаліка *піклз очень эгоистичная .	анжелика пиклз очень эгоистична .	
анжаліка піклз вельмі эгаістычная .	*анжаліка *піклз очень эгоистичная .	анжелика пиклз очень эгоистична .	
анжаліка піклз вельмі эгаістычная .	*анжаліка *піклз очень эгоистичная .	анжелика пиклз очень эгоистична .	



KEY
супраць	противно	против	
ты за ці супраць абортаў ?	ты за или противно абортов ?	ты за или против абортов ?	



KEY
нямецкай	немецким	немецкого	
у берліне , акрамя нямецкай мовы .	в берлине , кроме немецким языка .	в берлине , кроме немецкого языка .	



KEY
ва	в	во	
жадаю плёну заўсёды і ва	*жадаю плода всегда и в	желаю успехов всегда и во	
жадаю плёну заўсёды і ва ўсім	*жадаю плода всегда и в всем	желаю успехов всегда и во всём	
жадаю плёну заўсёды і ва ўсім .	*жадаю плода всегда и в всем .	желаю успехов всегда и во всём .	
плёну заўсёды і ва ўсім .	плода всегда и в всем .	успехов всегда и во всём .	



KEY
кваліфікацыя	неё	её	
немагчыма адмаўляць , яе кваліфікацыя вельмі	невозможно *адмаўляць , что неё квалификация	невозможно отрицать , что её квалификация	
немагчыма адмаўляць , яе кваліфікацыя вельмі высокая высокая	невозможно *адмаўляць , что неё квалификация очень высокая	невозможно отрицать , что её квалификация очень .	



KEY
была	была	было	
сёння была была вельмі холадна .	сегодня утром была очень холодно .	сегодня утром было очень холодно .	
сёння была была вельмі холадна .	сегодня утром была очень холодно .	сегодня утром было очень холодно .	
сёння была была вельмі холадна .	сегодня утром была очень холодно .	сегодня утром было очень холодно .	



KEY
выкарыстання	использования	пользования	
і праязнога білета шматразовага выкарыстання пракампасціруйце білет аднаразовага выкарыстання	и проездного билета многократного использования *пракампасціруйце билет одноразового использования	и проездного билета многоразового пользования прокомпостируйте билет одноразового пользования	
і праязнога білета шматразовага выкарыстання пракампасціруйце білет аднаразовага выкарыстання	и проездного билета многократного использования *пракампасціруйце билет одноразового использования	и проездного билета многоразового пользования прокомпостируйте билет одноразового пользования	
і праязнога білета шматразовага выкарыстання пракампасціруйце білет аднаразовага выкарыстання	и проездного билета многократного использования *пракампасціруйце билет одноразового использования	пользования прокомпостируйте билет одноразового пользования , не дожидаясь следующей	
праязнога білета шматразовага выкарыстання пракампасціруйце білет аднаразовага выкарыстання ,	проездного билета многократного использования *пракампасціруйце билет одноразового использования ,	проездного билета многоразового пользования прокомпостируйте билет одноразового пользования ,	
праязнога білета шматразовага выкарыстання пракампасціруйце білет аднаразовага выкарыстання ,	проездного билета многократного использования *пракампасціруйце билет одноразового использования ,	проездного билета многоразового пользования прокомпостируйте билет одноразового пользования ,	
выкарыстання пракампасціруйце білет аднаразовага выкарыстання , не чакаючы наступнага	использования *пракампасціруйце билет одноразового использования , не *чакаючы следующей	и проездного билета многоразового пользования прокомпостируйте билет одноразового пользования	
выкарыстання пракампасціруйце білет аднаразовага выкарыстання , не чакаючы наступнага	использования *пракампасціруйце билет одноразового использования , не *чакаючы следующей	пользования прокомпостируйте билет одноразового пользования , не дожидаясь следующей	
выкарыстання пракампасціруйце білет аднаразовага выкарыстання , не чакаючы наступнага	использования *пракампасціруйце билет одноразового использования , не *чакаючы следующей	пользования прокомпостируйте билет одноразового пользования , не дожидаясь следующей	
аднаразовага выкарыстання , не чакаючы наступнага .	одноразового использования , не *чакаючы следующей .	одноразового пользования , не дожидаясь следующей .	



KEY
зачыніце	закроете	закройте	
зачыніце акно .	закроете *акно .	закройте окно .	
зачыніце акно .	закроете *акно .	закройте окно .	



KEY
мы	мы	вы	
не вы , а , тое , , мы	не вы , а то самой , что мы	школы , , такой , и , только вы	
а , тое , , мы . дык дык	а то самой , что мы . *дык *наце	такой , и , только вы » . говорили	



KEY
сучасным	современным	современном	
мова ўжо не так актуальная ў сучасным свеце ,	язык уже не так *актуальная в современным мире ,	язык уже не так практичен в современном мире ,	
не так актуальная ў сучасным свеце , як некалькі	не так *актуальная в современным мире , как несколько	не так практичен в современном мире , как несколько	



KEY
гэтым	этим	этому	
я яшчэ звяжуся з вамі па гэтым	я ещё *звяжуся с вами по этим	я ещё свяжусь с вами по этому	
звяжуся з вамі па гэтым пытанні .	*звяжуся с вами по этим вопросе .	свяжусь с вами по этому вопросу .	
з вамі па гэтым пытанні .	с вами по этим вопросе .	с вами по этому вопросу .	



KEY
мой	мой	моей	
два разы большы за мой .	два разы больший за мой .	в два раза больше моей .	



KEY
непрымальныя	неприемлемые	неприемлемы	
для нас непрымальныя знявага « « слабага	для нас неприемлемые *знявага « слабого пола	"для нас неприемлемы `` слабого пола ''"	



KEY
білета	билета	билет	
і праязнога білета шматразовага выкарыстання пракампасціруйце білет аднаразовага выкарыстання	и проездного билета многократного использования *пракампасціруйце билет одноразового использования	пользования прокомпостируйте билет одноразового пользования , не дожидаясь следующей	



KEY
майму	моему	моим	
мая цётка радавалася майму поспеху .	мая тётка радовалась моему успехе .	моя тётя радовалась моим успехам .	
мая цётка радавалася майму поспеху .	мая тётка радовалась моему успехе .	моя тётя радовалась моим успехам .	
мая цётка радавалася майму поспеху .	мая тётка радовалась моему успехе .	моя тётя радовалась моим успехам .	



KEY
гарачы	горячий	горящий	
леў перастрыбнуў праз гарачы абруч	*леў *перастрыбнуў через горячий обруч	лев прыгнул скрозь горящий обруч	
леў перастрыбнуў праз гарачы абруч .	*леў *перастрыбнуў через горячий обруч .	лев прыгнул скрозь горящий обруч .	
леў перастрыбнуў праз гарачы абруч .	*леў *перастрыбнуў через горячий обруч .	лев прыгнул скрозь горящий обруч .	
леў перастрыбнуў праз гарачы абруч .	*леў *перастрыбнуў через горячий обруч .	лев прыгнул скрозь горящий обруч .	



KEY
два	два	дважды	
два — чатыры . гэта ёсць ёсць , то	два — четыре . эта давай будем , то	дважды два четыре . это есть , из этого	



KEY
футболе	футболе	футболу	
чэмпіянат свету па футболе пройдзе ў казані .	чемпионат мира по футболе *пройдзе в проповеди .	чемпионат мира по футболу пройдёт в казани .	
чэмпіянат свету па футболе пройдзе ў казані .	чемпионат мира по футболе *пройдзе в проповеди .	чемпионат мира по футболу пройдёт в казани .	



KEY
h6	h6	h1	
— , ад h1 ад h6 » , —	шесть , от h1 к h6 » , —	— « шесть , от h1 до h6 »	



KEY
камуністычнага	в	во	
вялікіх поспехаў за пабудову за пабудову камуністычнага ссср ў	в борьбе за построение коммунистического общество в ссср и	общества в ссср и за мир во всём мире	



KEY
гетэр	гетер	геттер	
я вялікі аматар гетэр яані .	я большой любитель гетер *яані .	я большой поклонник геттер яани .	
я вялікі аматар гетэр яані .	я большой любитель гетер *яані .	я большой поклонник геттер яани .	
я вялікі аматар гетэр яані .	я большой любитель гетер *яані .	я большой поклонник геттер яани .	
я вялікая аматарка гетэр яані .	я большая любительница гетер *яані .	я большая поклонница геттер яани .	
я вялікая аматарка гетэр яані .	я большая любительница гетер *яані .	я большая поклонница геттер яани .	
я вялікая аматарка гетэр яані .	я большая любительница гетер *яані .	я большая поклонница геттер яани .	
памерці разам з гетэр яані .	умереть вместе с гетер *яані .	умереть вместе с геттер яани .	
гетэр яані — найлепшая спявачка на	гетер *яані — наилучшая певица на	геттер яани — лучшая певица на	
гетэр яані — найлепшая спявачка на песенным конкурсе	гетер *яані — наилучшая певица на песенным конкурсе	геттер яани — лучшая певица на песенном конкурсе	



KEY
чарапіцы	укладки	кладке	
чарапіцы , , частуе частуе так так « «	укладки черепице , хозяин *частуе строителей так *званым «	кладке черепицы , хозяин угощает строителей так называемым «	



KEY
ўваходзіць	входить	входит	
літва ўваходзіць у еўрапейскі саюз .	литва входить в европейский союз .	литва входит в европейский союз .	



KEY
новая	новая	нова	
хаця гэта праблема і не новая	*хаця эта проблема и не новая	хотя данная проблема и не нова	
гэта праблема і не новая , у наш час	эта проблема и не новая , в наше время	данная проблема и не нова , в наше время	



KEY
адзін	один	одно	
ён напісаў адзін ліст .	он написал один лист .	он написал одно письмо .	
ён напісаў адзін ліст .	он написал один лист .	он написал одно письмо .	



KEY
нашу	нашу	нашей	
на нашу прапанова , яго	на нашу мысль , его	с нашей точки зрения его	
на нашу прапанова , яго прапанова	на нашу мысль , его предложение	с нашей точки зрения его предложение	



KEY
мэры	мэры	мери	
мэры цікавіць палітыка .	мэры *цікавіць политика .	мери интересует политика .	
мэры цікавіць палітыка .	мэры *цікавіць политика .	мери интересует политика .	



KEY
навошта	зачем	почему	
навошта людзі ходзяць у кіно	зачем люди ходят в кино	почему люди ходят в кино	



KEY
праблемы	проблемы	проблем	
мой бацька кінуў паліць праз праблемы з здароўем .	мой отец бросил *паліць через проблемы со здоровьем .	мой отец бросил курить из-за проблем со здоровьем .	
бацька кінуў паліць праз праблемы з здароўем .	отец бросил *паліць через проблемы со здоровьем .	отец бросил курить из-за проблем со здоровьем .	



KEY
дні	дне	дня	
я не еў тры дні .	я не *еў три дне .	я не ел три дня .	
я не еў тры дні .	я не *еў три дне .	я не ел три дня .	



KEY
больш	более	больше	
я больш не магу цярпець гэты	я более не маге терпеть эта	я больше не могу терпеть эту	
больш не магу цярпець гэты боль .	более не маге терпеть эта боль .	больше не могу терпеть эту боль .	
чым больш чытаеш , тым больш	чем более *чытаеш , тем более	чем больше читаешь , тем больше	
чым больш чытаеш , тым больш	чем более *чытаеш , тем более	чем больше читаешь , тем больше	
чым больш чытаеш , тым больш спазнаеш	чем более *чытаеш , тем более *спазнаеш	чем больше читаешь , тем больше познаешь	
чым больш чытаеш , тым больш спазнаеш	чем более *чытаеш , тем более *спазнаеш	чем больше читаешь , тем больше познаешь	
больш чытаеш , тым больш спазнаеш .	более *чытаеш , тем более *спазнаеш .	больше читаешь , тем больше познаешь .	
больш чытаеш , тым больш спазнаеш .	более *чытаеш , тем более *спазнаеш .	больше читаешь , тем больше познаешь .	
чытаеш , тым больш спазнаеш .	*чытаеш , тем более *спазнаеш .	читаешь , тем больше познаешь .	



KEY
ж	кто	что	
доўга доўга не мог , , ж ж :	*праснуўшыся долго не мог понять , кто ж он	словно чжуан-цзы , которому приснилось , что он бабочка	
доўга доўга не мог , , ж ж :	*праснуўшыся долго не мог понять , кто ж он	он бабочка , которой снится , что она чжуан-цзы	
ж ж : : , , наснілася што ,	кто ж он : *чжуанцзы , которому *наснілася ,	что она чжуан-цзы , который проснувшись , долго не	
ж ж : : , , наснілася што ,	кто ж он : *чжуанцзы , которому *наснілася ,	что он бабочка бабочка , которой снилось , ,	



KEY
правёў	провёл	провел	
нядзелю нядзелю я правёў , чытаючы навелы .	прошлое воскресенье я провёл , *чытаючы *навелы .	прошлое воскресенье я провел , читая новеллы .	
нядзелю я правёў , чытаючы навелы .	воскресенье я провёл , *чытаючы *навелы .	воскресенье я провел , читая новеллы .	
я правёў , чытаючы навелы .	я провёл , *чытаючы *навелы .	я провел , читая новеллы .	



KEY
нашае	нашей	наша	
ты можаш уявіць , якім было б нашае жыццё	ты можешь представить , которым бывше бы нашей жизнь	ты можешь представить , какой была б наша жизнь	
уявіць , якім было б нашае жыццё без жыццё	представить , которым бывше бы нашей жизнь без электричестве	представить , какой была б наша жизнь без электричества	
б нашае жыццё без жыццё ?	бы нашей жизнь без электричестве ?	б наша жизнь без электричества ?	



KEY
«	они	она	
— « а — « » ? » —	— « а почему они красные ? » —	— « а почему она ? » — «	



KEY
сапраўднае	настоящей	настоящая	
гэта было не сапраўднае каханне	эта бывше не настоящей любовь	это не была настоящая любовь	
гэта было не сапраўднае каханне .	эта бывше не настоящей любовь .	это не была настоящая любовь .	
гэта было не сапраўднае каханне .	эта бывше не настоящей любовь .	это не была настоящая любовь .	



KEY
вялікім	большим	большом	
яны жывуць у вялікім доме	яны живут в большим доме	они живут в большом доме	
яны жывуць у вялікім доме .	яны живут в большим доме .	они живут в большом доме .	



KEY
мясцовым	местным	местном	
ён вывучаў электрамеханіку і будызм у мясцовым	он *вывучаў электромеханике и буддизм в местным	он изучал электромеханику и буддизм в местном	
электрамеханіку і будызм у мясцовым універсітэце .	электромеханике и буддизм в местным университете .	электромеханику и буддизм в местном университете .	



KEY
перакладзіце	переложите	переведите	
перакладзіце наступныя сказы на японскую	переложите следующие предложения на японскую	переведите следующие предложения на японский	
перакладзіце наступныя сказы на японскую .	переложите следующие предложения на японскую .	переведите следующие предложения на японский .	



KEY
мужу	муже	мужу	
яна дапамагла свайму мужу выканаць яго работу .	яна помогла своему муже выполнить его работу .	она помогла своему мужу выполнить его работу .	



KEY
адмоўнае	отрицательной	отрицательное	
як люстра , зразумець станоўчае і адмоўнае ў сябе	как люстра , понять положительной и отрицательной в себя	как , можно понять положительное и отрицательное в себе	
станоўчае і адмоўнае ў сябе ; выкарыстоўваючы гісторыю як	положительной и отрицательной в себя ; *выкарыстоўваючы историю как	положительное и отрицательное в себе ; используя историю как	
адмоўнае ў сябе ; выкарыстоўваючы гісторыю як люстра ,	отрицательной в себя ; *выкарыстоўваючы историю как люстра ,	отрицательное в себе ; используя историю как , можно	



KEY
яму	яму	ему	
яна дала яму гадзіннік .	яна дала яму часы .	она дала ему часы .	
яна дала яму гадзіннік .	яна дала яму часы .	она дала ему часы .	
яму падабаецца не толькі бейсбол	яму *падабаецца не только бейсбол	ему нравится не только бейсбол	
яму падабаецца не толькі бейсбол ,	яму *падабаецца не только бейсбол ,	ему нравится не только бейсбол ,	
яму пашанцавала знайсці работу .	яму *пашанцавала *знайсці работу .	ему посчастливилось найти работу .	
яму пашанцавала знайсці работу .	яму *пашанцавала *знайсці работу .	ему посчастливилось найти работу .	
яму пашанцавала знайсці работу .	яму *пашанцавала *знайсці работу .	ему посчастливилось найти работу .	
не дурыце яму галаву .	не *дурыце яму голову .	не дурите ему голову .	
не дурыце яму галаву .	не *дурыце яму голову .	не дурите ему голову .	
але яму пашанцавала .	но яму *пашанцавала .	но ему повезло .	
але яму пашанцавала .	но яму *пашанцавала .	но ему повезло .	



KEY
тысячы	тысяче	тысячи	
больш за дзве тысячы йен .	более за две тысяче *йен .	него не больше тысячи иен .	
больш за дзве тысячы йен .	более за две тысяче *йен .	у не больше тысячи иен .	



KEY
скончыць	закончить	завершить	
я мушу скончыць гэту работу да паслязаўтра	я *мушу закончить эту работу к послезавтра	я должен завершить эту работу до послезавтра	
мушу скончыць гэту работу да паслязаўтра .	*мушу закончить эту работу к послезавтра .	должен завершить эту работу до послезавтра .	



KEY
таму	поэтому	потому	
мне падабаецца wxwidgets , таму что	мне *падабаецца wxwidgets , поэтому *что	мне нравится wxwidgets , потому что	
падабаецца wxwidgets , таму что , у адрозненне у	*падабаецца wxwidgets , поэтому *что , в отличие от	нравится wxwidgets , потому что , в отличие от	



KEY
хлусіць	врать	врёт	
ён хлусіць , як наняты .	он врать , как *наняты .	он врёт , как сивый .	
ён хлусіць , як наняты .	он врать , как *наняты .	он врёт , как сивый .	



KEY
пра	о	об	
могуць перадаць у суд сведчанні пра згвалтаванне дзіцяці ,	могут передать в суд свидетельстве о изнасилование ребёнке ,	могут передать в суд свидетельства об изнасиловании ребёнка ,	
перадаць у суд сведчанні пра згвалтаванне дзіцяці , бо	передать в суд свидетельстве о изнасилование ребёнке , так	передать в суд свидетельства об изнасиловании ребёнка , так	
у суд сведчанні пра згвалтаванне дзіцяці , бо іх	в суд свидетельстве о изнасилование ребёнке , так как	в суд свидетельства об изнасиловании ребёнка , так как	
суд сведчанні пра згвалтаванне дзіцяці , бо іх саміх	суд свидетельстве о изнасилование ребёнке , так как них	суд свидетельства об изнасиловании ребёнка , так как их	



KEY
вока	глаз	глаза	
я маю два вока .	я маю два глаз .	у меня два глаза .	
я маю два вока .	я маю два глаз .	у меня два глаза .	
я маю два вока .	я маю два глаз .	у меня два глаза .	



KEY
зубнога	врача	врачу	
ібрагім ібрагім талончык талончык да зубнога ,	*ібрагім взял *талончык к зубного врача ,	ибрагим взял талончик к зубному врачу ,	



KEY
мой	мой	мою	
ты хочаш ведаць мой сакрэт ? ён	ты хочешь *ведаць мой *сакрэт ? он	ты хочешь знать мою тайну ? это	
ты хочаш ведаць мой сакрэт ? ён вельмі	ты хочешь *ведаць мой *сакрэт ? он очень	ты хочешь знать мою тайну ? это очень	



KEY
вывучыць	изучить	выучить	
я хачу вывучыць іўрыт .	я хочу изучить *іўрыт .	я хочу выучить иврит .	
я хачу вывучыць іўрыт .	я хочу изучить *іўрыт .	я хочу выучить иврит .	



KEY
парасонам	зонтиком	зонтом	
два вучня пад адным парасонам ? двузначная сітуацыя !	два ученика под одним зонтиком ? *двузначная ситуация !	два ученика под одним зонтом ? двойственная ситуация !	



KEY
прыхільнікаў	силки	силы	
амерыканскія імперыялісты , імкнучыся і раздрабіць дэзарганізаваць прыхільнікаў	американские *імперыялісты , *імкнучыся *раздрабіць и *дэзарганізаваць силки	американские империалисты , стремясь раздробить и дезорганизовать силы	



KEY
кітайскай	китайским	китайского	
залежны стан выкарыстоўваецца ў паўночных дыялектах кітайскай	зависимое состояние *выкарыстоўваецца в северных диалектах китайским	страдательный залог используется в северных диалектах китайского	
выкарыстоўваецца ў паўночных дыялектах кітайскай мовы ў наступных выпадках	*выкарыстоўваецца в северных диалектах китайским языка в следующих случаях	используется в северных диалектах китайского языка в следующих случаях	



KEY
іх	них	их	
я іх ведаю .	я них *ведаю .	я их знаю .	
я іх ведаю .	я них *ведаю .	я их знаю .	
мы іх адшукаем .	мы них *адшукаем .	мы их разыщем .	
мы іх адшукаем .	мы них *адшукаем .	мы их разыщем .	



KEY
вуліц	паутины	паутине	
мае думкі ліпнуць да вуліц львоўскіх вуліц	мои мысли *ліпнуць к паутины *львоўскіх улиц	мои мысли липнут к паутине львовских улиц	
думкі ліпнуць да вуліц львоўскіх вуліц .	мысли *ліпнуць к паутины *львоўскіх улиц .	мысли липнут к паутине львовских улиц .	



KEY
вялікі	большой	большая	
твой сабака вельмі вялікі .	*твой собака очень большой .	твоя собака очень большая .	
твой сабака вельмі вялікі .	*твой собака очень большой .	твоя собака очень большая .	



KEY
,	то	что	
не вы , а , тое , , мы	не вы , а то самой , что мы	а то самое , что мы . вот вам	



KEY
дзіця	ребёнок	ребёнка	
ён уратаваў дзіця з агню .	он спас ребёнок с огня .	он спас ребёнка из огня .	
ён уратаваў дзіця з агню .	он спас ребёнок с огня .	он спас ребёнка из огня .	



KEY
веру	веру	верю	
я веру ў бога .	я веру в бога .	я верю в бога .	
я веру ў цябе .	я веру в тебя .	я верю в тебя .	



KEY
ездзіць	ездить	ездит	
сястра штогод ездзіць у карпаты .	сестра ежегодно ездить в *карпаты .	каждый год ездит в карпаты .	



KEY
блізарукі	близорукий	близорук	
кожны дзясяты чалавек блізарукі .	каждый десятый человек близорукий .	каждый десятый человек близорук .	



KEY
мой	моё	мой	
вось мой сцяг для нюнорска .	вот моё знамя для *нюнорска .	вот мой флаг для нюнорска .	
вось мой сцяг для нюнорска . так ідэалогія ідэалогія	вот моё знамя для *нюнорска . так как *ідэалогія	вот мой флаг для нюнорска . поскольку идеология нюнорска	



KEY
іх	них	ним	
як мы па іх сумуем , яны б хутчэй	как мы по них *сумуем , они бы поскорее	как мы по ним скучаем , они бы раньше	



KEY
прыгоннае	крепостного	крепостное	
прэзідэнт беларусі зноў увёў прыгоннае права , забараніўшы працаўнікам	президент беларуси снова ввёл крепостного право , запретив работникам	президент беларуси снова ввёл крепостное право , запретив работникам	



KEY
ветраных	ветреных	ветряных	
бадзёры перазвон ветраных званочкаў —	бодрый перезвон ветреных колокольчиков —	бодрящий перезвон ветряных колокольчиков -	
бадзёры перазвон ветраных званочкаў — адзна з	бодрый перезвон ветреных колокольчиков — *адзна с	бодрящий перезвон ветряных колокольчиков - из характерных	
бадзёры перазвон ветраных званочкаў — адзна з характэрных рыс	бодрый перезвон ветреных колокольчиков — *адзна с *характэрных рис	бодрящий перезвон ветряных колокольчиков - из характерных черт японского	



KEY
выгляду	вида	виду	
там дрэва , з выгляду падобнае на папяровую шаўкоўніцу	там дерево , с вида *падобнае на бумажную шелковицу	там дерево , с виду похожее на бумажную шелковицу	
дрэва , з выгляду падобнае на папяровую шаўкоўніцу ,	дерево , с вида *падобнае на бумажную шелковицу ,	дерево , с виду похожее на бумажную шелковицу ,	
судзячы па яго выгляду ,	*судзячы по его вида ,	судя по его виду ,	
 выгляду , ён магчыма жаўнер	 вида , он возможно *жаўнер	 виду , он возможно солдат	



KEY
песні	пёсне	песни	
табе падабаюцца яе песні ?	тебе *падабаюцца неё пёсне ?	тебе нравятся её песни ?	
табе падабаюцца яе песні ?	тебе *падабаюцца неё пёсне ?	тебе нравятся её песни ?	
табе падабаюцца яе песні ?	тебе *падабаюцца неё пёсне ?	тебе нравятся её песни ?	



KEY
вядомы	известный	известен	
мандалай вядомы сваімі пагадамі і	*мандалай известный своими пагодами и	мандалай известен своими пагодами и	
мандалай вядомы сваімі пагадамі і манастырамі	*мандалай известный своими пагодами и монастырями	мандалай известен своими пагодами и монастырями	



KEY
здаровым	здоровым	здоровом	
у здаровым целе здаровы дух .	в здоровым теле здоровый дух .	в здоровом теле здоровый дух .	



KEY
цікавую	интересную	интересую	
заглянуў у кнігарню і купіў цікавую кнігу .	заглянул в *кнігарню и *купіў интересную книгу .	заглянул в книжный и купил интересую книгу .	



KEY
нас	нас	на	
гульні натхніць нас на стварэнне лепшых праграм для дыстанцыйнай	игре *натхніць нас на создание лучших программ для дистанционным	вдохновить нас на создание приложений для электронного дистанционного ?	
нас на стварэнне лепшых праграм для дыстанцыйнай	нас на создание лучших программ для дистанционным	на создание приложений для электронного дистанционного ?	
 адзін з нас мусіць пайсці	 один с нас *мусіць пойти	 должен пойти на собрание .	



KEY
вядомы	известный	известным	
гэта ты стаў такі вядомы , што фарамп пісаць	эта ты пруд токи известный , что *фарамп *пісаць	как это ты таким известным , что фарамп писать	
такі вядомы , што фарамп пісаць пра цябе ?	токи известный , что *фарамп *пісаць о тебя ?	таким известным , что фарамп писать про тебя ?	
вядомы , што фарамп пісаць пра цябе ?	известный , что *фарамп *пісаць о тебя ?	известным , что фарамп писать про тебя ?	



KEY
горкі	горки	горькое	
застаўся горкі паслясмак .	остался горки *паслясмак .	осталось горькое послевкусие .	
застаўся горкі паслясмак .	остался горки *паслясмак .	осталось горькое послевкусие .	
застаўся горкі паслясмак .	остался горки *паслясмак .	осталось горькое послевкусие .	



KEY
блакітнае	голубой	голубое	
якое неба блакітнае !	которой небо голубой !	какое небо голубое !	
якое неба блакітнае !	которой небо голубой !	какое небо голубое !	



KEY
англійская	английская	английский	
гэта таму што англійская —	эта потому что английская —	это потому что английский —	
гэта таму што англійская — сусветная мова	эта потому что английская — мировой язык	это потому что английский — международный язык	
таму што англійская — сусветная мова	потому что английская — мировой язык	потому что английский — международный язык	



KEY
карычневы	коричневый	коричневое	
будынак пошты карычневы .	здание почты коричневый .	здание почты коричневое .	



KEY
роўнымi	ровнымi	равными	
i роўнымi ў годнасцi i правах . яны надзелены	i ровнымi в достоинства i правах . яны наделённый	и равными в своем и правах . наделены разумом	



KEY
пытанні	вопросе	вопросу	
звяжуся з вамі па гэтым пытанні .	*звяжуся с вами по этим вопросе .	свяжусь с вами по этому вопросу .	
з вамі па гэтым пытанні .	с вами по этим вопросе .	с вами по этому вопросу .	



KEY
маім	моим	моём	
болей не вучыцца ў маім класе .	*болей не *вучыцца в моим классе .	ученица больше не в моём классе .	



KEY
мэры	мэры	мэри	
том пацалаваў мэры ў лоб .	том *пацалаваў мэры в лоб .	том поцеловал мэри в лоб .	
том пацалаваў мэры ў лоб .	том *пацалаваў мэры в лоб .	том поцеловал мэри в лоб .	
мэры думала , што том дарэмна	мэры *думала , что том напрасно	мэри думала , что том напрасно	



KEY
я	наладок	настроек	
. я дзякуй форму я тут »	. я здесь форму наладок *ляплю »	. я тут форму настроек леплю »	
я дзякуй форму я тут »	я здесь форму наладок *ляплю »	я тут форму настроек леплю »	



KEY
паляцеў	улетел	полетел	
птушкай , я б паляцеў да цябе .	птицей , я бы улетел к тебя .	птицей , я бы полетел к тебе .	
я б паляцеў да цябе .	я бы улетел к тебя .	я бы полетел к тебе .	



KEY
нам	зам	нам	
нам запрошваць дантэ на вечарыну	зам *запрошваць *дантэ на вечеринку	нам приглашать данте на вечеринку	
нам запрошваць дантэ на вечарыну ?	зам *запрошваць *дантэ на вечеринку ?	нам приглашать данте на вечеринку ?	
нам запрошваць дантэ на вечарыну ? ні	зам *запрошваць *дантэ на вечеринку ? ни	нам приглашать данте на вечеринку ? ни	
нам ледзьве хапае , каб	зам едва *хапае , чтобы	нам едва хватает , чтобы	
нам ледзьве хапае , каб з ’	зам едва *хапае , чтобы с ’	нам едва хватает , чтобы съесть завтрак	
нам не патрэбная дапамога .	зам не *патрэбная помощь .	нам не нужна помощь .	
нам не патрэбная дапамога .	зам не *патрэбная помощь .	нам не нужна помощь .	
ніколі не ведаеш , што рыхтуе нам	никогда не *ведаеш , что *рыхтуе зам	никогда не знаешь , что готовит нам	
не ведаеш , што рыхтуе нам будучыня .	не *ведаеш , что *рыхтуе зам будущее .	не знаешь , что готовит нам будущее .	
ведаеш , што рыхтуе нам будучыня .	*ведаеш , что *рыхтуе зам будущее .	знаешь , что готовит нам будущее .	
мой бацька часта апавядаў нам пра свае школьныя	мой отец часто *апавядаў зам о свои школьные	мой отец часто рассказывал нам о своих школьных	
мой бацька часта апавядаў нам пра свае школьныя годы	мой отец часто *апавядаў зам о свои школьные *годы	мой отец часто рассказывал нам о своих школьных годах	
часта апавядаў нам пра свае школьныя годы .	часто *апавядаў зам о свои школьные *годы .	часто рассказывал нам о своих школьных годах .	
апавядаў нам пра свае школьныя годы .	*апавядаў зам о свои школьные *годы .	рассказывал нам о своих школьных годах .	
нам пра свае школьныя годы .	зам о свои школьные *годы .	нам о своих школьных годах .	
ці не пайсці нам адсюль ?	или не пойти зам отсюда ?	не уйти ли нам отсюда ?	
ці не пайсці нам адсюль ?	или не пойти зам отсюда ?	не уйти ли нам отсюда ?	
ці не пайсці нам адсюль ?	или не пойти зам отсюда ?	не уйти ли нам отсюда ?	



KEY
парку	парк	парке	
з сваёй сястрой у парку .	со своей сестрой в парк .	со своей сестрой в парке .	
у гэтым парку шмат дрэў ?	в этим парк много деревьев ?	в этом парке много деревьев ?	
у гэтым парку шмат дрэў ?	в этим парк много деревьев ?	в этом парке много деревьев ?	



KEY
станоўчае	положительной	положительное	
як люстра , зразумець станоўчае і адмоўнае ў сябе	как люстра , понять положительной и отрицательной в себя	как , можно понять положительное и отрицательное в себе	
станоўчае і адмоўнае ў сябе ; выкарыстоўваючы гісторыю як	положительной и отрицательной в себя ; *выкарыстоўваючы историю как	положительное и отрицательное в себе ; используя историю как	



KEY
слова	слово	слова	
няма такога слова ў рускай	нету такого слово в русским	нет такого слова в русском	
няма такога слова ў рускай мове .	нету такого слово в русским языке .	нет такого слова в русском языке .	
няма такога слова ў рускай мове .	нету такого слово в русским языке .	нет такого слова в русском языке .	
якая менавіта частка слова «	которая именно часть слово «	какая именно часть слова ``	
 слова « не » »	 слово « не » тебе	" слова `` нет '' тебе"	
у слоўніку няма слова « gullible »	в словаре нету слово « gullible »	в словаре нет слова « gullible »	
у слоўніку няма слова « gullible »	в словаре нету слово « gullible »	в словаре нет слова « gullible »	
глядзіце , не прапусціце ані слова , перапісваючы	смотрите , не *прапусціце ничуть слово , *перапісваючы	смотрите , не пропустите ни слова , переписывая	
глядзіце , не прапусціце ані слова , перапісваючы гэты	смотрите , не *прапусціце ничуть слово , *перапісваючы этот	смотрите , не пропустите ни слова , переписывая документ	
якая менавіта частка слова «	которая именно часть слово «	какая именно часть слова ``	
 слова « « » »	 слово « нету » тебе	" слова `` нет '' тебе"	



KEY
спявае	поёт	поет	
мая дачка спявае ў тэатры .	мая дочь поёт в театре .	моя дочь поет в театре .	



KEY
чатыры	варианты	варианта	
выбраць рэжым рэжым . . . ёсць чатыры варыянты	режим отражения изображения . давай будем четыре варианты показа	позволяет выбрать режим изображения . есть четыре варианта показа	



KEY
рацыю	рацию	рация	
да высновы , што ён меў рацыю .	к вывода , что он *меў рацию .	к выводу , что него была рация .	



KEY
на	на	на"	
часопіс « домбра » » на	журнал « домбра » выходить на	"журнал `` домбра '' выходит на"	



KEY
зачынены	закрытый	закрыт	
у нядзелі магазін зачынены .	в воскресенье магазин закрытый .	по воскресеньям магазин закрыт .	
у нядзелі магазін зачынены .	в воскресенье магазин закрытый .	по воскресеньям магазин закрыт .	
у нядзелі магазін зачынены .	в воскресенье магазин закрытый .	по воскресеньям магазин закрыт .	



KEY
вуліцах	улицах	улицам	
я блукаў па вуліцах , каб забіць час	я бродил по улицах , чтобы убить время	я бродил по улицам , чтобы убить время	



KEY
забаронены	запрещённый	запрещён	
у некаторых абласцях францыі забаронены доступ да замежных сайтаў	в некоторых областях франции запрещённый доступ к иностранных *сайтаў	в некоторых областях франции запрещён доступ к иностранным сайтам	
забаронены доступ да замежных сайтаў для дарослых .	запрещённый доступ к иностранных *сайтаў для взрослых .	запрещён доступ к иностранным сайтам для взрослых .	



KEY
багатая	богатая	богат	
французская мова багатая на сінонімы .	французский язык богатая на синонимы .	французский язык богат на синонимы .	



KEY
вывучаць	изучат	изучать	
жыццё надта кароткае , каб вывучаць нямецкую	жизнь слишком короткой , чтобы изучат немецкую	жизнь слишком коротка , чтобы изучать немецкий	
надта кароткае , каб вывучаць нямецкую .	слишком короткой , чтобы изучат немецкую .	слишком коротка , чтобы изучать немецкий .	
кароткае , каб вывучаць нямецкую .	короткой , чтобы изучат немецкую .	коротка , чтобы изучать немецкий .	



KEY
як	как	так	
 гэта , як здаецца .	 плохо , как *здаецца .	 это не так плохо как	



KEY
слізкае	скользкой	скользкое	
і слізкае дакранулася да наставай шчакі , і яна	и скользкой *дакранулася к *наставай щеки , и она	и скользкое дотронулось до настиной щеки , и она	



KEY
верыць	верить	верит	
ён практык і не верыць у магчымасць цудаў .	он практик и не верить в возможность чудес .	он практик и не верит в возможность чудес .	



KEY
шакаладнае	шоколадного	шоколадное	
: пераходзь на цёмны бок . мы маем шакаладнае	: *пераходзь на *цёмны сторона . мы маем шоколадного	: переходи на тёмную сторону . у есть шоколадное	
бок . мы маем шакаладнае пячэнне	сторона . мы маем шоколадного печенье	сторону . у есть шоколадное печенье	



KEY
таксама	также	тоже	
ён таксама не прыдзе .	он также не *прыдзе .	он тоже не придёт .	
ён таксама не прыдзе .	он также не *прыдзе .	он тоже не придёт .	



KEY
бадзёры	бодрый	бодрящий	
бадзёры перазвон ветраных званочкаў —	бодрый перезвон ветреных колокольчиков —	бодрящий перезвон ветряных колокольчиков -	
бадзёры перазвон ветраных званочкаў — адзна з	бодрый перезвон ветреных колокольчиков — *адзна с	бодрящий перезвон ветряных колокольчиков - из характерных	
бадзёры перазвон ветраных званочкаў — адзна з характэрных рыс	бодрый перезвон ветреных колокольчиков — *адзна с *характэрных рис	бодрящий перезвон ветряных колокольчиков - из характерных черт японского	



KEY
кніга	книга	книжка	
дзе мая кніга ?	где мая книга ?	где моя книжка ?	
дзе мая кніга ?	где мая книга ?	где моя книжка ?	



KEY
»	выходить	выходит	
часопіс « домбра » » на	журнал « домбра » выходить на	"журнал `` домбра '' выходит на"	



KEY
песня	пёсня	песня	
гэта песня заўжды нагадвае мне пра	эта пёсня всегда *нагадвае мне о	эта песня всегда напоминает мне о	
гэта песня заўжды нагадвае мне пра маё дзяцінства	эта пёсня всегда *нагадвае мне о моё детство	эта песня всегда напоминает мне о моём детстве	



KEY
сябе	себя	себе	
як люстра , зразумець станоўчае і адмоўнае ў сябе	как люстра , понять положительной и отрицательной в себя	как , можно понять положительное и отрицательное в себе	
станоўчае і адмоўнае ў сябе ; выкарыстоўваючы гісторыю як	положительной и отрицательной в себя ; *выкарыстоўваючы историю как	положительное и отрицательное в себе ; используя историю как	
адмоўнае ў сябе ; выкарыстоўваючы гісторыю як люстра ,	отрицательной в себя ; *выкарыстоўваючы историю как люстра ,	отрицательное в себе ; используя историю как , можно	



KEY
мая	мая	моя	
дзе мая кніга ?	где мая книга ?	где моя книга ?	
люся — вось мая каханая	*люся — вот мая любимая	люся - вот моя зазноба	
люся — вось мая каханая .	*люся — вот мая любимая .	люся - вот моя зазноба .	
люся — вось мая каханая .	*люся — вот мая любимая .	люся - вот моя зазноба .	
люся — вось мая каханая .	*люся — вот мая любимая .	люся - вот моя зазноба .	
дзе мая кніга ?	где мая книга ?	где моя книжка ?	
дзе мая кніга ?	где мая книга ?	где моя книжка ?	
няхай мая гісторыя паслужыць табе урокам .	пусть мая история *паслужыць тебе уроком .	пусть моя история послужит тебе уроком .	
мая жонка жонка водзіць машыну .	мая жена плохо *водзіць машину .	моя жена плохо водит машину .	
мая жонка жонка водзіць машыну .	мая жена плохо *водзіць машину .	моя жена плохо водит машину .	
мая жонка жонка водзіць машыну .	мая жена плохо *водзіць машину .	моя жена плохо водит машину .	
мая цётка радавалася майму поспеху .	мая тётка радовалась моему успехе .	моя тётя радовалась моим успехам .	
мая цётка радавалася майму поспеху .	мая тётка радовалась моему успехе .	моя тётя радовалась моим успехам .	
мая цётка радавалася майму поспеху .	мая тётка радовалась моему успехе .	моя тётя радовалась моим успехам .	
мая дачка спявае ў тэатры .	мая дочь поёт в театре .	моя дочь поет в театре .	



KEY
возера	озеро	озера	
дом ля возера мой .	дом у озеро мой .	дом у озера мой .	
наліваю я ў іх з гэтага возера поўна слёз	*наліваю я в них с этого озеро полно слёз	наливаю я в них из этого озера полно слёз	
ў іх з гэтага возера поўна слёз слёз і	в них с этого озеро полно слёз людских и	в них из этого озера полно слёз людских и	
аж пакуль усё гэта возера не высушу , аж	*аж пока всё это озеро не *высушу , *аж	в них из этого озера полно слёз людских и	



KEY
лацінская	латинская	латинский	
лацінская — мова будучыні !	латинская — язык будущем !	латинский — язык будущего !	
лацінская — мова будучыні !	латинская — язык будущем !	латинский — язык будущего !	



KEY
толькі	но	то	
суседзі з другога боку , , толькі на на	*казалі соседи со второго боке , но только на	вы — не вы , а то самое ,	



KEY
заплюшчыце	закроете	закройте	
заплюшчыце вочы .	закроете глаза .	закройте глаза .	



KEY
носе	носе	носу	
зарубі сабе на носе !	*зарубі себе на носе !	заруби себе на носу !	
зарубі сабе на носе !	*зарубі себе на носе !	заруби себе на носу !	



KEY
да	зубного	зубному	
ібрагім ібрагім талончык талончык да	*ібрагім взял *талончык к зубного	ибрагим взял талончик к зубному	
ібрагім ібрагім талончык талончык да зубнога ,	*ібрагім взял *талончык к зубного врача ,	ибрагим взял талончик к зубному врачу ,	



KEY
для	для	"для	
для нас непрымальныя знявага « « слабага	для нас неприемлемые *знявага « слабого пола	"для нас неприемлемы `` слабого пола ''"	



KEY
што	что	это	
нідэрландах ёсць ёсць звычай , што , што пры	нидерландах давай будем обычай , что , когда при	черепичным пивом » , чтобы это отпраздновать . на	



KEY
h1	h1	h6	
— « — , ад h1 ад h6 »	— « шесть , от h1 к h6 »	шесть , от h1 до h6 » . —	



