гэта	эта	это	30
гэта	этот	это	14
не	не	нет	14
яе	неё	её	13
няма	нету	нет	10
яму	яму	ему	9
больш	более	больше	9
нам	зам	нам	8
гэтым	этим	этом	8
яна	яна	она	8
у	в	во	7
ж	ж	же	7
дрэва	дерево	дерева	6
выкарыстання	использования	пользования	6
кветкі	цветка	цветы	6
песню	пёсню	песню	5
тысячы	тысяче	тысячи	5
слова	слово	слова	5
гетэр	гетер	геттер	5
нядзелі	воскресенье	воскресеньям	4
іх	них	их	4
май	май	имей	4
мая	мая	моя	4
яго	его	него	4
раней	ранее	раньше	4
,	звезды	звёзды	4
два	два	две	4
клава	всё	все	3
выгляду	вида	виду	3
неба	небо	неба	3
ёй	ней	ей	3
найлепшы	наилучший	лучший	3
нямецкая	немецкая	немецкий	3
магу	маге	могу	3
напісаны	написанный	написана	3
школьныя	школьные	школьных	3
згвалтаванне	изнасилование	изнасиловании	3
гарачая	горячая	горячий	3
парку	парк	парке	3
варожага	вражеского	вражеский	3
пра	о	об	3
французскую	французскую	французский	3
ты	бы	ты	3
цябе	тебя	тебе	3
раніцы	утре	утро	3
адзін	один	одна	3
сказ	предложение	предложении	2
бок	сторона	сторону	2
скончыць	закончить	завершить	2
беларускую	белорусскую	белорусский	2
большы	больший	больше	2
майму	моему	моим	2
маё	моё	моём	2
і	в	во	2
дзіцяці	ребёнке	ребёнка	2
невялікім	небольшим	небольшом	2
таму	поэтому	потому	2
горкі	горки	горькое	2
істота	эта	это	2
гэтыя	эти	это	2
ў	в	во	2
вядомы	известный	известен	2
садзе	саде	саду	2
добрую	хорошую	хорошая	2
англійскай	английским	английском	2
застаўся	остался	осталось	2
ўсім	всем	всём	2
шматразовага	многократного	многоразового	2
ўвагі	внимания	внимание	2
выдуманая	вымышленная	вымышленное	2
пара	пара	пора	2
жудаснага	ужасного	ужасному	2
знішчаны	уничтоженный	уничтожен	2
здароўя	эта	это	2
пайсці	пойти	уйти	2
сведчанні	свидетельстве	свидетельства	2
пакоі	комнате	комнаты	2
купляйце	белорусской	белорусское	2
павярнулася	повернулась	вернулась	2
футболе	футболе	футболу	2
захаду	запада	западу	2
слізкае	скользкой	скользкое	2
агні	огне	огни	2
дзяцінства	детство	детстве	2
вывучаць	изучат	изучать	2
ва	всем	всём	2
такая	такая	такой	2
непісьменнымі	безграмотными	безграмотным	2
парнаграфію	детскую	детской	2
ўсход	восток	востоку	2
наша	наш	наша	2
гэтым	этим	этому	2
лісця	листа	листьев	2
наша	наша	наше	2
мой	моё	мой	2
ён	он	она	2
калекцыю	коллекцию	коллекция	2
табою	будет	пребудет	2
дамашняе	домашнего	домашнее	2
калісьці	когда-то	когда-либо	2
элегантная	элегантная	элегантна	2
песні	пёсне	песни	2
прапанову	предложение	предложении	2
нашу	нашу	нашей	2
мовай	связной	связным	2
працягнула	продолжила	продолжала	2
марка	марка	марко	2
вялікі	большой	большое	2
ва	в	во	2
возера	озеро	озера	2
вывучыць	изучить	выучить	2
папала	попала	попало	2
пытанні	вопросе	вопросу	2
адно	одно	один	2
адзін	один	одно	2
электрамеханіку	электромеханике	электромеханику	2
вядомае	известной	известно	2
кошыку	корзинке	корзине	2
табе	непонятная	непонятна	2
мінулым	прошлым	прошлом	2
апетыту	аппетита	аппетиту	2
зачыніце	закроете	закройте	2
удавы	удавы	вдовы	2
.	порнографию	порнографии	2
пераклала	переложила	перевела	2
хоць	хотя	хоть	2
чырвонае	красной	красное	2
шаўкоўніцай	шелковицей	шелковницей	2
іх	них	ним	2
нямецкую	немецкую	немецкий	2
таксама	также	тоже	2
беларускае	белорусской	белорусское	2
дзіця	ребёнок	ребёнка	2
агародніна	овощ	овощи	2
дзяржаўны	государственное	государственный	2
офісу	офису	офиса	2
нашым	нашими	нашим	2
мэры	мэры	мэри	2
тэрмін	эта	это	2
адчыненымі	открытыми	открытой	2
нашае	нашей	наша	2
шкада	жалко	жаль	2
тоні	тоне	тони	2
поспеху	успехе	успехам	2
якой	которой	которому	2
яшчэ	ещё	еще	2
ваш	ваш	ваше	2
важная	важная	важны	2
звычку	привычку	привычка	2
кодам	кодом	кодами	2
свае	свои	своих	2
папулярная	популярная	популярна	1
правы	права	прав	1
верыць	верить	верит	1
расплюшчыце	откроете	откройте	1
іх	как	так	1
была	была	было	1
сапраўднае	настоящей	настоящая	1
старадаўняй	старинной	старинном	1
шчаслівы	счастливый	счастлив	1
роўнымi	ровнымi	равными	1
начальніка	начальника	начальником	1
сучасным	современным	современном	1
чалавека	человека	человеку	1
турэцкай	турецкой	турецком	1
месцы	месте	места	1
ўрокам	уроком	урокам	1
кожная	каждая	каждой	1
гэта	эти	это	1
купляў	покупок	покупал	1
якой	которой	котором	1
французская	французская	французский	1
лепшы	лучший	лучше	1
штармавое	штормового	штормовое	1
навошта	зачем	почему	1
будучыні	будущем	будущего	1
багатая	богатая	богата	1
японскай	японской	японского	1
заняпад	упадок	упадке	1
вуліцах	улицах	улицам	1
трошкі	немножко	немного	1
гэты	этот	это	1
зачынены	закрытый	закрыт	1
ружы	розе	розы	1
мару	мечту	мечта	1
люстэрка	зеркало	зеркальце	1
краі	крайу	края	1
грым	грим	гримм	1
нашым	нашим	нашем	1
абдурыла	одурачила	обдурила	1
»	выходить	выходит	1
разы	разы	раза	1
высновы	вывода	выводу	1
песня	пёсня	песня	1
ўваходзіць	входить	входит	1
чарапіцы	укладки	кладке	1
паляцеў	улетел	полетел	1
гатовы	готовый	готов	1
дапамогуць	помогут	поможет	1
ўзвышэнне	возвышение	возвышении	1
замка́	замка́	замка	1
шакаладнае	шоколадного	шоколадное	1
банку	банке	банку	1
абяцанку	свой	своё	1
лепшая	лучшая	лучше	1
маці	мать	матери	1
меркаванні	мнении	мнения	1
перакладуць	переложат	переведут	1
пачакайце	подождите	погодите	1
кітай	китай	китае	1
добрая	хорошая	хороша	1
манга	манго	манга	1
апошнім	последним	последнее	1
сэрца	сердце	сердцу	1
ўласную	собственную	собственном	1
мэры	мэры	мери	1
чым	чем	тем	1
кава	холодная	холодное	1
багатая	богатая	богат	1
сваёй	своей	своими	1
жыхарства	жительство	жительства	1
богу	боге	богу	1
палічцы	полочке	полке	1
з	детство	детства	1
выклічце	вызывайте	вызовите	1
гарачы	горячий	горящий	1
дываны	новые	новых	1
вуліц	паутины	паутине	1
сталічным	столичным	столичном	1
небяспечныя	опасные	опасными	1
тым	тем	чем	1
настаўніку	учителе	учителю	1
гатовае	готовой	готов	1
што	что	этом	1
карычневы	коричневый	коричневое	1
не	не	на	1
непрымальныя	неприемлемые	неприемлемы	1
татарскай	татарским	татарском	1
прыпынак	остановка	остановку	1
тэрміновая	срочная	срочное	1
том	том	тома	1
вядомы	известный	известным	1
танная	дешёвая	дешёвый	1
з	них	их	1
папала	попала	покупал	1
эзатэрычных	эзотерических	экзотерических	1
щто	щто	что	1
спадару	господине	господину	1
лета	лето	лета	1
японію	японию	японии	1
і	отклонение	отстранение	1
!	!	"!	1
ён	который	которому	1
сонцам	ничего	нового	1
азёрамі	озёрами	озерами	1
акружаная	окружённая	окружена	1
навучыць	научить	обучить	1
кароткае	короткой	коротка	1
табе	тебе	тебя	1
.	умом	разумом	1
кроку	шаге	шага	1
аднаразовага	одноразового	многоразового	1
нямецкай	немецкой	немецкого	1
змяніўся	изменился	поменялся	1
важныя	важные	важны	1
блізарукі	близорукий	близорук	1
сястра	сестра	сестры	1
што	которому	которой	1
а	что	это	1
сонцам	нового	ничего	1
.	несчастья	несчастий	1
бульбу	картофель	картофеле	1
выпадковыя	случайные	случайны	1
кітайскай	китайской	китайском	1
свой	свой	своё	1
пара	пара	пока	1
нямецкай	немецким	немецкого	1
казалі	самой	самое	1
беларусі	тем	этим	1
сотні	сотне	сотни	1
госці	гостье	гости	1
думаю	думой	думаю	1
яе	неё	ней	1
саміх	них	их	1
поўная	полный	полна	1
гарах	гарях	горах	1
боль	эта	эту	1
ранняй	ранним	раннем	1
ездзіць	ездить	ездит	1
фартэпіяна	фортепьяно	фортепиано	1
ўкраінскім	украинским	украинском	1
лацінская	латинская	латинский	1
хвіліну	минуту	минутку	1
ветраных	ветреных	ветряных	1
толькі	но	на	1
птушка	птица	птичка	1
прыродныя	природные	природными	1
мой	мой	мою	1
цягам	значение	течением	1
англійская	английская	английский	1
вайну	войну	войне	1
пачытаць	присев	присел	1
тата	тата	папа	1
той	тот	той	1
надзеі	надежде	надежды	1
жыццё	электричестве	электричества	1
матэматыку	математике	математики	1
нож	эта	это	1
ровар	эта	это	1
стол	что	стол	1
раману	роману	романа	1
буракі	свёклы	свеклу	1
прыхільнікаў	поклонников	сторонников	1
носе	носе	носу	1
гэта	эта	этот	1
адмерай	отмерь	отрежь	1
гэта	это	этого	1
«	сатанические	сатанинские	1
я	всё	все	1
раманы	время	времени	1
што	что	кто	1
паклёп	клевета	клевещет	1
глыбокае	глубокой	глубокое	1
нядобры	нехороший	хороший	1
яе	неё	нет	1
направа	направо	вправо	1
сучаснай	литературе	литературы	1
найлепшая	наилучшая	наилучший	1
гэтае	этого	этот	1
гэтая	это	эта	1
ці	или	ли	1
цягніку	часы	часов	1
пакой	комната	комнату	1
такі	токи	таким	1
рэсурсы	ресурсы	ресурсами	1
дзіцяці	ребёнке	ребёнку	1
гісторыя	общество	общества	1
—	открытым	открытыми	1
тое	самой	такой	1
кніга	книга	книжка	1
цудоўны	эта	это	1
дні	дне	дня	1
праліў	пролив	пролил	1
прызначаная	назначенная	предназначена	1
заплюшчыце	закроете	закройте	1
краіна	страна	страны	1
бацька	отец	отца	1
аптымістычныя	оптимистические	оптимистичные	1
пытанні	вопросе	вопросы	1
рацыю	рацию	рация	1
станоўчае	положительной	положительное	1
набыла	приобрела	обрела	1
кітайскай	китайским	китайского	1
золата	золото	золота	1
японскую	японскую	японский	1
польшчы	польше	польши	1
мужу	муже	мужу	1
вымаўленні	произношении	произношения	1
парасонам	зонтиком	зонтом	1
фізкультуры	физкультуре	физкультуры	1
цётка	тётка	тётя	1
«	они	она	1
.	свет	светло	1
час	время	времени	1
заданне	своё	свое	1
радасцю	эта	это	1
камуністычнага	общество	общества	1
кліент	права	прав	1
рок	эта	это	1
замежных	иностранных	иностранным	1
налева	налево	влево	1
апытаных	опрошенных	опрашиваемых	1
здаровым	здоровым	здоровом	1
адмоўнае	отрицательной	отрицательное	1
свайго	своей	свою	1
зялёную	зелёную	зелёный	1
метра	метра	метро	1
гэтае	этой	этот	1
яна	она	на	1
і	английскими	английском	1
мне	мне	меня	1
імя	своё	свое	1
хлусіць	врать	врёт	1
побыту	быта	быту	1
пераможца	победитель	победителя	1
біла	било	билл	1
меркаванні	разные	различных	1
дзень	ночью	ночь	1
правёў	провёл	провел	1
старшыні	председателе	председателю	1
прыйдзе	придёт	придет	1
зброі	оружии	оружия	1
сябе	себя	себе	1
полымя	пламя	полымя	1
?	?	"?	1
бадзёры	бодрый	бодрящий	1
мой	мой	моей	1
забаронены	запрещённый	запрещён	1
працы	работе	работы	1
песнямі	пёснями	песнями	1
зайцы	зайце	зайцы	1
што	что	это	1
не	не	ни	1
гультай	лентяй	ленивый	1
рэжым	отражения	изображения	1
забаронены	запрещённый	запрещен	1
паляпшэнне	улучшение	улучшении	1
штогод	едет	ездит	1
пачаўся	начался	началось	1
маім	моим	моём	1
вывучыць	изучить	научиться	1
перакладзіце	переложите	переведите	1
