ведаю	*ведаю	знаю	26
,	*чжуанцзы	,	24
люся	*люся	люся	22
люблю	*люблю	люблю	19
што	*наснілася	,	15
дзякуй	*дзякуй	спасибо	12
су	*су	су	11
бачыў	*бачыў	видел	11
знайсці	*знайсці	найти	11
твой	*твой	твой	11
купіў	*купіў	купил	10
львоў	*львоў	львов	10
народ	*абраны	народ	10
клава	*клава	клава	10
ведае	*ведае	знает	10
цао	*цао	цао	10
«	*замасціць	«	9
працаваць	*працаваць	работать	9
,	*славенскай	,	9
яані	*яані	яани	9
ён	*наснілася	,	9
,	*зярно	,	9
мушу	*мушу	должен	8
падабаецца	*падабаецца	нравится	8
нюнорска	*нюнорска	нюнорска	8
паабяцалі	*паабяцалі	пообещали	8
працуе	*працуе	работает	8
бэці	*бэці	бетти	8
ці	*піша	,	8
цзыю	*цзыю	цзыю	8
,	*македонскай	,	7
болей	*болей	больше	7
твая	*твая	твоя	7
,	*адмаўляецца	,	7
здаецца	*здаецца	кажется	7
згадваць	*згадваць	вспоминать	7
спаць	*спаць	спать	7
часам	*афарыст	,	7
чуў	*чуў	слышал	7
ці	*чжуанцзы	,	7
татоэбе	*татоэбе	татоэбе	6
бачыць	*бачыць	видеть	6
пашукай	*пашукай	поищи	6
блог	*блог	блог	6
ці	*чжуанцзы	что	6
:	*славацкай	:	6
істота	*істота	существо	6
замасціць	*замасціць	«	6
маркс	*маркс	маркс	6
зрабіць	*зрабіць	сделать	6
свеціць	*свеціць	светит	6
знайшоў	*знайшоў	нашёл	6
аж	*аж	аж	6
дазваляе	*дазваляе	позволяет	6
думаеш	*думаеш	думаешь	6
і	*раздрабіць	и	6
ведаць	*ведаць	знать	6
праэкт	*праэкт	проект	6
вырашыць	*вырашыць	решить	6
размаўляць	*размаўляць	запретить	6
роджэр	*роджэр	роджер	6
пачаставаць	*пачаставаць	работников	5
шы	*шы	ши	5
—	*о	—	5
ці	*піша	что	5
анжаліка	*анжаліка	анжелика	5
львове	*львове	во	5
гуляць	*гуляць	играть	5
інфармацію	*інфармацію	информацию	5
сказаць	*сказаць	сказать	5
прысніў	*прысніў	которому	5
буды	*буды	будды	5
сакрэт	*сакрэт	секрет	5
півам	*чарапічным	пивом	5
нагадвае	*нагадвае	напоминает	5
,	*чжуанцзы	бабочка	5
пятроўшчына	*пятроўшчына	откроют	5
,	*адмаўляецца	угостить	5
выразаў	*выразаў	вырезал	5
гэта	*адсвяткаваць	отпраздновать	5
сніць	*сніць	,	5
шукала	*шукала	искала	4
пӱртӱс	*пӱ*ртӱ*с	природа	4
асвойваецца	*асвойваецца	осваивается	4
есці	*есці	есть	4
перастрыбнуў	*перастрыбнуў	прыгнул	4
адрамантаваць	*адрамантаваць	починить	4
ведаеш	*ведаеш	знаешь	4
іслам	*іслам	ислам	4
кнопки	*кнопки	кнопки	4
вашыя	*вашыя	ваши	4
пісаць	*пісаць	писать	4
чытаеш	*чытаеш	читаешь	4
«	*званым	«	4
йӧра	*йӧ*ра	хорошо	4
замасціць	*замасціць	»	4
зранку	*зранку	утром	4
гэткай	*гэткай	этакой	4
»	*рэкламавалі	рекламировали	4
падабаюцца	*падабаюцца	нравятся	4
так	*лінсхотэне	так	4
замяняем	*замяняем	исландским	4
казаў	*казаў	говорил	4
доўга	*праснуўшыся	бабочка	4
еҥым	*еҥ*ым	человека	4
дэзарганізаваць	*дэзарганізаваць	силы	4
крынічным	*крынічным	исходными	4
рон	*рон	рон	4
сайце	*сайце	сайте	4
писе	*пи*се	его	4
хаця	*хаця	хотя	4
вольныя	*вольныя	свободные	4
эше	*эше	что	4
доўга	*праснуўшыся	чжуан-цзы	4
годы	*годы	годах	4
што	*крыўдаваў	,	4
многіх	*многіх	многих	4
ідэальны	*ідэальны	идеальный	4
плаваць	*плаваць	плавать	4
лонадана	*лонадана	лондона	4
любіў	*любіў	любил	4
»	*міхалова	»	4
«	*ало	алло	4
апавядаў	*апавядаў	рассказывал	4
лжывую	*лжывую	ложную	4
вандраваў	*вандраваў	путешествовал	4
чакала	*чакала	ждала	4
«	*купляйце	покупайте	4
блытаюць	*блытаюць	средства	4
зрабіць	*зрабіць	.	4
галаснейшы	*галаснейшы	громче	4
максымальным	*максымальным	максимальном	4
частуе	*частуе	строителей	4
ведалі	*ведалі	знали	4
садиктак	сади*ктак	всё	4
саромейся	*саромейся	стесняйся	4
доўга	*праснуўшыся	,	4
сніць	*сніць	он	4
»	*міхалова	«	4
прынясі	*прынясі	принеси	4
што	*наснілася	он	4
выкарыстоўваецца	*выкарыстоўваецца	используется	4
тудлан	*тудлан	наделила	4
ўмееш	*ўмееш	умеешь	4
леў	*леў	лев	4
ўзяў	*ўзяў	взял	4
сустрэў	*сустрэў	встретил	4
перакладаю	*перакладаю	перевожу	4
акна	*акна	окна	4
вывалілася	*вывалілася	вывалилась	4
характэрных	*характэрных	характерных	4
мюрыэл	*мюрыэл	мюриэл	4
здарылася	*здарылася	случилось	4
арганізаваць	*арганізаваць	устроить	4
сніць	*сніць	чжуан-цзы	4
сцвярджае	*сцвярджае	утверждает	4
стамляе	*стамляе	устал	4
ці	*чжуанцзы	кто	4
слухаць	*слухаць	слушать	4
знаходзіцца	*знаходзіцца	находится	4
ӱскырт	ӱ*скырт	упрямого	4
сэрвісаў	*сэрвісаў	сервисов	4
шукаў	*шукаў	искал	4
вырашыў	*вырашыў	решил	4
зрабіў	*зрабіў	сделал	4
ён	*ну	что	3
песьня	*песьня	песня	3
ідэалогія	*ідэалогія	идеология	3
фарсі	*фарсі	язык	3
давядзецца	*давядзецца	придется	3
задаваць	*задаваць	задавать	3
бізнэсмэн	*бізнэсмэн	бизнесмен	3
звуць	*звуць	зовут	3
вырашылі	*вырашылі	решили	3
дажджыстым	*дажджыстым	дождливым	3
,	*чжуанцзы	он	3
найяскравейшая	*найяскравейшая	наиярчайшая	3
твой	*твой	твоя	3
эўрабачаньня	*эўрабачаньня	евровидения	3
збалансованага	*збалансованага	сбалансированного	3
стала	*падтрымліваць	поддерживать	3
рыхтуе	*рыхтуе	готовит	3
каптурко	*каптурко	шапочко	3
размаўляе	*размаўляе	говорят	3
сӧрваленыт	*сӧ*рваленыт	упрашивали	3
адрэдагавала	*адрэдагавала	отредактировала	3
імперыялістамі	*імперыялістамі	империалистами	3
ушым	*ушым	острым	3
дацкі	*дацкі	флага	3
водзіць	*водзіць	водит	3
сайтаў	*сайтаў	сайтов	3
размаўляе	*размаўляе	разговаривает	3
хапае	*хапае	нет	3
пракампасціруйце	*пракампасціруйце	прокомпостируйте	3
разумею	*разумею	понимаю	3
вучыцца	*вучыцца	учится	3
раксалана	*раксалана	роксолана	3
прысніся	*прысніся	приснись	3
інфармацію	*інфармацію	ложную	3
вянуць	*вянуць	вянут	3
лётае	*лётае	летает	3
заспяваем	*заспяваем	споём	3
прасты	*прасты	простой	3
салоная	*салоная	солёная	3
.	*ўжываць	.	3
перасунь	*перасунь	передвинь	3
засыхалі	*засыхалі	засыхали	3
праяўляліся	*праяўляліся	проявлялись	3
дык	*дык	,	3
«	*ну	,	3
ізраіль	*ізраіль	израиль	3
адрэсу	*адрэсу	адрес	3
»	*папсавалі	вы	3
ляльку	*ляльку	куклу	3
бардэлі	*бардэлі	борделе	3
камп	*камп	компьютерные	3
што	*наснілася	которой	3
вырашаць	*вырашаць	решать	3
вывучаў	*вывучаў	изучал	3
дасцін	*дасцін	дастин	3
усталявалі	*усталявалі	тесный	3
фарамп	*фарамп	фарамп	3
московиц	*москови*ц	московиц	3
пярсідская	*пярсідская	персидский	3
прыводзіць	*прыводзіць	приводит	3
орэст	*орэст	орест	3
рамсэс	*рамсэс	рамсес	3
звяртае	*звяртае	обращает	3
патрык	*патрык	патрик	3
іра	*іра	ира	3
выставу	*выставу	выставку	3
ціма	*ціма	тима	3
невялічкая	*невялічкая	небольшая	3
сцерці	*сцерці	стёрт	3
марыць	*марыць	мечтает	3
фарсі	*фарсі	фарси	3
адзна	*адзна	-	3
карэньчыкі	*карэньчыкі	корешки	3
клясе	*клясе	классе	3
занепакоілася	*занепакоілася	встревожилась	3
дарэнда	*дарэнда	доренда	3
забыўся	*забыўся	забыл	3
браян	*браян	брайан	3
чак-чак	*чак-*чак	чак-чак	3
смяяліся	*смяяліся	смеялись	3
пафарбаваць	*пафарбаваць	покрасить	3
юэбін	*юэбін	юэбин	3
i	*павi*нны	и	3
дацкай	*дацкай	датский	3
маша	*маша	маша	3
прасцейшая	*прасцейшая	проще	3
здраджваў	*здраджваў	предавал	3
парламентская	*парламентская	парламентская	3
абажае	*абажае	обожает	3
ісландскім	*ісландскім	,	3
выйгралі	*выйгралі	выиграли	3
злезлі	*злезлі	слезли	3
чыла	*чыла	равно	3
бегаць	*бегаць	бегать	3
нюнорска	*нюнорска	основывается	3
адчуваў	*адчуваў	чувствовал	3
індустрыялізацыя	*індустрыялізацыя	индустриализация	3
пярсідская	*пярсідская	язык	3
чытаць	*чытаць	читать	3
пашанцавала	*пашанцавала	посчастливилось	3
сарваныя	*сарваныя	сорванные	3
часам	*афарыст	бабочка	3
на	*казахскай	на	3
абмеркаваць	*абмеркаваць	обсудить	3
тэт-а-тэт	*тэт-а-*тэт	тет-а-тет	3
роўтэр	*роўтэр	роутер	3
прайшло	*прайшло	прошёл	3
разбіраецца	*разбіраецца	разбирается	3
,	*чжуанцзы	снится	3
мяняецца	*мяняецца	меняется	3
існуе	*існуе	ли	3
спазнаеш	*спазнаеш	познаешь	3
нефертары	*нефертары	нефертари	3
лжывую	*лжывую	на	3
ён	*наснілася	снилось	3
сніць	*сніць	которой	3
метро	*грушаўка	»	3
навелы	*навелы	новеллы	3
адрозніваецца	*адрозніваецца	отличается	3
піклз	*піклз	пиклз	3
вылез	*вылез	вылез	3
казахскай	*казахскай	казахском	3
паслясмак	*паслясмак	послевкусие	3
інтэрнэце	*інтэрнэце	интернете	3
спрошчвае	*спрошчвае	упрощает	3
выкарыстоўваючы	*выкарыстоўваючы	используя	3
абяцала	*абяцала	ей	3
люсе	*люсе	люсе	3
соцрэалістычныя	*соцрэалістычныя	соцреалистические	3
станавілася	*станавілася	.	3
:	*славацкай	,	3
пятроўшчына	*пятроўшчына	«	3
заплятала	*заплятала	заплетала	3
размяшчаючы	*размяшчаючы	размещая	3
пабачымся	*пабачымся	увидимся	3
ўдзячны	*ўдзячны	благодарен	3
еў	*еў	дракон	3
канкурэнтаздатнасці	*канкурэнтаздатнасці	конкурентоспособности	3
азначалі	*азначалі	означали	3
без	*клавы	без	3
срэбны	*срэбны	серебряную	3
іерогліфа	*іерогліфа	иероглифа	3
львоў	*львоў	львове	3
няўжо	*няўжо	неужели	3
павінну	*павінну	должны	3
чытаючы	*чытаючы	читая	3
зносін	*зносін	,	3
патэлефанаваць	*патэлефанаваць	позвонить	3
найяскравейшая	*найяскравейшая	самая	3
дэзарганізаваць	*дэзарганізаваць	и	3
рэакцыю	*рэакцыю	реакцию	3
шэі	*шэі	шеи	3
зроблены	*зроблены	сделан	3
ведаюць	*ведаюць	знают	3
што	*наснілася	бабочка	3
сварыць	*сварыць	ругает	3
пятроўшчына	*пятроўшчына	»	3
вывучае	*вывучае	изучает	3
’	*яўляліся	звёздочки	3
расказаць	*расказаць	рассказать	3
што	*пабачыўшы	что	3
рок	*рок	рок	3
зайздросціла	*зайздросціла	завидовала	3
вэбмайстры	*вэбмайстры	вебмастеры	3
асноўваецца	*асноўваецца	основывается	3
любое	*любое	любое	3
хапае	*хапае	недостаточно	3
ці	*чжуанцзы	которому	3
дантэ	*дантэ	данте	3
доўга	*праснуўшыся	что	3
спорта	*спорта	спорта	3
хадзем	*хадзем	что	3
,	*пагадзяцца	,	3
запрошваць	*запрошваць	приглашать	3
купляць	*купляць	покупать	3
ці	*чжуанцзы	которой	3
любляць	*любляць	любят	3
цёмны	*цёмны	тёмную	3
нарадзіўся	*нарадзіўся	родился	3
падараваў	*падараваў	подарил	3
тваю	*тваю	твой	3
пачынаецца	*пачынаецца	начинается	3
чжуанцзы	*чжуанцзы	чжуан-цзы	3
жадаю	*жадаю	желаю	3
вокны	*вокны	окна	3
суседзі	*казалі	с	3
прадбачыць	*прадбачыць	предсказать	3
пераходзь	*пераходзь	переходи	3
ён	*наснілася	что	3
бывай	*бывай	пока	3
вучыў	*вучыў	учил	3
збіраюся	*збіраюся	собираюсь	3
ненавідзела	*ненавідзела	ненавидела	3
ідэалогія	*ідэалогія	нюнорска	3
прэзыдэнт	*прэзыдэнт	президент	3
купіць	*купіць	купить	3
лі	*лі	ли	3
штаны	*штаны	штаны	3
сніць	*сніць	же	3
дазваляе	*выбраць	выбрать	3
джэка	*джэка	джеком	3
завецца	*завецца	шелковницей	3
удзельнічаў	*удзельнічаў	участвовал	3
жырафаў	*жырафаў	жирафов	3
дык	*наце	,	2
што	*наснілася	чжуан-цзы	2
гольф	*гольф	гольф	2
сядайце	*сядайце	садитесь	2
раблю	*раблю	делаю	2
пашанцавала	*пашанцавала	повезло	2
адказвае	*адказвае	телефону	2
прадаюцца	*прадаюцца	продаются	2
прытворымся	*прытворымся	притворимся	2
спрабаваў	*спрабаваў	пытался	2
маеце	*маеце	имеете	2
зусім	*паміраць	совершенно	2
дык	*наце	мы	2
пачытаць	*пачытаць	почитать	2
хуйні	*хуйні	хуйни	2
спіць	*спіць	спит	2
імперыялісты	*імперыялісты	,	2
піша	*піша	пишет	2
ён	*наснілася	афорист	2
ўзнікла	*ўзнікла	возникла	2
товада	*товада	товада	2
завецца	*завецца	называется	2
горкая	*горкая	горький	2
частуе	*частуе	отпраздновать	2
квінтэсенцыя	*квінтэсенцыя	квинтэссенция	2
насіць	*насіць	носить	2
эстонскай	*эстонскай	эстонском	2
шахматы	*шахматы	шахматы	2
прысніў	*прысніў	,	2
дзверы	*дзверы	дверь	2
абажаю	*абажаю	обожаю	2
някляева	*някляева	некляева	2
дзякуй	*дзякуй	слава	2
састарэлых	*састарэлых	пожилых	2
давядзецца	*іначай	придётся	2
здарылася	*здарылася	стало	2
арктыцы	*арктыцы	арктике	2
сакрэт	*сакрэт	тайну	2
ён	*наснілася	бабочка	2
пан	*тадэвуш	тадеуш	2
прысніў	*прысніў	он	2
функцыянальнасцю	*функцыянальнасцю	функциональностью	2
серыйная	*серыйная	серийная	2
ці	*піша	долго	2
тараторыць	*тараторыць	,	2
імкнучыся	*імкнучыся	раздробить	2
заматай	*заматай	замотай	2
нарадзілася	*нарадзілася	родилась	2
мусім	*мусім	должны	2
чытаў	*чытаў	читал	2
лічыць	*лічыць	,	2
ўвогуле	*ўвогуле	вообще	2
крыўдуеш	*крыўдуеш	недоволен	2
саромеецца	*саромеецца	стесняется	2
вучышся	*вучышся	.	2
пятнаццаць	*пятнаццаць	пятнадцать	2
тучы	*тучы	тучи	2
паясніў	*паясніў	объяснил	2
сустракаюцца	*сустракаюцца	чаще	2
пачаставаць	*пачаставаць	,	2
паглядзеў	*паглядзеў	посмотрел	2
высахлі	*высахлі	высохли	2
што	*наснілася	она	2
,	*чжуанцзы	который	2
пачаставаць	*пачаставаць	ставят	2
так	*лінсхотэне	нет	2
прапусціце	*прапусціце	пропустите	2
еш	*еш	ещё	2
прашчаецца	*прашчаецца	прощается	2
рабіў	*рабіў	делал	2
інапланецяне	*інапланецяне	инопланетяне	2
сніць	*сніць	бабочка	2
—	*здаёмыя	—	2
шчыра	*малюе	,	2
агурбаш	*агурбаш	агурбаш	2
марыў	*марыў	мечтал	2
меў	*меў	была	2
выкрадаюць	*выкрадаюць	похищают	2
,	*чанг	,	2
народ	*абраны	избранный	2
наліваю	*наліваю	наливаю	2
.	*наступстваў	или	2
размаўляю	*размаўляю	говорю	2
дапамогай	*спаму	спама	2
кахаю	*кахаю	люблю	2
адвучыўся	*адвучыўся	отучился	2
ускладае	*ускладае	возлагает	2
павiнны	*ставi*цца	в	2
хапіла	*хапіла	хватило	2
чакаў	*чакаў	ждал	2
тут	*ляплю	леплю	2
алан	*алан	алан	2
бо	*прамакутная	форма	2
натхнення	*ісландскую	использовали	2
еўра	*еўра	евро	2
заблукаеш	*заблукаеш	заблудишься	2
натхніць	*натхніць	на	2
анімэ	*анімэ	аниме	2
выкалі	*выкалі	выколи	2
заклей	*заклей	заклей	2
хадановіч	*хадановіч	хаданович	2
набліжаліся	*набліжаліся	близилось	2
прыводзіць	*прыводзіць	,	2
казахскай	*казахскай	в	2
,	*чжуанцзы	которой	2
доўга	*праснуўшыся	снилось	2
зрабіла	*зрабіла	сделала	2
.	*наступстваў	.	2
суматра	*суматра	суматра	2
паміраць	*давядзецца	умирать	2
пацалаваў	*пацалаваў	поцеловал	2
ютарныя	*ютарныя	вдохновить	2
давялося	*давялося	пришлось	2
падобнае	*падобнае	похожее	2
:	*славацкай	чужом	2
стуліў	*стуліў	сомкнул	2
цямнее	*цямнее	темнеет	2
ці	*чжуанцзы	бабочка	2
думаюць	*думаюць	думают	2
адзна	*адзна	из	2
звяртае	*звяртае	внимание	2
іграць	*іграць	играть	2
лічыць	*лічыць	считает	2
гэта	*адсвяткаваць	флаг	2
салмана	*салмана	рушди	2
патчам	*патчам	для	2
праносіць	*праносіць	проносить	2
ведаў	*ведаў	знал	2
праблемаў	*праблемаў	проблем	2
ліпнуць	*ліпнуць	липнут	2
расчыняецца	*расчыняецца	растворяется	2
несмачная	*несмачная	невкусный	2
сымпатычных	*сымпатычных	для	2
што	*зрабіць	.	2
хочацца	*хочацца	хочется	2
метро	*грушаўка	метро	2
выкрадалі	*выкрадалі	похищали	2
іен	*іен	иен	2
ютарныя	*ютарныя	нас	2
салмана	*рушдзі	—	2
здымаем	*здымаем	снимаем	2
занепакоілася	*занепакоілася	:	2
расеі	*расеі	россии	2
джэк	*джэк	джек	2
—	*здаёмыя	,	2
—	*здаёмыя	словенском	2
акторам	*акторам	актером	2
што	*наснілася	тоже	2
—	*скажа	—	2
пераўсталёўваць	*пераўсталёўваць	переустанавливать	2
ўсталяваў	*ўсталяваў	установил	2
прыдумваў	*прыдумваў	придумывал	2
талончык	*талончык	талончик	2
ведаеш	*ведаеш	это	2
маеце	*маеце	вас	2
дадаваць	*дадаваць	добавлять	2
коткі	*коткі	кошки	2
яны	*спяць	они	2
загарэлася	*загарэлася	загорелась	2
іншапланецяне	*іншапланецяне	инопланетяне	2
дзверы	*дзверы	двери	2
паліць	*паліць	курить	2
салмана	*салмана	салмана	2
маляваць	*маляваць	рисовать	2
«	*ну	«	2
балела	*балела	болело	2
паглядзіце	*паглядзіце	посмотрите	2
калі	*лічыць	что	2
что	*что	что	2
мандарыны	*мандарыны	мандарины	2
йен	*йен	иен	2
ібрагім	*ібрагім	ибрагим	2
мілер	*мілер	миллер	2
«	*яндекс	яндекс	2
пуэн	*пуэн	умом	2
шыпоў	*шыпоў	шипов	2
гучней	*гучней	громче	2
львове	*львове	львове	2
’	*сказала	сказала	2
адхілілася	*адхілілася	увидев	2
патрэбныя	*патрэбныя	нужны	2
бачыш	*бачыш	видишь	2
выпей	*выпей	выпей	2
безнадзейныя	*безнадзейныя	безнадёжны	2
еўрабачанне	*еўрабачанне	2011	2
траціў	*траціў	тратил	2
салмана	*салмана	»	2
з	*засноўнікаў	из	2
твае	*твае	твои	2
,	*македонскай	:	2
таксама	*чжуанцзы	,	2
пстрыкніце	*пстрыкніце	щёлкните	2
есць	*есць	ест	2
,	*чжуанцзы	пишет	2
раскіданыя	*раскіданыя	разбросаны	2
«	*замасціць	»	2
нямае	*нямае	нет	2
частуе	*частуе	флаг	2
чуеш	*чуеш	слышишь	2
цікавіць	*цікавіць	интересует	2
шчыра	*малюе	искренне	2
люсі	*люсі	люси	2
цёмныя	*цёмныя	тёмные	2
пакажы	*пакажы	покажи	2
валодае	*валодае	обладает	2
карысней	*карысней	полезнее	2
ісціная	*ісціная	истинная	2
ці	*піша	иногда	2
называецца	*называецца	называется	2
акна	*акна	окно	2
i	*павi*нны	поступать	2
ці	*піша	которой	2
ставіцца	*ставіцца	ставится	2
гэй	*гэй	эй	2
гавары	*гавары	говори	2
працоўнага	*працоўнага	рабочего	2
улучыць	*улучыць	чтобы	2
кашгары	*кашгары	кашгаре	2
думкаай	*думкаай	,	2
дык	*дык	что	2
называлі	*называлі	называли	2
хапае	*хапае	хватает	2
туман	*туман	туман	2
і	*раздрабіць	раздробить	2
:	*славацкай	языке	2
прашчае	*прашчае	прощает	2
гаварыў	*гаварыў	говорил	2
забівае	*забівае	убивает	2
перапісваючы	*перапісваючы	переписывая	2
тваю	*тваю	твою	2
ўнадзілася	*ўнадзілася	повадилась	2
дакраніся	*дакраніся	дотронься	2
сустрэла	*сустрэла	встретила	2
ён	*наснілася	не	2
існуе	*існуе	существует	2
,	*чжуанцзы	кто	2
пабудаваны	*пабудаваны	построен	2
асноўваецца	*асноўваецца	на	2
спакушае	*спакушае	совращает	2
разлічваць	*разлічваць	рассчитывать	2
звяжуся	*звяжуся	свяжусь	2
тэрэза	*тэрэза	тереза	2
губка	*губка	губка	2
высланае	*высланае	намерениями	2
лукашэнка	*лукашэнка	лукашенко	2
душэ	*душэ	душе	2
таксама	*чжуанцзы	тоже	2
дурыце	*дурыце	дурите	2
свойго	*свойго	своей	2
фэйсбуцы	*фэйсбуцы	фейсбуке	2
імперыялісты	*імперыялісты	империалисты	2
лазанью	*лазанью	лазанью	2
адляцелі	*адляцелі	улетели	2
грэю	*грэю	грею	2
кажуць	*кажуць	говорят	2
супадае	*супадае	совпадает	2
,	*чжуанцзы	она	2
чакаў	*чакаў	ожидал	2
сніць	*сніць	что	2
патрэбная	*патрэбная	нужна	2
салмана	*рушдзі	рушди	2
салмана	*рушдзі	салмана	2
інапланецянамі	*інапланецянамі	инопланетянами	2
адшукаем	*адшукаем	разыщем	2
гуляем	*гуляем	играем	2
памыць	*памыць	помыть	2
i	*павi*нны	отношении	2
патрэбны	*патрэбны	нужен	2
балатавацца	*балатавацца	баллотироваться	2
ўчасна	*ўчасна	вовремя	2
змірыцца	*змірыцца	смириться	2
,	*чжуанцзы	иногда	2
высушу	*высушу	высушу	2
нла	*нла	нло	2
,	*чжуанцзы	приснилось	2
зроблена	*зроблена	сделано	2
накрытая	*накрытая	укрыта	2
набліжаліся	*набліжаліся	приближалось	2
разнознівае	*разнознівае	различает	2
нараджаюцца	*нараджаюцца	свободными	2
ці	*піша	кто	2
нюнорска	*нюнорска	поскольку	2
наняты	*наняты	сивый	2
твая	*твая	твоё	2
здымалі	*здымалі	снимали	2
опцыя	*опцыя	опция	2
ён	*наснілася	которой	2
чапай	*чапай	трогай	2
метро	*грушаўка	«	2
куй	*куй	куй	2
схавалася	*схавалася	спряталось	2
борам	*борам	бором	2
таму	*заразіў	заразил	2
павiнны	*ставi*цца	друг	2
ставіцца	*ставіцца	флаг	2
слухаў	*слухаў	слушал	2
,	*македонскай	словацком	2
что	*что	потому	2
складаюць	*складаюць	составляют	2
ўмее	*ўмее	умеет	2
насіць	*насіць	стал	2
актуальная	*актуальная	практичен	2
’	*сказала	прогноза	2
ці	*чжуанцзы	он	2
ведаеце	*ведаеце	знаете	2
і	*абычаі	и	2
зарубі	*зарубі	заруби	2
маршалізаваных	*маршалізаваных	маршаллизованных	2
сайту	*сайту	сайта	2
пандарку	*пандарку	пандарк	2
ствараеце	*ствараеце	создаёте	2
сато	*сато	сато	2
ізалентай	*ізалентай	изолентой	2
гуляў	*гуляў	играл	2
адлюстроўваўся	*адлюстроўваўся	отражалась	2
львоўскіх	*львоўскіх	львовских	2
моваў	*моваў	в	2
штосьці	*штосьці	,	2
сандра	*сандра	сандра	2
дацкай	*дацкай	датским	2
ззяюць	*ззяюць	сияют	2
ён	*наснілася	он	2
чакае	*чакае	ждет	2
пройдзе	*пройдзе	пройдёт	2
што	*наснілася	что	2
некурцоў	*некурцоў	некурящих	2
іўрыце	*іўрыце	иврите	2
чжуанцзы	*чжуанцзы	,	2
—	*о	,	2
пабачыць	*пабачыць	увидеть	2
еў	*еў	ел	2
педафілы	*педафілы	педофилы	2
сустрэць	*сустрэць	встретить	2
наймацнейшая	*наймацнейшая	,	2
сурокі	*сурокі	порчу	2
праплывалі	*праплывалі	проплывали	2
адчыняй	*адчыняй	открывай	2
давялося	*давялося	собрать	2
працоўныя	*працоўныя	рабочие	2
прыдзе	*прыдзе	придёт	2
бэна	*бэна	бена	2
даводзілі	*даводзілі	доказывали	2
страляючы	*страляючы	стреляя	2
прыносяць	*прыносяць	приносят	2
думае	*думае	,	2
зарабляю	*зарабляю	зарабатываю	2
збольшваецца	*збольшваецца	увеличивается	2
паважаюць	*паважаюць	уважают	2
зарабляў	*зарабляў	зарабатывал	2
стае	*стае	становится	2
для	*выкарыстоўвалі	языка	2
загойваюцца	*загойваюцца	заживают	2
косы	*косы	косы	2
,	*славенскай	македонском	2
ало	*ало	алло	2
чакаючы	*чакаючы	дожидаясь	2
ён	*наснілася	иногда	2
ровар	*ровар	велосипед	2
пробуй	*пробуй	пробуй	2
здрадзіў	*здрадзіў	меня	2
крыўдуеш	*крыўдуеш	.	2
—	*скажа	тебе	2
адчуў	*адчуў	чувствовал	2
на	*казахскай	выходит	2
падабацца	*падабацца	нравится	2
кашалёк	*згубi*ла	кошелёк	2
ніхто	*насамрэч	деле	2
нюнорска	*нюнорска	для	2
.	*досвед	.	2
акно	*акно	окно	2
мандалай	*мандалай	мандалай	2
:	*славацкай	словацком	2
вольны	*вольны	свободное	2
адмаўляць	*адмаўляць	отрицать	2
памыляецца	*памыляецца	ошибается	2
еш	*еш	этих	2
сэзон	*сэзон	сезон	2
пагадзяцца	*пагадзяцца	согласятся	2
абама	*абама	обама	2
купляйце	*купляйце	покупайте	2
імкнучыся	*імкнучыся	стремясь	2
срэбнымі	*срэбнымі	серебряными	2
доўга	*праснуўшыся	не	2
прыпыніце	*прыпыніце	прекратите	2
ганаруся	*ганаруся	горжусь	2
шчыра	*малюе	рисует	2
ці	*чжуанцзы	я	2
колю	*колю	колю	2
правым	*правым	правым	2
закохвалася	*закохвалася	влюблялась	2
падабацца	*падабацца	стало	2
чакайце	*чакайце	ждите	2
прагноза	*прагноза	прогноза	2
бізнэсмэн	*бізнэсмэн	еврейский	2
страляйце	*страляйце	стреляйте	2
іўрыт	*іўрыт	иврит	2
вучацца	*вучацца	учатся	2
львоўскі	*львоўскі	львовский	2
чжуанцзы	*чжуанцзы	он	2
сайтаў	*сайтаў	сайтам	2
снедае	*снедае	завтракает	2
усталявалі	*усталявалі	установили	2
трасці	*трасці	трясти	2
тваёй	*тваёй	твоей	2
дык	*наце	и	1
згубіў	*згубіў	потерял	1
адказвае	*адказвае	слова	1
барысаўдрэва	*барысаўдрэва	борисовдрева	1
вырашыць	*вырашыць	эту	1
згубіўшы	*згубіўшы	потеряв	1
нюнорска	*нюнорска	прямоугольна	1
што	*пабачыўшы	увидев	1
ці	*піша	или	1
педафілы	*педафілы	все	1
ўношу	*ўношу	вношу	1
ён	*ну	он	1
дакранулася	*дакранулася	и	1
бачыў	*бачыў	не	1
пералічаныя	*пералічаныя	,	1
«	*дзякуй	''	1
што	*крыўдаваў	продалось	1
паглядзі	*паглядзі	посмотри	1
рэлігіёзны	*рэлігіёзны	религиозный	1
півам	*чарапічным	угостить	1
максымальным	*максымальным	основывается	1
дык	*наце	вы	1
«	*замасціць	позволяет	1
ці	*чжуанцзы	снилось	1
імкнучыся	*імкнучыся	вооружение	1
азначалі	*азначалі	дух	1
і	*абычаі	искренне	1
часам	*афарыст	иногда	1
ён	*ну	,	1
пераскаквае	*пераскаквае	перепрыгивает	1
пакажыце	*пакажыце	пожалуйста	1
імкнучыся	*імкнучыся	демократии	1
выбраць	*выбраць	выбрать	1
расказала	*расказала	рассказала	1
анімэ	*анімэ	,	1
улоўліваць	*улоўліваць	в	1
мушу	*мушу	решить	1
падабаўляць	*падабаўляць	подобавлять	1
таксама	*чжуанцзы	иногда	1
фэйсбуцы	*фэйсбуцы	?	1
раксалана	*раксалана	встревожилась	1
часам	*афарыст	или	1
блытаюць	*блытаюць	ослабевают	1
злітуйцеся	*злітуйцеся	работали	1
ставiцца	*адзi*н	друга	1
купіць	*купіць	новый	1
,	*адмаўляецца	ставят	1
пачаставаць	*пачаставаць	что	1
што	*наснілася	или	1
пачаставаць	*пачаставаць	это	1
дазваляе	*выбраць	режим	1
дык	*дык	.	1
зефір	*зефір	тебе	1
маеце	*маеце	хочется	1
баюся	*баюся	боюсь	1
ставiцца	*адзi*н	.	1
што	*наснілася	снится	1
замасціць	*замасціць	авторазмер	1
ведаеце	*ведаеце	нас	1
падлі…	*падлі…	подлей…	1
давядзецца	*іначай	умирать	1
кракаў	*кракаў	краков	1
зайздросціць	*зайздросціць	завидует	1
не	*ўмее	их	1
аж	*аж	в	1
актор	*актор	актер	1
павiнны	*ставi*цца	правах	1
перасякліся	*перасякліся	не	1
прапіў	*прапіў	пропил	1
ідэальны	*ідэальны	цвет	1
.	*нязгодных	,	1
суседзі	*казалі	такой	1
алаха	*алаха	аллаха	1
зарадзілася	*зарадзілася	зародилась	1
бегае	*бегае	бегает	1
садиктак	сади*ктак	,	1
галандскай	*галандскай	голландского	1
звальняцца	*звальняцца	увольняться	1
таксама	*чжуанцзы	он	1
частуе	*частуе	к	1
ісландскім	*ісландскім	...	1
ён	*наснілася	которому	1
купіце	*купіце	купите	1
чытаю	*чытаю	читаю	1
метро	*грушаўка	грушевка	1
ідэалогія	*ідэалогія	на	1
змяняе	*змяняе	меняет	1
,	*чжуанцзы	которому	1
сустракаю	*сустракаю	встречаю	1
аватары	*аватары	аватаре	1
ці	*піша	снится	1
меў	*меў	меня	1
сніць	*сніць	снилось	1
пагаварыць	*пагаварыць	поговорить	1
гаворыць	*гаворыць	говорящий	1
бачыла	*бачыла	видела	1
снедаў	*снедаў	завтракал	1
натхніць	*натхніць	нас	1
,	*адмаўляецца	флаг	1
што	*наснілася	мог	1
сайтам	*сайтам	сайтом	1
народ	*абраны	к	1
дагэтуль	*дагэтуль	и	1
так	*лінсхотэне	в	1
свеціць	*свеціць	,	1
інфекцыя	*інфекцыя	инфекция	1
баіцца	*баіцца	идти	1
натхніць	*натхніць	создание	1
запрапануй	*запрапануй	предложи	1
ўдвох	*ўдвох	вдвоём	1
змніць	*змніць	единицы	1
і	*абычаі	ясно	1
,	*адмаўляецца	работников	1
бо	*прамакутная	.	1
вучуся	*вучуся	занимаюсь	1
«	*званым	называемым	1
нептуна	*нептуна	провести	1
аж	*аж	и	1
усталявалі	*усталявалі	гнилые	1
дакранулася	*дакранулася	дотронулось	1
»	*рэкламавалі	с	1
жоднага	*жоднага	ни	1
так	*лінсхотэне	молочник	1
вучыцца	*вучыцца	учиться	1
нептуна	*нептуна	нептуна	1
півам	*чарапічным	»	1
ставiцца	*адзi*н	отношении	1
,	*славенскай	словацком	1
чацьвёртую	*чацьвёртую	четвертую	1
толькі	*свеціць	солнце	1
суседзі	*казалі	вот	1
ідэалогія	*ідэалогія	расхождении	1
лічыць	*лічыць	не	1
працаваць	*працаваць	разговаривать	1
кенам	*кенам	кен	1
ставiцца	*адзi*н	и	1
жывёш	*жывёш	живёшь	1
пазнаў	*пазнаў	познал	1
сумую	*сумую	скучаю	1
прыносіць	*прыносіць	не	1
,	*чанг	чанг	1
пан	*тадэвуш	панов	1
ніводнага	*ніводнага	одного	1
часам	*афарыст	что	1
праспрагаць	*праспрагаць	проспрягать	1
турбуй	*турбуй	беспокой	1
прысніў	*прысніў	бабочка	1
яны	*спяць	вместе	1
дапамогай	*спаму	помощью	1
адрэж	*адрэж	отрежь	1
ён	*наснілася	который	1
маюцьодну	*маюцьодну	имеют	1
гаворыць	*гаворыць	уже	1
так	*лінсхотэне	теперь	1
»	*папсавалі	то	1
саэб	*саэб	саэб	1
ўстанавілі	*ўстанавілі	установили	1
«	*дзякуй	!	1
пазыч	*пазыч	пожалуйста	1
ставiцца	*адзi*н	наделены	1
твайго	*твайго	твоего	1
,	*славенскай	словенском	1
плаваюць	*плаваюць	плавают	1
’	*яўляецца	первым	1
рамашку	*рамашку	ромашку	1
распаўсюджвайце	*распаўсюджвайце	распространяйте	1
суседзі	*казалі	школы	1
маеш	*маеш	тебя	1
выкарыстоўваемая	*выкарыстоўваемая	всего	1
шчыра	*малюе	ясно	1
ўдалося	*ўдалося	вышло	1
для	*выкарыстоўвалі	...	1
цэліцеся	*цэліцеся	целитесь	1
мусіць	*мусіць	собрание	1
можа	*зрабіць	что	1
тэлефануйце	*тэлефануйце	,	1
хадзем	*хадзем	играть	1
паміраць	*давядзецца	совершенно	1
адлюстроўвае	*адлюстроўвае	отражает	1
алаха	*алаха	кроме	1
можа	*зрабіць	сделать	1
пафарбаваць	*пафарбаваць	бы	1
ці	*піша	чжуан-цзы	1
—	*о	много	1
гэта	*адсвяткаваць	.	1
прамільгнула	*прамільгнула	будущее	1
частуе	*частуе	так	1
нават	*разумееш	понимаешь	1
усталявалі	*усталявалі	но	1
i	*павi*нны	правах	1
купляючы	*купляючы	покупая	1
жадаў	*жадаў	бы	1
тужыць	*тужыць	роптать	1
адрамантуй	*адрамантуй	почини	1
напаўняла	*напаўняла	наполняло	1
ездзе	*адзначана	что	1
жоднага	*жоднага	одного	1
часам	*афарыст	афорист	1
павінну	*павінну	купить	1
застаўляе	*застаўляе	заставляет	1
тэхас	*тэхас	техас	1
брусэль	*брусэль	брюссель	1
ці	*піша	бабочка	1
«	*купляйце	«	1
,	*зярно	это	1
прыносіць	*прыносіць	приносит	1
прысягнуў	*прысягнуў	поклялся	1
дазваляе	*дазваляе	»	1
сніць	*сніць	не	1
бо	*прамакутная	прямоугольна	1
тыгай	*тыгай	такой	1
доўга	*праснуўшыся	который	1
суседзі	*казалі	не	1
ці	*чжуанцзы	—	1
падманулі	*падманулі	обманули	1
шнобелеўскую	*шнобелеўскую	шнобелевскую	1
павяртайся	*павяртайся	поскорее	1
замасціць	*замасціць	варианта	1
размаўляе	*размаўляе	говорит	1
маюцьодну	*маюцьодну	четвертую	1
доўга	*праснуўшыся	словно	1
яго	*ведалі	—	1
адгуджана	*адгуджана	миновать	1
іх	*бачыць	видеть	1
даведацца	*даведацца	узнать	1
дацкі	*дацкі	датский	1
частуе	*частуе	дома	1
львоўскай	*львоўскай	львовской	1
часам	*афарыст	с	1
:	*славацкай	)	1
сталых	*сталых	зрелых	1
знявага	*знявага	"нас	1
размаўляе	*размаўляе	по-английски	1
жадаеце	*жадаеце	хотите	1
пан	*тадэвуш	»	1
ніводнага	*ніводнага	!	1
пятроўшчына	*пятроўшчына	на	1
дагэтуль	*дагэтуль	всё	1
дацкі	*дацкі	,	1
,	*дзякуй	спасибо	1
бо	*прамакутная	не	1
суседзі	*казалі	а	1
вучыцца	*вучыцца	в	1
дык	*дык	только	1
сніць	*сніць	тоже	1
знае	*знае	знает	1
таксама	*чжуанцзы	снилось	1
.	*нязгодных	банят	1
мёртвы	*мёртвы	мёртв	1
жарэ	*жарэ	жрёт	1
найшепшая	*найшепшая	наилучший	1
для	*выкарыстоўвалі	для	1
доўга	*праснуўшыся	он	1
ці	*піша	он	1
гатуеце	*гатуеце	готовите	1
натхнення	*ісландскую	для	1
хуана	*хуана	хуана	1
замасціць	*замасціць	,	1
,	*македонскай	языке	1
что	*что	большинства	1
ці	*чжуанцзы	тоже	1
любіць	*любіць	нравится	1
прамільгнула	*прамільгнула	промелькнуло	1
анімэ	*анімэ	нравится	1
сумуем	*сумуем	скучаем	1
выйграць	*выйграць	выиграть	1
есці	*есці	завтрак	1
вучуся	*вучуся	учусь	1
пракампасціруйце	*пракампасціруйце	многоразового	1
цвятаева	*цвятаева	цветаева	1
двузначная	*двузначная	двойственная	1
тараторыць	*тараторыць	тараторит	1
яны	*спяць	"они	1
забывай	*забывай	забывай	1
параўнайце	*параўнайце	сравните	1
цэліцеся	*цэліцеся		1
бязглузьдзіцы	*бязглузьдзіцы	.	1
знявага	*знявага	нас	1
па	*засудзяць	осудят	1
зусім	*паміраць	безграмотным	1
штосьці	*штосьці	что-то	1
маеце	*маеце	друзей	1
чацьвёртую	*чацьвёртую	,	1
французкай	*французкай	французском	1
мусіць	*мусіць	должен	1
навязаць	*навязаць	о	1
унь	*унь	,	1
ідэалогія	*ідэалогія	для	1
дэзарганізаваць	*дэзарганізаваць	дезорганизовать	1
доўга	*праснуўшыся	с	1
прыамур	*прыамур	,	1
расії	*расії	россии	1
таксама	*чжуанцзы	она	1
гаворыць	*гаворыць	говорит	1
адпавядае	*адпавядае	соответствует	1
пазычыць	*пазычыць	одолжить	1
немагчымы	*немагчымы	невозможен	1
максымальным	*максымальным	вдохновения	1
«	*ведаю	знаю	1
бо	*прамакутная	флага	1
суседзі	*казалі	вы	1
прыгатаваннем	*прыгатаваннем	пищи	1
ведаю	*ведаю	всё	1
маюцьодну	*маюцьодну	американцев	1
болей	*болей	заблудишься	1
чалавеканенавісных	*чалавеканенавісных	смысл	1
выбрукавана	*выбрукавана	благими	1
праспрагаць	*праспрагаць	могут	1
дырку	*дырку	дырку	1
заняволіць	*заняволіць	поработить	1
найпрыгажэйшыя	*найпрыгажэйшыя	в	1
’	*яўляюць	остановки	1
максымальным	*максымальным	расхождении	1
гаварыць	*гаварыць	говорить	1
,	*дзякуй	,	1
ідэалогія	*ідэалогія	.	1
(	*здавалася	казалось	1
што	*зрабіць	сделать	1
чыла	*чыла	всё	1
неправы	*неправы	неправ	1
гуляць	*гуляць	в	1
дазваляе	*выбраць	позволяет	1
адказвае	*адказвае	отвечает	1
фаната	*фаната	фаната	1
півам	*чарапічным	,	1
часам	*афарыст	пишет	1
дэзарганізаваць	*дэзарганізаваць	,	1
зрабіць	*зрабіць	если	1
ем	*ем	ем	1
мыю	*мыю	стираю	1
часам	*афарыст	—	1
казалі	*казалі	говорили	1
будзеш	*вучыцца	учиться	1
найдаўжэйшае	*найдаўжэйшае	самое	1
працоўныя	*працоўныя	,	1
рабі	*рабі	свое	1
дагэтуль	*дагэтуль	сих	1
спакушаюць	*спакушаюць	малолетних	1
перо	*перо	перро	1
ажаніцца	*ажаніцца	.	1
звяртайцеся	*звяртайцеся	обращайтесь	1
кахаю	*кахаю	вас	1
максымальным	*максымальным	с	1
прыводзіць	*прыводзіць	у	1
мушу	*мушу	найти	1
,	*чжуанцзы	долго	1
асноўваецца	*асноўваецца	.	1
давяраю	*давяраю	доверяю	1
бойся	*бойся	бойся	1
збіраць	*збіраць	грибы	1
талончык	*талончык	взял	1
,	*дзякуй	от	1
людзi	*людзi	равными	1
»	*рэкламавалі	»	1
пачаставаць	*пачаставаць	»	1
памятаеце	*памятаеце	помните	1
суджана	*суджана	быть	1
і	*абычаі	теперь	1
каўтае	*каўтае	глотает	1
патчам	*патчам	патчем	1
пагуляць	*пагуляць	поиграть	1
крыўдуеш	*крыўдуеш	сражении	1
размаўляю	*размаўляю	разговариваю	1
мёртвы	*мёртвы	мёртвая	1
уш	*уш	не	1
пан	*тадэвуш	,	1
запрашаем	*запрашаем	приглашаем	1
дацкай	*дацкай	не	1
весці	*весці	вести	1
,	*чжуанцзы	—	1
можа	*зрабіць	хуже	1
цэнтаўра	*цэнтаўра	центавра	1
паглядзела	*паглядзела	посмотрела	1
карпаты	*карпаты	карпаты	1
адказвае	*адказвае	сотрудник	1
падабаецца	*падабаецца	мне	1
доўга	*праснуўшыся	приснилось	1
прыстасаваных	*прыстасаваных	приспособленных	1
метро	*грушаўка	михалово	1
чжуанцзы	*чжуанцзы	она	1
суседзі	*казалі	порядки	1
навязаць	*навязаць	войн	1
шарля	*шарля	шарля	1
людзi	*людзi	разумом	1
доўга	*праснуўшыся	тоже	1
тваім	*тваім	твоём	1
рупіць	*рупіць	болит	1
натхнення	*ісландскую	вдохновения	1
шукала	*шукала	идеальный	1
доўга	*праснуўшыся	иногда	1
ён	*наснілася	—	1
частуе	*частуе	,	1
пачаставаць	*пачаставаць	когда	1
наставай	*наставай	настиной	1
іскрыць	*іскрыць	искрит	1
частуе	*частуе	метлу	1
што	*наснілася	иногда	1
дэзарганізаваць	*дэзарганізаваць	резинку	1
слухайце	*слухайце	слушайте	1
калі	*лічыць	сделать	1
туман	*туман	сквозь	1
дагэтуль	*дагэтуль	а	1
падлічваюць	*падлічваюць	науки	1
ці	*піша	она	1
хочацца	*хочацца	не	1
і	*выйграйце	выиграйте	1
пасля	*абеда	после	1
лічыць	*лічыць	очень	1
доўга	*праснуўшыся	понять	1
калі	*лічыць	,	1
ведаеце	*ведаеце	быстро	1
—	*скажа	уже	1
ну	*ну	ну	1
калі	*лічыць	полагает	1
называецца	*называецца	библиотек	1
мухамад	*мухамад	мухаммед	1
не	*ўмее	умеет	1
пазнаёміць	*пазнаёміць	познакомить	1
частуе	*частуе	а	1
пан	*тадэвуш	пан	1
—	*о	так	1
дык	*наце	лад	1
мюрыэл	*мюрыэл	время	1
зруйнаваў	*зруйнаваў	тайфун	1
азначалі	*азначалі	"``	1
думаў	*думаў	думал	1
насіць	*насіць	очки	1
і	*раздрабіць	стремясь	1
абралі	*абралі	выбрали	1
здарылася	*здарылася	стряслось	1
часам	*афарыст	снилось	1
ён	*ну	фон	1
падабаецца	*падабаецца	ли	1
’	*сказала	что	1
ядуць	*ядуць	едят	1
дык	*наце	говорили	1
болей	*болей	ученица	1
пачаставаць	*пачаставаць	не	1
цалаваў	*цалаваў	целовал	1
здольны	*здольны	способен	1
паслужыць	*паслужыць	история	1
думаў	*думаў	принц	1
так	*лінсхотэне	что	1
пазычыце	*пазычыце	одолжите	1
называецца	*называецца	функция	1
шчыра	*малюе	обычаи	1
сайт	*сайт	сайт	1
імкнучыся	*імкнучыся	,	1
што	*крыўдаваў	сражении	1
сніць	*сніць	иногда	1
найчасцей	*найчасцей	чаще	1
зефір	*зефір	зефир	1
падобнае	*падобнае	на	1
»	*міхалова	петровщина	1
што	*зрабіць	»	1
папера	*папера	?	1
прысніў	*прысніў	иногда	1
працаваць	*працаваць	хочется	1
выкідвай	*выкідвай	выбрасывай	1
кузэн	*кузэн	кузен	1
імперыялісты	*імперыялісты	мира	1
дапамогай	*спаму	.	1
імперыялісты	*імперыялісты	американские	1
частуе	*частуе	.	1
праспрагаць	*праспрагаць	глагола	1
што	*наснілася	не	1
смяяліся	*смяяліся	девочкой	1
ці	*піша	я	1
дык	*дык	свой	1
прагаласаваў	*прагаласаваў	проголосовал	1
шчыра	*малюе	панов	1
пятроўшчына	*пятроўшчына	петровщина	1
грэю	*грэю	,	1
прайшоў	*прайшоў	прошла	1
праглядзець	*праглядзець	посмотреть	1
узвесці	*узвесці	,	1
«	*меркую	я	1
опцыя	*опцыя	«	1
патрапілі	*патрапілі	под	1
размаўляюць	*размаўляюць	языке	1
замяняем	*замяняем	что	1
дазваляе	*выбраць	области	1
i	*павi*нны	наделены	1
часам	*афарыст	понять	1
,	*адмаўляецца	чтобы	1
паглядзела	*паглядзела	даже	1
расії	*расії	предложение	1
ён	*ну	...	1
збіраць	*збіраць	собирать	1
камп	*камп	могут	1
таннейшых	*таннейшых	подешевле	1
сцвярджае	*сцвярджае	маркс	1
карысны	*карысны	полезный	1
павiнны	*ставi*цца	и	1
чы	*чы	может	1
лянуецца	*лянуецца	ленится	1
пасля	*абеда	?	1
зрабіць	*зрабіць	из	1
сніць	*сніць	приснилось	1
ідэалогія	*ідэалогія	не	1
пан	*тадэвуш	так	1
ніла	*ніла	.	1
замёрзнеш	*замёрзнеш	замёрзнешь	1
сайт	*сайт	свой	1
што	*наснілася	афорист	1
свеціць	*свеціць	же	1
пачаставаць	*пачаставаць	хозяин	1
ці	*чжуанцзы	иногда	1
ён	*наснілася	чжуан-цзы	1
«	*званым	черепичным	1
здарыўся	*здарыўся	произошёл	1
судзячы	*судзячы	судя	1
,	*дзякуй	тут	1
ці	*піша	не	1
хм-м-м	*хм-*м-*м	хм-м-м	1
казахскай	*казахскай	слово	1
наводзіць	*наводзіць	на	1
доўга	*праснуўшыся	же	1
разражаджаная	*разражаджаная	разряжена	1
,	*адмаўляецца	пивом	1
даводзілі	*даводзілі	,	1
«	*купляйце	белорусское	1
што	*наснілася	которому	1
параджае	*параджае	навязать	1
здаецца	*здаецца	плохо	1
дзіўнейшыя	*дзіўнейшыя	более	1
прыводзіць	*прыводзіць	судьбою	1
працоўныя	*працоўныя	трудящиеся	1
дык	*наце	такой	1
толькі	*свеціць	темно	1
нараджаюцца	*нараджаюцца	наделены	1
дык	*дык	самое	1
адхілілася	*адхілілася	это	1
доўга	*праснуўшыся	я	1
узвесці	*узвесці	оклеветать	1
моё	*моё	мой	1
яго	*ведалі	знали	1
перамагаем	*перамагаем	побеждаем	1
замасціць	*замасціць	области	1
бо	*прамакутная	потому	1
(	*здавалася	(	1
нараджаюцца	*нараджаюцца	в	1
сустракаюцца	*сустракаюцца	ещё	1
прысніў	*прысніў	чжуан-цзы	1
ці	*чжуанцзы	который	1
чаю	*чаю	чаю	1
згубіў	*згубіў	кошелёк	1
чую	*чую	слышу	1
пракампасціруйце	*пракампасціруйце	проездного	1
,	*македонскай	македонском	1
ездзе	*адзначана	на	1
ставiцца	*адзi*н	в	1
зліць	*зліць	злить	1
бо	*прамакутная	что	1
ці	*чжуанцзы	чжуан-цзы	1
«	*замасціць	растянуть	1
часам	*афарыст	который	1
замяняем	*замяняем	форма	1
замасціць	*замасціць	размерами	1
жывёлаў	*жывёлаў	,	1
што	*крыўдаваў	.	1
абміналі	*абміналі	обходили	1
бачылі	*бачылі	видели	1
вучышся	*вучышся	усердно	1
без	*клавы	клавы	1
узвесці	*узвесці	трудящиеся	1
паслухаць	*паслухаць	послушать	1
.	*нязгодных	что	1
піша	*піша	тебя	1
працуе	*працуе	,	1
дабудзь	*дабудзь	добудь	1
не	*ўмее	не	1
прысудзіў	*прысудзіў	приговорил	1
карлас	*карлас	карлос	1
ці	*чжуанцзы	долго	1
імперыялізму	*імперыялізму	империализма	1
дагэтуль	*дагэтуль	ещё	1
адхілілася	*адхілілася	отпрянула	1
даведаецца	*даведаецца	узнает	1
ісландскім	*ісландскім	не	1
дэзарганізаваць	*дэзарганізаваць	фильмы	1
ці	*чжуанцзы	словно	1
грэю	*грэю	и	1
знайсці	*знайсці	мою	1
памятаеш	*памятаеш	помнишь	1
чытаў	*чытаў	ни	1
працаваў	*працаваў	работал	1
гарбаткі	*гарбаткі	чайку	1
гатаваць	*гатаваць	готовить	1
ставіцца	*ставіцца	угостить	1
улоўліваць	*улоўліваць	улавливающих	1
частуе	*частуе	когда	1
сняданкам	*сняданкам	завтраком	1
бібліяй	*бібліяй	,	1
пачаставаць	*пачаставаць	и	1
зрабіць	*зрабіць	?	1
сказана	*сказана	говорится	1
часам	*афарыст	чжуан-цзы	1
баіцца	*баіцца	боится	1
працуюць	*працуюць	работают	1
прагноза	*прагноза	девушка	1
замасціць	*замасціць	друг	1
павiнны	*ставi*цца	.	1
мроя	*мроя	.	1
перазваню	*перазваню	перезвоню	1
для	*выкарыстоўвалі	исландский	1
знявага	*знявага	``	1
развіваецца	*развіваецца	развивающемся	1
думала	*думала	думала	1
частуе	*частуе	угощает	1
ён	*наснілася	понять	1
»	*міхалова	откроют	1
павiнны	*ставi*цца	разумом	1
парагвай	*парагвай	парагвай	1
тайская	*тайская	тайский	1
плавае	*плавае	плавает	1
іх	*бачыць	их	1
прагноза	*прагноза	сказала	1
робяць	*робяць	делают	1
ці	*чжуанцзы	приснилось	1
адпраўляецца	*адпраўляецца	отправляется	1
ўчасна	*ўчасна	я	1
дазваляе	*дазваляе	выбрать	1
зефір	*зефір	,	1
амфітрыты	*амфітрыты	амфитриты	1
доўга	*праснуўшыся	—	1
сніць	*сніць	словно	1
найшепшая	*найшепшая	в	1
спяшайся	*спяшайся	торопись	1
—	*о	было	1
што	*наснілася	я	1
размаўлялі	*размаўлялі	разговаривали	1
пацалуй	*пацалуй	поцелуй	1
водзіць	*водзіць	плохо	1
усталявалі	*усталявалі	мира	1
асноўваецца	*асноўваецца	идеология	1
майк	*майк	майк	1
найдаўжэйшае	*найдаўжэйшае	длинное	1
зарабляю	*зарабляю	евро	1
патэлефаную	*патэлефаную	перезвоню	1
падабацца	*падабацца	аниме	1
паслужыць	*паслужыць	послужит	1
пракампасціруйце	*пракампасціруйце	,	1
падлічваюць	*падлічваюць	подсчитывают	1
суседзі	*казалі	вам	1
часам	*афарыст	проснувшись	1
абароненасць	*абароненасць	защищённость	1
чакаючы	*чакаючы	одноразового	1
ісціная	*ісціная	национальность	1
параджае	*параджае	,	1
доўга	*праснуўшыся	афорист	1
тайландзе	*тайландзе	таиланде	1
крывёў	*крывёў	кровей	1
еўрабачанне	*еўрабачанне	евровидение	1
выпісваюць	*выпісваюць	выписывают	1
пятроўшчына	*пятроўшчына	день	1
доўга	*праснуўшыся	кто	1
кнігарню	*кнігарню	книжный	1
чжуанцзы	*чжуанцзы	с	1
прысніў	*прысніў	которой	1
о	*о	о	1
распрацаваная	*распрацаваная	разработана	1
дык	*дык	наши	1
абяцаў	*абяцаў	обещал	1
выбрукавана	*выбрукавана	вымощена	1
ён	*ну	потому	1
маршалізаваных	*маршалізаваных	стран	1
гма	*гма	гмо	1
гуцы	*гуцы	лишь	1
наставай	*наставай	отпрянула	1
ставiцца	*адзi*н	поступать	1
ці	*чжуанцзы	или	1
садзіць	*садзіць	сажает	1
есць	*есць	есть	1
працоўнага	*працоўнага	сокращении	1
гэта	*адсвяткаваць	а	1
таксама	*чжуанцзы	снится	1
маеце	*маеце	нет	1
дазваляе	*выбраць	растянуть	1
бачыў	*бачыў	маркс	1
доўга	*праснуўшыся	пишет	1
дык	*дык	на	1
’	*яўляюцца	квадраты	1
максымальным	*максымальным	идеология	1
шупшалмаш	*шупшалмаш	никогда	1
пан	*тадэвуш	искренне	1
лічу	*лічу	думаю	1
датычыцца	*датычыцца	касается	1
імперыялісты	*імперыялісты	не	1
так	*лінсхотэне	потому	1
i	*павi*нны	совестью	1
(	*здавалася	бы	1
сніць	*сніць	долго	1
высушу	*высушу	слёз	1
застаўляе	*застаўляе	множества	1
павiнны	*ставi*цца	поступать	1
захлёбваючыся	*захлёбваючыся	захлёбываясь	1
»	*міхалова	метро	1
нараджаюцца	*нараджаюцца	и	1
мондыктарыше	*мондыктарыше	поцелуй	1
вучыцца	*вучыцца	не	1
булачку	*булачку	булочку	1
мабыць	*мабыць	должно	1
вучацца	*вучацца	безнадёжны	1
сайтаў	*сайтаў	.	1
ніла	*ніла	нила	1
суседзі	*казалі	говорили	1
«	*замасціць	показа	1
сніць	*сніць	которому	1
дык	*наце	школы	1
па	*засудзяць	по	1
ставіцца	*ставіцца	.	1
карысней	*карысней	луна	1
імкнучыся	*імкнучыся	консервы	1
патрэбныя	*патрэбныя	только	1
ведаеце	*ведаеце	,	1
людзi	*людзi	.	1
працоўныя	*працоўныя	снять	1
учасна	*учасна	подошёл	1
міцкевіча	*міцкевіча	«	1
таксама	*чжуанцзы	которой	1
шчыра	*малюе	пан	1
доўга	*праснуўшыся	долго	1
характэрных	*характэрных	черт	1
ён	*наснілася	с	1
знайдзе	*знайдзе	.	1
часам	*афарыст	я	1
бо	*прамакутная	расхождении	1
міцкевіча	*міцкевіча	мицкевича	1
ніякіх	*серадах	``"	1
часам	*афарыст	не	1
думкаай	*думкаай	с	1
ззяюць	*ззяюць	на	1
ці	*чжуанцзы	мог	1
траян	*траян	троян	1
замасціць	*замасціць	замостить	1
любіць	*любіць	мюриэл	1
ён	*наснілася	пишет	1
каўтае	*каўтае	по	1
ніводнага	*ніводнага	проспрягать	1
ведаем	*ведаем	его	1
і	*абычаі	наших	1
чжуанцзы	*чжуанцзы	я	1
ці	*піша	которому	1
ці	*чжуанцзы	проснувшись	1
«	*замасціць	,	1
будавалася	*будавалася	строилась	1
дагэтуль	*дагэтуль	четыре	1
ці	*піша	проснувшись	1
адказвае	*адказвае	,	1
—	*скажа	умеет	1
паснедаў	*паснедаў	позавтракал	1
’	*яўляюцца	прямоугольниками	1
павiнны	*ставi*цца	совестью	1
вучыць	*вучыць	учит	1
заблукаеш	*заблукаеш	больше	1
радактараў	*радактараў	редакторов	1
сустрэну	*сустрэну	встречу	1
еўра	*еўра	день	1
галандыя	*галандыя	голландия	1
«	*меркую	"''	1
суседзі	*казалі	мы	1
ці	*чжуанцзы	с	1
што	*наснілася	с	1
гаворыць	*гаворыць	говорящая	1
хварэю	*хварэю	болею	1
аповесьць	*аповесьць	адама	1
жывёлаў	*жывёлаў	домашних	1
пашуковая	*пашуковая	поисковая	1
чыла	*чыла	сердечный	1
іх	*бачыць	тот	1
паспаць	*паспаць	поспать	1
паказвае	*паказвае	означает	1
закахаўся	*закахаўся	влюбился	1
бегае	*бегае	быстрее	1
сніць	*сніць	кто	1
паўнаэкранных	*паўнаэкранных	полноэкранных	1
педафілы	*педафілы	совращают	1
людзi	*людзi	рождаются	1
«	*дзякуй	``	1
пачаставаць	*пачаставаць	чтобы	1
не	*ўмее	скажет	1
імперыялістамі	*імперыялістамі	маршаллизованных	1
адказвае	*адказвае	по	1
болей	*болей	пояс	1
мяжуюць	*мяжуюць	граничат	1
кансервы	*кансервы	консервы	1
дазваляе	*дазваляе	размерами	1
хапае	*хапае	едва	1
застаецца	*застаецца	остаётся	1
—	*скажа	скажет	1
дэзарганізаваць	*дэзарганізаваць	империалистами	1
што	*наснілася	долго	1
падыходзіць	*падыходзіць	подходит	1
адказвае	*адказвае	бутерброд	1
таксама	*чжуанцзы	долго	1
слухаеце	*слухаеце	слушаете	1
татоэба	*татоэба	татоэба	1
роўтэр	*роўтэр	.	1
дык	*наце	свой	1
працаваць	*працаваць	,	1
будзеш	*вучыцца	будешь	1
суседзі	*казалі	соседи	1
свеціць	*свеціць	конечно	1
творыць	*творыць	творит	1
сніць	*сніць	я	1
сказаць	*сказаць	,	1
дык	*дык	так	1
марнаваць	*марнаваць	терять	1
вычамі	*вычамі	меня	1
падабаецца	*падабаецца	вам	1
дацкі	*дацкі	вдохновения	1
—	*о	ну	1
толькі	*свеціць	только	1
«	*ну	нет	1
хтосьці	*хтосьці	кто-то	1
ідэалогія	*ідэалогія	с	1
»	*міхалова	михалово	1
чжуанцзы	*чжуанцзы	бабочка	1
збаўце	*збаўце	убавьте	1
замяняем	*замяняем	флага	1
ці	*чжуанцзы	не	1
жаўнер	*жаўнер	солдат	1
