знаю	знать	V
люся	люся	S
люблю	любить	V
клава	клава	S
знает	знать	V
найти	находить	V
твой	твой	APRO
львов	лев	S
цао	цао	S
педофилы	педофил	S
работает	работать	V
бетти	бетти	S
нюнорска	нюнорск	S
пишет	писать	V
роджер	роджер	S
спать	спать	V
твоя	твой	APRO
яани	яань	S
писать	писать	V
люси	люся	S
маркс	маркс	S
умеешь	уметь	V
сказать	сказать	V
иен	иена	S
знать	знать	V
работать	работать	V
тима	тим	S
случилось	случаться	V
завидовала	завидовать	V
доренда	доренд	S
обама	обама	S
окна	окно	S
читать	читать	V
позволяет	позволять	V
знаешь	знать	V
песня	песня	S
выиграли	выигрывать	V
брайан	брайан	S
стесняйся	стесняться	V
кнопки	кнопка	S
зовут	звать	V
вывалилась	вывалиться	V
обращает	обращать	V
мюриэл	мюриэл	S
свободные	свободный	A
посчастливилось	посчастливиться	V
рассказать	рассказывать	V
классе	класс	S
блог	блог	S
этакой	этакий	APRO
сайте	сайт	S
смеялись	смеяться	V
слушать	слушать	V
характерных	характерный	A
анжелика	анжелика	S
львове	львов	S
рон	рон	S
обожает	обожать	V
знали	знать	V
пообещали	пообещать	V
изучает	изучать	V
существует	существовать	V
бегать	бегать	V
кен	кен	S
ненавидела	ненавидеть	V
изучал	изучать	V
дотронулось	дотрагиваться	V
светит	светить	V
шарля	шарль	S
заплетала	заплетать	V
проплывали	проплывать	V
алло	але	INTJ
засыхали	засыхать	V
фарамп	фарамп	S
штаны	штаны	S
поговорить	поговорить	V
собираюсь	собираться	V
увеличивается	увеличиваться	V
мандалай	мандалай	S
слезли	слезать	V
начинается	начинаться	V
отрежь	отрезать	V
совпадает	совпадать	V
дотронься	дотрагиваться	V
напоминает	напоминать	V
московиц	московица	S
промелькнуло	промелькнуть	V
товада	товада	S
окно	окно	S
президент	президент	S
настиной	настина	S
разговаривает	разговаривать	V
прощает	прощать	V
предавал	предавать	V
заклей	заклеивать	V
краков	краков	S
имеете	иметь	V
неужели	неужели	PART
знаете	знать	V
открывай	открывать	V
юэбин	юэбина	S
темнеет	темнеть	V
дастин	дастин	S
люсе	люся	S
сервисов	сервис	S
загорелась	загораться	V
осваивается	осваиваться	V
трогай	трогать	V
родилась	рождаться	V
думаешь	думать	V
майк	майк	S
развешивает	развешивать	V
ислам	ислам	S
дурите	дурить	V
тучи	туча	S
тёмную	темный	A
забыл	забывать	V
говори	говорить	V
маша	маша	S
читаешь	читать	V
инопланетяне	инопланетянин	S
будды	будда	S
татоэбе	татоэб	S
борисовдрева	борисовдрев	S
реакцию	реакция	S
обожаю	обожать	V
искала	искать	V
бесчисленные	бесчисленный	A
рассказывал	рассказывать	V
адрес	адрес	S
тереза	тереза	S
твой	твой	APRO
люблю	любить	V
почитать	почитать	V
означали	означать	V
говорить	говорить	V
спит	спать	V
учил	учить	V
становится	становиться	V
называется	называться	V
прощается	прощаться	V
казахском	казахский	A
соцреалистические	соцреалистический	A
похожее	похожий	A
совращают	совращать	V
отредактировала	отредактировать	V
прогноза	прогноз	S
наиярчайшая	яркий	A
окно	окно	S
сорванные	сорвать	V
стёрт	стереть	V
многих	многий	APRO
нептуна	нептун	S
продаются	продаваться	V
шапочко	шапочко	S
индустриализация	индустриализация	S
идеальный	идеальный	A
информацию	информация	S
вырезал	вырезать	V
империалистами	империалист	S
голландского	голландский	A
дверь	дверь	S
бена	бен	S
лазанью	лазание	S
данте	данте	S
утверждает	утверждать	V
твоей	твой	APRO
инопланетянами	инопланетянин	S
разбросаны	разбрасывать	V
познаешь	познавать	V
джеком	джек	S
тёмные	темный	A
задавать	задавать	V
покупайте	покупать	V
смириться	смиряться	V
туман	туман	S
трясти	трясти	V
салмана	салман	S
упрощает	упрощать	V
вылез	вылезать	V
окна	окно	S
твоя	твой	APRO
аж	аж	PART
нашёл	находить	V
любят	любить	V
серебряную	серебряный	A
миллер	миллер	S
желаю	желать	V
понимаю	понимать	V
убивает	убивать	V
говорит	говорить	V
идеология	идеология	S
сайта	сайт	S
увольняться	увольняться	V
разбирается	разбираться	V
секрет	секрет	S
инопланетяне	инопланетянин	S
прокомпостируйте	прокомпостировать	V
мандарины	мандарин	S
нло	нло	S
джек	джек	S
называли	называть	V
годах	год	S
играть	играть	V
основывается	основываться	V
пройдёт	проходить	V
аниме	аниме	S
притворимся	притворяться	V
твоё	твой	APRO
рок	рок	S
читал	читать	V
летает	летать	V
перепрыгивает	перепрыгивать	V
помыть	помыть	V
душе	душа	S
израиль	израиль	S
снимали	снимать	V
баллотироваться	баллотироваться	V
перро	перро	S
пропустите	пропустить	V
скучаем	скучать	V
повадилась	повадиться	V
пиклз	пиклз	S
обладает	обладать	V
гольф	гольф	S
познаешь	познавать	V
гмо	гмо	S
думала	думать	V
зарабатывал	зарабатывать	V
империализма	империализм	S
распространяйте	распространять	V
дожить	доживать	V
встречаю	встречать	V
шнобелевскую	шнобелевский	A
прекратите	прекращать	V
чаю	чай	S
называется	называться	V
разряжена	разряжать	V
меняет	менять	V
сияют	сиять	V
возлагает	возлагать	V
умеет	уметь	V
аватаре	аватар	S
тайский	тайский	A
мёртв	мертвый	A
подсчитывают	подсчитывать	V
троян	троян	S
губка	губка	S
бегает	бегать	V
плавает	плавать	V
нашли	находить	V
роксолана	роксолан	S
опция	опция	S
татоэба	татоэб	S
разработана	разрабатывать	V
учишься	учиться	V
грею	греть	V
творит	творить	V
отправляется	отправляться	V
выстлан	выстилать	V
дезорганизовать	дезорганизовывать	V
найдёт	находить	V
отучился	отучаться	V
некурящих	некурящий	A
агурбаш	агурбаш	S
исправишь	исправлять	V
ем	есть	V
работаю	работать	V
послужит	послужить	V
новеллы	новелла	S
рассчитывать	рассчитывать	V
полезнее	полезно	ADV
вянут	вянуть	V
исландским	исландский	A
приводит	приводить	V
злить	злить	V
учатся	учиться	V
подходит	подходить	V
пятнадцать	пятнадцать	NUM
строилась	строиться	V
стреляя	стрелять	V
ведёт	вести	V
максимальном	максимальный	A
сбалансированного	сбалансированный	A
персидский	персидский	A
обещал	обещать	V
карпаты	карпаты	S
проект	проект	S
человеконенавистнических	человеконенавистнический	A
куй	ковать	V
перезвоню	перезванивать	V
львовских	львовский	A
империалисты	империалист	S
инфекция	инфекция	S
убавьте	убавлять	V
глотает	глотать	V
ел	есть	V
меняется	меняться	V
познал	познавать	V
неправ	неправый	A
брюссель	брюссель	S
евро	евро	S
рисовать	рисовать	V
орест	орест	S
готовить	готовить	V
хуйни	хуйнуть	V
сайтом	сайт	S
справился	справляться	V
создаёте	создавать	V
борделе	бордель	S
поиграть	поиграть	V
тараторит	тараторить	V
хаданович	хаданович	S
фарси	фарси	S
различает	различать	V
замёрзнешь	замерзать	V
переустанавливать	переустанавливать	V
замостить	замащивать	V
плавают	плавать	V
проспрягать	проспрягать	V
бором	бор	S
горький	горький	A
зефир	зефир	S
зародилась	зарождаться	V
горжусь	гордиться	V
высушу	высушивать	V
судя	судя	ADV
учусь	учиться	V
львовской	львовский	A
подлей	подло	ADV
знает	знать	V
фейсбуке	фейсбук	S
тратит	тратить	V
ссср	ссср	S
интернете	интернет	S
слушайте	слушать	V
алан	алан	S
львове	львов	S
что	что	CONJ
выставку	выставка	S
хуана	хуан	S
приносят	приносить	V
саэб	саэб	S
лондона	лондон	S
болело	болеть	V
читая	читать	V
проблем	проблема	S
выбрали	выбирать	V
выбрать	выбирать	V
снимаем	снимать	V
остаётся	оставаться	V
нефертари	нефертари	ADV
сделала	сделать	V
предсказать	предсказывать	V
редакторов	редактор	S
разговаривали	разговаривать	V
стреляйте	стрелять	V
побеждаем	побеждать	V
вебмастеры	вебмастер	S
установил	устанавливать	V
ждала	ждать	V
бобруйска	бобруйск	S
консервы	консервы	S
боюсь	бояться	V
фаната	фанат	S
твои	твой	APRO
продолжала	продолжать	V
установили	устанавливать	V
водит	водить	V
заруби	зарубать	V
наливаю	наливать	V
защищённость	защищенность	S
пропил	пропивать	V
мухаммед	мухаммед	S
голландия	голландия	S
карлос	карлос	S
выбрасывай	выбрасывать	V
проголосовал	проголосовать	V
означает	означать	V
добудь	добывать	V
аллаха	аллах	S
послевкусие	послевкусие	S
заживают	заживать	V
колю	коля	S
посмотрела	посмотреть	V
иероглифа	иероглиф	S
полноэкранных	полноэкранный	A
растворяется	растворяться	V
арктике	арктика	S
правым	правый	A
пришлось	приходиться	V
садитесь	садиться	V
свободное	свободный	A
фнорд	фнорд	S
кашгаре	кашгар	S
поцеловал	поцеловать	V
стряслось	стрясаться	V
ромашку	ромашка	S
ира	ира	S
львовский	львовский	A
скучаю	скучать	V
серебряными	серебряный	A
цветаева	цветаева	S
сайтов	сайт	S
приглашаем	приглашать	V
пробуй	пробовать	V
целитесь	целиться	V
читаю	читать	V
безнадёжны	безнадежный	A
любое	любой	APRO
встречаются	встречаться	V
собирать	собирать	V
москаль	москаль	S
суматра	суматра	S
разговариваю	разговаривать	V
компьютерные	компьютерный	A
позавтракал	позавтракать	V
целовал	целовать	V
свяжусь	связываться	V
познакомить	познакомить	V
некляева	некляев	S
забывай	забывать	V
парагвай	парагвай	S
миннесоте	миннесота	S
единицы	единица	S
тратил	тратить	V
развивающемся	развиваться	V
талончик	талончик	S
сезон	сезон	S
датским	датский	A
симпатичных	симпатичный	A
булочку	булочка	S
поцелуй	поцелуй	S
полезный	полезный	A
твоём	твой	APRO
бойся	бояться	V
обещало	обещать	V
шекспира	шекспир	S
объяснил	объяснять	V
высохли	высыхать	V
покрасить	покрасить	V
французском	французский	A
роутер	роутер	S
покажи	показывать	V
убивай	убивать	V
искал	искать	V
иврите	иврит	S
заблудишься	заблудиться	V
знаем	знать	V
ест	есть	V
мёртвая	мертвый	A
спряталось	спрятаться	V
заменяем	заменять	V
твою	твой	APRO
задумываюсь	задумываться	V
разговаривать	разговаривать	V
патрик	патрик	S
липнут	липнуть	V
бегай	бегать	V
сайт	сайт	S
двери	дверь	S
вести	весть	S
актер	актер	S
эстонском	эстонский	A
рамсес	рамсес	S
зарабатываю	зарабатывать	V
иен	иена	S
основывается	основываться	V
мой	мой	APRO
кошки	кошка	S
приснись	присниться	V
замотай	заматывать	V
цитировать	цитировать	V
сайтам	сайт	S
узбекскую	узбекский	A
думал	думать	V
играем	играть	V
работал	работать	V
амфитриты	амфитрит	S
лукашенко	лукашенко	S
ложную	ложный	A
умею	уметь	V
делаю	делать	V
послушать	послушать	V
возвращайся	возвращаться	V
решать	решать	V
понимаешь	понимать	V
придумать	придумывать	V
совращает	совращать	V
думают	думать	V
выиграть	выигрывать	V
возникла	возникать	V
уважают	уважать	V
подобавлять	подобавлять	V
вдвоём	вдвоем	ADV
сато	сато	S
переходи	переходить	V
сандра	сандра	S
ну	ну	PART
косы	коса	S
готовите	готовить	V
наполняло	наполнять	V
заставляет	заставлять	V
мицкевича	мицкевич	S
техас	техас	S
парламентская	парламентский	A
спорта	спорт	S
искрит	искрить	V
выписывают	выписывать	V
кузен	кузен	S
обращать	обращать	V
простой	простой	A
придумывал	придумывать	V
проявлялись	проявляться	V
говорил	говорить	V
проносить	проносить	V
жрёт	жрать	V
дырку	дырка	S
квинтэссенция	квинтэссенция	S
слушаете	слушать	V
таиланде	таиланд	S
шахматы	шахматы	S
поспать	поспать	V
серийная	серийный	A
поисковая	поисковый	A
приносит	приносить	V
видела	видеть	V
посмотрел	посмотреть	V
функциональностью	функциональность	S
познакомились	познакомиться	V
эй	эй	INTJ
изолентой	изолента	S
обходили	обходить	V
твоего	твой	APRO
выколи	выкалывать	V
доверяю	доверять	V
добавлять	добавлять	V
передвинь	передвигать	V
прошёл	проходить	V
